飞机号,时间,环境温度(℃),左温差,右温差,左边CONT CABIN DUCT,左边FWD DUCT,左边AFT DUCT,左边L PACK,左边SUPPLY DUCT,右边CONT CABIN DUCT,右边FWD DUCT,右边AFT DUCT,右边L PACK,右边SUPPLY DUCT,排故措施
1161,4/18/2019,17,5,3,4,0,0,22,0,0,3,3,20,0,更换右组件TCV
1351,5/8/2019,19,7,3,3,0,0,26,0,0,4,3,22,0,更换右侧冲压进气进口作动筒
1489,4/14/2019,28,-3,-4,2,0,0,25,0,0,8,8,24,0,更换左组件PFTC，右PFTC串件
1489,4/21/2019,24,5,5,4,0,0,29,0,0,4,4,29,0,更换前舱配平活门、对串P5-10面板
1538,5/2/2019,24,2,1,2,0,0,26,0,0,4,4,25,0,更换空调面板组件（P5-10)
1541,4/10/2019,8,16,18,3,0,0,24,0,0,2,3,26,0,更换右侧冲压进气出口作动器
1568,4/27/2019,10,13,8,6,0,0,23,0,0,6,6,18,0,更换右侧冲压进气进口作动筒、更换 PFTC2
1725,5/8/2019,17,7,11,4,0,0,24,0,0,4,6,28,0,更换ACM
1733,5/3/2019,20,5,8,6,0,0,25,0,0,6,7,28,0,更换温控面板
1735,4/27/2019,27,3,-1,5,0,0,30,0,0,5,5,26,0,更换左组件温度传感器
1783,4/14/2019,21,-21,-1,5,0,0,0,0,0,5,6,20,0,对串T488/T489
1785,4/18/2019,20,4,7,7,0,0,24,0,0,7,8,27,0,更换左组件TCV
1786,4/8/2019,20,5,4,3,0,0,25,0,0,3,3,24,0,更换P5-17控制面板
1796,5/1/2019,27,5,7,6,0,0,32,0,0,6,4,34,0,更换驾驶舱配平活门
1796,5/3/2019,15,9,-15,6,0,0,24,0,0,5,4,0,0,对串ZTC1、吹除左组件散热器
1906,4/10/2019,22,10,2,7,0,0,32,0,0,0,0,24,0,更换右组件TCV
1927,4/21/2019,25,3,4,4,0,0,28,0,0,8,5,29,0,更换P5-17面板
206P,4/16/2019,17,9,7,4,0,0,26,0,0,4,4,24,0,更换驾驶舱配平活门
5137,4/17/2019,28,-5,4,3,0,0,23,0,0,3,3,32,0,更换右侧再循环风扇
5141,5/6/2019,20,10,10,5,0,0,30,0,0,5,6,30,0,更换左组件TCV
5337,5/2/2019,18,2,2,4,0,0,20,0,0,6,5,20,0,更换右组件TCV
5346,4/18/2019,25,6,6,4,0,0,31,0,0,4,3,31,0,完成右组件散热器反向吹除
5346,5/1/2019,20,2,6,6,0,0,22,0,0,6,6,26,0,更换右组件冲压进气门作动筒
5346,5/7/2019,26,6,5,6,0,0,32,0,0,6,6,31,0,完成右组件反向吹除
5373,4/30/2019,26,4,4,6,0,0,30,0,0,8,8,30,0,更换右侧空调组件流量控制关断活门
5406,4/12/2019,28,2,2,7,0,0,30,0,0,6,4,30,0,更换驾驶舱配平活门
5407,4/27/2019,20,5,4,4,0,0,25,0,0,5,4,24,0,更换右组件TCV
5408,4/18/2019,25,6,6,5,0,0,31,0,0,5,5,31,0,更换左组件TCV、更换驾驶舱配平活门
5428,4/17/2019,15,9,16,4,0,0,24,0,0,4,4,31,0,更换作动器
5462,5/4/2019,20,6,7,5,0,0,26,0,0,3,3,27,0,更换前舱配平活门
5466,4/26/2019,15,-5,-5,3,0,0,10,0,0,3,3,10,0,更换TEMP BULB
5713,4/11/2019,31,-2,-3,5,0,0,29,0,0,4,5,28,0,T471当地无料未更换
5713,4/13/2019,12,10,8,6,0,0,22,0,0,6,6,20,0,更换ZTC1
5713,4/13/2019,12,10,8,6,0,0,22,0,0,6,6,20,0,更换右组件传感器T474和T489
5713,4/27/2019,28,0,2,4,0,0,28,0,0,6,6,30,0,更换驾驶舱配平空气活门
5805,4/22/2019,20,-20,-20,0,0,0,0,6,0,0,0,0,6,更换ACM
5855,5/3/2019,22,5,4,6,0,0,27,0,0,5,5,26,0,更换空调温度控制面板
6060,4/26/2019,10,14,12,4,0,0,24,0,0,4,4,22,0,更换左组件TCV
6061,4/29/2019,26,-2,2,1,0,0,24,0,0,5,5,28,0,更换左组件冲压进气作动器
6066,5/1/2019,20,4,3,3,0,0,24,0,0,4,5,23,0,更换温控面板
7173,4/17/2019,18,4,2,4,0,0,22,0,0,4,3,20,0,更换左组件温度传感器T488
7400,4/13/2019,27,5,3,5,0,0,32,0,0,5,5,30,0,串件温度传感器
7400,5/2/2019,32,-8,-12,6,0,0,24,0,0,13,14,20,0,更换前后配平活门
7639,5/8/2019,25,11,7,6,0,0,36,0,0,8,7,32,0,反吹左组件
5579,5/8/2019,25,11,10,8,0,0,36,0,0,8,6,35,0,反吹左、右组件，未完成
5138,5/8/2019,25,8,10,4,0,0,33,0,0,5,5,35,0,反吹右组件
5611,5/8/2019,16,10,16,4,0,0,26,0,0,6,6,32,0,反吹右组件
5358,5/8/2019,25,11,11,8,0,0,36,0,0,8,8,36,0,反吹左、右组件
7172,5/8/2019,22,10,6,5,0,0,32,0,0,5,4,28,0,反吹左组件，未完成
1103,5/8/2019,25,11,7,4,0,0,36,0,0,4,4,32,0,反吹左组件
5359,5/8/2019,22,10,6,9,0,0,32,0,0,4,3,28,0,反吹左组件，未完成
6065,5/8/2019,21,11,8,4,0,0,32,0,0,4,4,29,0,反吹左组件
5733,5/7/2019,27,10,7,7,0,0,37,0,0,6,7,34,0,反吹左组件
1498,5/7/2019,19,13,8,6,0,0,32,0,0,6,6,27,0,反吹左组件
5478,5/7/2019,21,11,5,3,0,0,32,0,0,4,4,26,0,反吹左组件
5520,5/7/2019,22,10,8,5,0,0,32,0,0,5,4,30,0,反吹左组件
5579,5/7/2019,28,9,8,8,0,0,37,0,0,8,8,36,0,反吹左组件，未完成
7172,5/7/2019,22,11,8,5,0,0,33,0,0,6,6,30,0,反吹左组件，未完成
5371,5/7/2019,27,3,10,6,0,0,30,0,0,7,8,37,0,反吹右组件，未完成
5581,5/7/2019,25,5,12,10,0,0,30,0,0,7,6,37,0,反吹左、右组件，未完成
5136,5/6/2019,20,8,12,5,0,0,28,0,0,5,4,32,0,反吹右组件，未完成
5478,5/6/2019,22,12,6,4,0,0,34,0,0,4,4,28,0,反吹左组件，未完成
6065,5/6/2019,21,13,9,5,0,0,34,0,0,4,4,30,0,反吹左组件
7172,5/6/2019,23,10,7,4,0,0,33,0,0,6,4,30,0,反吹左组件，未完成
5579,5/6/2019,22,10,8,6,0,0,32,0,0,7,6,30,0,反吹左组件，未完成
7886,5/6/2019,30,6,7,5,0,0,36,0,0,4,3,37,0,反吹右组件，未完成
5467,5/6/2019,20,10,13,2,0,0,30,0,0,3,1,33,0,反吹右组件
7379,5/6/2019,20,11,12,4,0,0,31,0,0,3,3,32,0,反吹右组件，未完成
1101,5/6/2019,20,14,16,3,0,0,34,0,0,3,3,36,0,反吹左、右组件
5430,5/6/2019,22,10,10,5,0,0,32,0,0,5,4,32,0,反吹左、右组件
1213,5/5/2019,25,11,10,6,0,0,36,0,0,6,6,35,0,反吹左、右组件，未完成
5405,5/5/2019,25,11,9,5,0,0,36,0,0,5,4,34,0,反吹左组件
5478,5/5/2019,20,12,5,4,0,0,32,0,0,4,4,25,0,反吹左组件
1903,5/5/2019,21,7,17,2,0,0,28,0,0,2,2,38,0,反吹右组件，未完成
5358,5/5/2019,29,8,8,9,0,0,37,0,0,9,8,37,0,反吹左、右组件
1495,5/5/2019,25,11,8,4,0,0,36,0,0,3,4,33,0,反吹左组件
5373,5/4/2019,22,10,11,7,0,0,32,0,0,8,8,33,0,反吹左、右组件
7379,5/3/2019,25,8,10,4,0,0,33,0,0,4,3,35,0,反吹右组件，未完成
5625,5/2/2019,25,11,9,8,0,0,36,0,0,5,5,34,0,反吹左组件，未完成
5463,5/1/2019,23,13,-1,3,0,0,36,0,0,4,4,22,0,反吹左组件
1497,5/1/2019,26,10,6,3,0,0,36,0,0,4,4,32,0,反吹左组件，未完成
1215,5/1/2019,23,11,9,4,0,0,34,0,0,4,4,32,0,反吹左组件
5625,5/1/2019,26,6,10,4,0,0,32,0,0,4,5,36,0,反吹右组件，未完成
1130,5/1/2019,25,8,11,4,0,0,33,0,0,9,8,36,0,反吹右组件
1501,5/1/2019,22,6,10,4,0,0,28,0,0,4,4,32,0,反吹右组件，未完成
5522,4/30/2019,24,13,3,6,0,0,37,0,0,6,7,27,0,反吹左组件
5709,4/30/2019,22,9,12,7,0,0,31,0,0,8,8,34,0,反吹右组件，未完成
5338,4/30/2019,20,12,9,4,0,0,32,0,0,3,3,29,0,反吹左组件，未完成
5637,4/30/2019,24,12,9,2,0,0,36,0,0,2,2,33,0,反吹左组件
5430,4/30/2019,25,9,10,6,0,0,34,0,0,6,6,35,0,反吹右组件
5522,4/29/2019,28,9,8,7,0,0,37,0,0,8,7,36,0,反吹左组件
5288,4/29/2019,17,-17,-17,0,0,0,0,8,0,0,0,0,18,反吹右组件
1586,4/28/2019,11,21,11,8,0,0,32,0,0,6,5,22,0,反吹左组件，未完成
7175,4/28/2019,26,10,4,6,0,0,36,0,0,5,6,30,0,反吹左组件，未完成
1163,4/28/2019,11,12,19,2,0,0,23,0,0,10,10,30,0,反吹右组件
5538,4/28/2019,12,14,20,4,0,0,26,0,0,4,4,32,0,反吹右组件，未完成
1487,4/28/2019,14,18,12,7,0,0,32,0,0,8,7,26,0,反吹左组件，未完成
1487,4/27/2019,14,18,12,7,0,0,32,0,0,8,7,26,0,反吹左组件，未完成
1163,4/27/2019,13,19,21,8,0,0,32,0,0,8,9,34,0,反吹左、右组件
5478,4/27/2019,15,17,15,8,0,0,32,0,0,7,8,30,0,反吹左组件，未完成
5483,4/27/2019,25,10,7,5,0,0,35,0,0,7,6,32,0,反吹左组件，未完成
7379,4/27/2019,24,5,12,5,0,0,29,0,0,8,9,36,0,反吹右组件、冷凝器波纹管漏水
7639,4/27/2019,26,11,7,6,0,0,37,0,0,7,7,33,0,反吹左、右组件
5289,4/27/2019,30,-30,-30,0,0,0,0,19,0,0,0,0,11,反吹左、右组件
7639,4/26/2019,26,10,6,5,0,0,36,0,0,8,7,32,0,反吹左组件
1793,4/26/2019,25,10,5,5,0,0,35,0,0,4,4,30,0,反吹左组件，未完成
5580,4/26/2019,25,10,5,5,0,0,35,0,0,4,4,30,0,反吹左组件
1786,4/26/2019,27,7,11,4,0,0,34,0,0,4,4,38,0,反吹右组件
1213,4/25/2019,27,12,7,10,0,0,39,0,0,4,4,34,0,反吹左组件
5482,4/25/2019,8,24,20,9,0,0,32,0,0,8,9,28,0,反吹左组件，未完成
1538,4/25/2019,20,2,15,2,0,0,22,0,0,7,8,35,0,反吹右组件
1102,4/25/2019,25,8,3,6,0,0,33,0,0,10,9,28,0,反吹右组件，未完成
7379,4/25/2019,24,7,10,4,0,0,31,0,0,4,4,34,0,反吹右组件
1131,4/24/2019,13,19,17,4,0,0,32,0,0,7,8,30,0,反吹左组件
1141,4/24/2019,24,11,6,6,0,0,35,0,0,5,5,30,0,反吹左组件
1213,4/24/2019,22,10,8,6,0,0,32,0,0,6,6,30,0,反吹左组件
5538,4/23/2019,20,10,13,2,0,0,30,0,0,2,4,33,0,反吹右组件
5686,4/23/2019,24,16,8,8,0,0,40,0,0,6,8,32,0,反吹左组件
5090,4/23/2019,24,11,7,6,0,0,35,0,0,8,7,31,0,反吹左组件
1783,4/23/2019,20,0,16,4,0,0,20,0,0,4,4,36,0,反吹右组件
1496,4/23/2019,26,9,10,6,0,0,35,0,0,6,6,36,0,反吹右组件，未完成
5712,4/23/2019,22,3,11,2,0,0,25,0,0,8,7,33,0,反吹右组件
5580,4/22/2019,23,9,11,6,0,0,32,0,0,6,6,34,0,反吹右组件
5522,4/22/2019,30,4,4,6,0,0,34,0,0,10,12,34,0,反吹右组件
1347,4/22/2019,25,4,-1,4,0,0,29,0,0,16,14,24,0,反吹右组件
1729,4/22/2019,20,17,11,5,0,0,37,0,0,5,4,31,0,反吹左组件，未完成
5430,4/22/2019,20,6,15,6,0,0,26,0,0,8,6,35,0,反吹右组件
5082,4/21/2019,25,11,5,8,0,0,36,0,0,5,5,30,0,反吹左组件
5405,4/21/2019,24,12,10,4,0,0,36,0,0,5,4,34,0,反吹左、右组件，未完成
206H,4/21/2019,25,11,9,2,0,0,36,0,0,2,2,34,0,反吹左组件
5153,4/21/2019,25,11,9,8,0,0,36,0,0,4,4,34,0,反吹左组件，未完成
1101,4/21/2019,25,11,10,3,0,0,36,0,0,3,3,35,0,反吹左、右组件
1505,4/21/2019,23,12,5,3,0,0,35,0,0,3,3,28,0,反吹左组件，未完成
7618,4/21/2019,20,6,15,5,0,0,26,0,0,7,6,35,0,反吹右组件
5580,4/20/2019,20,12,12,6,0,0,32,0,0,6,6,32,0,反吹左、右组件
5661,4/20/2019,25,9,11,4,0,0,34,0,0,5,6,36,0,反吹右组件
6060,4/19/2019,21,3,11,2,0,0,24,0,0,2,3,32,0,反吹右组件
7379,4/19/2019,25,9,11,4,0,0,34,0,0,2,2,36,0,反吹右组件，未完成
1482,4/19/2019,22,10,4,4,0,0,32,0,0,5,5,26,0,反吹左组件
1496,4/18/2019,24,10,8,6,0,0,34,0,0,5,4,32,0,反吹左组件，未完成
5371,4/18/2019,25,10,7,7,0,0,35,0,0,6,6,32,0,反吹左组件，未完成
5082,4/18/2019,25,10,7,4,0,0,35,0,0,4,4,32,0,反吹左组件，未完成
1103,4/17/2019,22,12,7,4,0,0,34,0,0,4,4,29,0,反吹左组件，未完成
1496,4/17/2019,22,9,10,6,0,0,31,0,0,6,5,32,0,反吹右组件，未完成
5520,4/17/2019,25,11,7,6,0,0,36,0,0,5,4,32,0,反吹左组件，未完成
5661,4/16/2019,16,4,2,3,0,0,20,0,0,10,8,18,0,反吹右组件
1130,4/16/2019,21,12,7,2,0,0,33,0,0,2,2,28,0,反吹左组件
5405,4/16/2019,22,10,7,4,0,0,32,0,0,5,4,29,0,反吹左组件
5082,4/16/2019,26,10,4,6,0,0,36,0,0,4,4,30,0,反吹左组件，未完成
5623,4/16/2019,25,11,6,6,0,0,36,0,0,6,6,31,0,反吹左组件
1101,4/15/2019,26,11,7,3,0,0,37,0,0,2,2,33,0,反吹左组件
5661,4/15/2019,25,11,9,4,0,0,36,0,0,4,4,34,0,反吹左组件，未完成
5082,4/15/2019,26,10,7,7,0,0,36,0,0,5,5,33,0,反吹左组件，未完成
1505,4/15/2019,25,11,9,5,0,0,36,0,0,3,5,34,0,反吹左组件，未完成
5623,4/15/2019,22,10,5,6,0,0,32,0,0,5,5,27,0,反吹左组件，未完成
5620,4/15/2019,22,10,5,4,0,0,32,0,0,3,5,27,0,反吹左组件，未完成
5712,4/15/2019,23,11,13,2,0,0,34,0,0,4,4,36,0,反吹左、右组件，未完成
1141,4/14/2019,22,11,8,3,0,0,33,0,0,6,6,30,0,反吹左组件，未完成
1101,4/14/2019,20,12,14,5,0,0,32,0,0,5,6,34,0,反吹左、右组件
1997,4/14/2019,20,4,16,4,0,0,24,0,0,6,6,36,0,反吹右组件
5482,4/14/2019,15,6,5,12,0,0,21,0,0,4,4,20,0,反吹左组件
1783,4/14/2019,21,-21,-1,5,0,0,0,0,0,5,6,20,0,反吹左组件
6800,4/14/2019,25,11,5,4,0,0,36,0,0,4,4,30,0,反吹左组件
1545,4/14/2019,25,10,7,6,0,0,35,0,0,5,6,32,0,反吹左组件，未完成
206G,4/13/2019,25,10,7,4,0,0,35,0,0,4,4,32,0,反吹左组件，未完成
5136,4/13/2019,27,4,10,3,0,0,31,0,0,5,5,37,0,反吹右组件，未完成
5478,4/13/2019,20,12,4,4,0,0,32,0,0,4,4,24,0,反吹左组件，未完成
1101,4/12/2019,15,17,7,3,0,0,32,0,0,2,2,22,0,反吹左组件，未完成
5288,4/12/2019,16,-16,-16,0,0,0,0,23,0,0,0,0,18,反吹左、右组件
1101,4/11/2019,12,20,16,4,0,0,32,0,0,4,4,28,0,反吹左组件，未完成
5373,4/11/2019,18,14,12,9,0,0,32,0,0,8,8,30,0,反吹左组件，未完成
6065,4/10/2019,25,11,7,4,0,0,36,0,0,4,5,32,0,反吹左组件
5479,4/10/2019,15,7,18,5,0,0,22,0,0,6,7,33,0,反吹右组件
5136,4/10/2019,25,8,11,5,0,0,33,0,0,5,5,36,0,反吹右组件
1545,4/10/2019,26,7,10,5,0,0,33,0,0,5,5,36,0,反吹右组件
7886,4/10/2019,25,10,7,4,0,0,35,0,0,4,5,32,0,反吹左组件
1505,4/9/2019,26,10,3,4,0,0,36,0,0,4,4,29,0,反吹左组件，未完成
5359,4/9/2019,21,14,14,4,0,0,35,0,0,5,7,35,0,反吹左、右组件，未完成
7886,4/9/2019,25,11,9,6,0,0,36,0,0,4,6,34,0,反吹左组件，未完成
1491,4/8/2019,15,20,9,5,0,0,35,0,0,5,5,24,0,反吹左组件
1497,4/8/2019,25,7,12,4,0,0,32,0,0,4,4,37,0,反吹右组件
1927,4/8/2019,25,10,5,3,0,0,35,0,0,6,3,30,0,反吹左组件，未完成
5375,4/8/2019,25,12,11,9,0,0,37,0,0,8,9,36,0,反吹左、右组件
,,23,7,1,4,0,0,30,0,0,4,4,24,0,正常
,,10,6,10,7,0,0,16,0,0,6,6,20,0,正常
,,20,2,2,4,0,0,22,0,0,4,3,22,0,正常
,,21,5,4,2,0,0,26,0,0,3,3,25,0,正常
,,22,3,3,4,0,0,25,0,0,4,4,25,0,正常
,,25,-3,-1,4,0,0,22,0,0,6,4,24,0,正常
,,10,12,8,2,0,0,22,0,0,2,2,18,0,正常
,,13,-8,8,3,0,0,5,0,0,2,2,21,0,正常
,,25,-12,-1,4,0,0,13,0,0,4,4,24,0,正常
,,4,18,19,8,0,0,22,0,0,8,9,23,0,正常
,,15,13,13,6,0,0,28,0,0,8,8,28,0,正常
,,23,3,4,4,0,0,26,0,0,4,3,27,0,正常
,,16,5,6,4,0,0,21,0,0,4,4,22,0,正常
,,27,8,1,6,0,0,35,0,0,2,2,28,0,正常
,,20,4,4,4,0,0,24,0,0,4,4,24,0,正常
,,15,8,0,6,0,0,23,0,0,5,5,15,0,正常
,,26,6,4,6,0,0,32,0,0,6,6,30,0,正常
,,10,12,12,4,0,0,22,0,0,5,5,22,0,正常
,,2,19,14,3,0,0,21,0,0,3,3,16,0,正常
,,8,6,4,8,0,0,14,0,0,3,3,12,0,正常
,,9,13,15,4,0,0,22,0,0,6,4,24,0,正常
,,26,6,3,3,0,0,32,0,0,3,3,29,0,正常
,,26,8,6,3,0,0,34,0,0,5,4,32,0,正常
,,25,6,5,4,0,0,31,0,0,4,4,30,0,正常
,,22,6,2,5,0,0,28,0,0,6,5,24,0,正常
,,23,7,-3,4,0,0,30,0,0,6,6,20,0,正常
,,22,7,6,3,0,0,29,0,0,3,3,28,0,正常
,,24,6,6,3,0,0,30,0,0,3,3,30,0,正常
,,16,5,2,2,0,0,21,0,0,4,2,18,0,正常
,,18,3,2,3,0,0,21,0,0,4,4,20,0,正常
,,11,13,12,3,0,0,24,0,0,3,3,23,0,正常
,,15,9,7,6,0,0,24,0,0,5,6,22,0,正常
,,20,2,2,2,0,0,22,0,0,3,8,22,0,正常
,,25,4,6,1,0,0,29,0,0,9,8,31,0,正常
,,15,7,6,4,0,0,22,0,0,4,4,21,0,正常
,,28,0,-2,2,0,0,28,0,0,3,3,26,0,正常
,,10,11,10,3,0,0,21,0,0,2,3,20,0,正常
,,20,0,0,4,0,0,20,0,0,4,4,20,0,正常
,,18,4,3,4,0,0,22,0,0,5,4,21,0,正常
,,28,2,-2,4,0,0,30,0,0,4,3,26,0,正常
,,18,8,7,6,0,0,26,0,0,5,6,25,0,正常
,,30,2,0,6,0,0,32,0,0,7,6,30,0,正常
,,12,14,10,6,0,0,26,0,0,5,6,22,0,正常
,,15,13,9,5,0,0,28,0,0,4,4,24,0,正常
,,15,7,6,6,0,0,22,0,0,4,4,21,0,正常
,,26,0,-2,6,0,0,26,0,0,2,2,24,0,正常
,,26,6,4,6,0,0,32,0,0,3,4,30,0,正常
,,5,23,13,2,0,0,28,0,0,3,2,18,0,正常
,,5,23,13,2,0,0,28,0,0,3,2,18,0,正常
,,27,3,1,4,0,0,30,0,0,5,4,28,0,正常
,,28,2,4,8,0,0,30,0,0,6,5,32,0,正常
,,27,3,3,4,0,0,30,0,0,6,4,30,0,正常
,,5,15,11,3,0,0,20,0,0,3,3,16,0,正常
,,25,3,4,5,0,0,28,0,0,5,5,29,0,正常
,,5,17,13,4,0,0,22,0,0,4,4,18,0,正常
,,26,6,3,4,0,0,32,0,0,4,4,29,0,正常
,,27,3,3,6,0,0,30,0,0,6,6,30,0,正常
,,15,11,10,4,0,0,26,0,0,5,5,25,0,正常
,,15,11,10,4,0,0,26,0,0,5,5,25,0,正常
,,13,11,10,4,0,0,24,0,0,4,5,23,0,正常
,,22,8,8,3,0,0,30,0,0,4,3,30,0,正常
,,24,2,2,2,0,0,26,0,0,3,2,26,0,正常
,,16,6,12,4,0,0,22,0,0,4,4,28,0,正常
,,16,10,8,5,0,0,26,0,0,5,5,24,0,正常
,,15,10,11,4,0,0,25,0,0,4,4,26,0,正常
,,15,3,4,5,0,0,18,0,0,5,5,19,0,正常
,,16,8,6,2,0,0,24,0,0,3,2,22,0,正常
,,16,10,10,2,0,0,26,0,0,2,2,26,0,正常
,,16,4,4,4,0,0,20,0,0,4,4,20,0,正常
,,26,6,6,4,0,0,32,0,0,4,4,32,0,正常
,,15,13,7,5,0,0,28,0,0,5,5,22,0,正常
,,25,7,5,2,0,0,32,0,0,4,2,30,0,正常
,,15,9,7,4,0,0,24,0,0,4,4,22,0,正常
,,28,6,2,6,0,0,34,0,0,6,5,30,0,正常
,,29,7,4,4,0,0,36,0,0,6,6,33,0,正常
,,16,10,8,4,0,0,26,0,0,4,4,24,0,正常
,,29,3,2,5,0,0,32,0,0,5,4,31,0,正常
,,25,5,6,3,0,0,30,0,0,4,4,31,0,正常
,,11,9,7,4,0,0,20,0,0,2,2,18,0,正常
,,15,11,9,4,0,0,26,0,0,5,4,24,0,正常
,,25,5,3,4,0,0,30,0,0,4,4,28,0,正常
,,16,4,6,4,0,0,20,0,0,5,4,22,0,正常
,,16,10,8,6,0,0,26,0,0,6,5,24,0,正常
,,16,10,8,5,0,0,26,0,0,6,5,24,0,正常
,,15,12,9,6,0,0,27,0,0,5,6,24,0,正常
,,29,1,3,9,0,0,30,0,0,9,7,32,0,正常
,,24,8,4,4,0,0,32,0,0,6,4,28,0,正常
,,15,10,-15,4,0,0,25,0,0,4,5,0,0,正常
,,15,10,8,4,0,0,25,0,0,4,5,23,0,正常
,,15,10,8,4,0,0,25,0,0,4,5,23,0,正常
,,18,4,7,5,0,0,22,0,0,3,4,25,0,正常
,,24,4,0,1,0,0,28,0,0,2,1,24,0,正常
,,30,2,2,6,0,0,32,0,0,2,2,32,0,正常
,,29,7,6,6,0,0,36,0,0,5,4,35,0,正常
,,25,1,5,4,0,0,26,0,0,4,4,30,0,正常
,,21,5,3,3,0,0,26,0,0,4,4,24,0,正常
,,20,5,4,5,0,0,25,0,0,5,4,24,0,正常
,,10,15,12,4,0,0,25,0,0,4,5,22,0,正常
,,10,15,12,4,0,0,25,0,0,4,5,22,0,正常
,,18,10,10,3,0,0,28,0,0,3,3,28,0,正常
,,20,8,2,3,0,0,28,0,0,3,3,22,0,正常
,,10,13,10,2,0,0,23,0,0,4,4,20,0,正常
,,20,8,2,3,0,0,28,0,0,3,3,22,0,正常
,,7,14,12,4,0,0,21,0,0,3,4,19,0,正常
,,13,9,7,4,0,0,22,0,0,3,4,20,0,正常
,,29,2,1,4,0,0,31,0,0,3,3,30,0,正常
,,29,4,3,3,0,0,33,0,0,3,3,32,0,正常
,,29,4,3,3,0,0,33,0,0,3,3,32,0,正常
,,19,3,3,3,0,0,22,0,0,4,4,22,0,正常
,,30,2,3,6,0,0,32,0,0,8,8,33,0,正常
,,10,10,10,2,0,0,20,0,0,4,6,20,0,正常
,,28,6,5,4,0,0,34,0,0,4,5,33,0,正常
,,10,10,10,3,0,0,20,0,0,8,8,20,0,正常
,,29,4,3,5,0,0,33,0,0,4,5,32,0,正常
,,14,12,12,3,0,0,26,0,0,3,3,26,0,正常
,,29,7,3,6,0,0,36,0,0,5,5,32,0,正常
,,28,6,2,3,0,0,34,0,0,6,6,30,0,正常
,,29,0,1,4,0,0,29,0,0,9,8,30,0,正常
,,17,7,3,5,0,0,24,0,0,6,5,20,0,正常
,,20,-20,6,4,0,0,0,0,0,4,4,26,0,正常
,,18,8,7,6,0,0,26,0,0,4,4,25,0,正常
,,15,9,7,6,0,0,24,0,0,4,4,22,0,正常
,,30,2,2,6,0,0,32,0,0,6,7,32,0,正常
,,30,0,-3,4,0,0,30,0,0,5,5,27,0,正常
,,8,13,13,3,0,0,21,0,0,2,2,21,0,正常
,,30,-2,-2,5,0,0,28,0,0,5,5,28,0,正常
,,28,-1,0,4,0,0,27,0,0,6,4,28,0,正常
,,18,-18,-18,0,0,0,0,6,0,0,0,0,6,正常
,,15,11,8,4,0,0,26,0,0,4,4,23,0,正常
,,22,-1,4,4,0,0,21,0,0,4,3,26,0,正常
,,28,4,1,3,0,0,32,0,0,5,4,29,0,正常
,,20,4,2,6,0,0,24,0,0,6,6,22,0,正常
,,18,4,0,4,0,0,22,0,0,3,4,18,0,正常
,,28,3,3,5,0,0,31,0,0,4,4,31,0,正常
,,8,18,12,4,0,0,26,0,0,6,6,20,0,正常
,,20,4,4,4,0,0,24,0,0,4,4,24,0,正常
,,20,8,2,4,0,0,28,0,0,2,2,22,0,正常
,,27,7,5,4,0,0,34,0,0,4,4,32,0,正常
,,16,8,6,4,0,0,24,0,0,4,4,22,0,正常
,,21,5,6,5,0,0,26,0,0,5,5,27,0,正常
,,22,6,6,3,0,0,28,0,0,4,4,28,0,正常
,,23,3,2,7,0,0,26,0,0,4,6,25,0,正常
,,26,0,4,2,0,0,26,0,0,4,4,30,0,正常
,,23,-1,1,3,0,0,22,0,0,4,4,24,0,正常
,,15,6,7,4,0,0,21,0,0,4,5,22,0,正常
,,20,6,5,6,0,0,26,0,0,6,6,25,0,正常
,,20,3,3,3,0,0,23,0,0,6,3,23,0,正常
,,18,6,7,4,0,0,24,0,0,4,5,25,0,正常
,,21,9,5,6,0,0,30,0,0,5,5,26,0,正常
,,21,2,1,5,0,0,23,0,0,5,5,22,0,正常
,,27,-1,2,4,0,0,26,0,0,4,4,29,0,正常
,,20,8,8,4,0,0,28,0,0,4,4,28,0,正常
,,30,-6,-4,4,0,0,24,0,0,5,5,26,0,正常
,,16,3,1,4,0,0,19,0,0,2,2,17,0,正常
,,26,4,2,2,0,0,30,0,0,8,8,28,0,正常
,,10,9,6,2,0,0,19,0,0,3,2,16,0,正常
,,10,10,10,2,0,0,20,0,0,2,2,20,0,正常
,,20,4,4,6,0,0,24,0,0,5,5,24,0,正常
,,18,4,5,2,0,0,22,0,0,3,3,23,0,正常
,,21,3,7,4,0,0,24,0,0,4,5,28,0,正常
,,28,4,4,2,0,0,32,0,0,2,2,32,0,正常
,,18,8,7,4,0,0,26,0,0,5,4,25,0,正常
,,20,0,-2,4,0,0,20,0,0,4,4,18,0,正常
,,18,2,6,8,0,0,20,0,0,6,5,24,0,正常
,,18,9,9,4,0,0,27,0,0,4,4,27,0,正常
,,18,9,8,5,0,0,27,0,0,4,4,26,0,正常
,,15,6,7,3,0,0,21,0,0,4,4,22,0,正常
,,21,3,4,5,0,0,24,0,0,4,4,25,0,正常
,,20,3,3,5,0,0,23,0,0,5,4,23,0,正常
,,22,5,4,4,0,0,27,0,0,4,3,26,0,正常
,,27,-1,-1,8,0,0,26,0,0,4,4,26,0,正常
,,17,8,6,3,0,0,25,0,0,3,2,23,0,正常
,,19,5,5,6,0,0,24,0,0,6,6,24,0,正常
,,23,5,5,5,0,0,28,0,0,4,5,28,0,正常
,,12,9,9,6,0,0,21,0,0,4,4,21,0,正常
,,12,10,6,5,0,0,22,0,0,6,6,18,0,正常
,,28,3,4,5,0,0,31,0,0,6,6,32,0,正常
,,27,7,6,9,0,0,34,0,0,7,8,33,0,正常
,,28,5,4,6,0,0,33,0,0,8,6,32,0,正常
,,27,5,8,4,0,0,32,0,0,6,4,35,0,正常
,,21,5,7,8,0,0,26,0,0,8,8,28,0,正常
,,24,-2,2,6,0,0,22,0,0,7,6,26,0,正常
,,16,10,8,6,0,0,26,0,0,6,5,24,0,正常
,,18,10,8,5,0,0,28,0,0,5,5,26,0,正常
,,22,4,1,3,0,0,26,0,0,4,5,23,0,正常
,,21,10,7,3,0,0,31,0,0,3,2,28,0,正常
,,28,-2,2,8,0,0,26,0,0,8,6,30,0,正常
,,16,10,12,5,0,0,26,0,0,5,5,28,0,正常
,,20,4,4,4,0,0,24,0,0,4,4,24,0,正常
,,10,10,8,4,0,0,20,0,0,3,4,18,0,正常
,,19,9,10,5,0,0,28,0,0,5,4,29,0,正常
,,20,8,7,4,0,0,28,0,0,5,4,27,0,正常
,,19,4,7,3,0,0,23,0,0,2,2,26,0,正常
,,16,-6,0,2,0,0,10,0,0,2,2,16,0,正常
,,20,7,6,5,0,0,27,0,0,5,4,26,0,正常
,,22,6,7,4,0,0,28,0,0,3,4,29,0,正常
,,10,10,8,4,0,0,20,0,0,5,5,18,0,正常
,,12,8,6,6,0,0,20,0,0,6,6,18,0,正常
,,23,3,-7,2,0,0,26,0,0,4,4,16,0,正常
,,24,5,2,6,0,0,29,0,0,4,4,26,0,正常
,,30,6,2,5,0,0,36,0,0,5,6,32,0,正常
,,16,8,8,7,0,0,24,0,0,7,7,24,0,正常
,,17,8,5,5,0,0,25,0,0,6,6,22,0,正常
,,21,8,9,4,0,0,29,0,0,5,5,30,0,正常
,,25,-1,7,4,0,0,24,0,0,4,4,32,0,正常
,,25,1,3,3,0,0,26,0,0,8,4,28,0,正常
,,21,5,7,4,0,0,26,0,0,4,4,28,0,正常
,,17,7,5,4,0,0,24,0,0,4,4,22,0,正常
,,22,4,4,4,0,0,26,0,0,4,4,26,0,正常
