ÈÕÆÚ,µØµã,·É»úºÅ,»úÐÍ,»·¾³ÎÂ¶È(¡æ),×ó±ßCONT CABIN DUCT,×ó±ßL PACK,ÓÒ±ßFWD DUCT,ÓÒ±ßAFT DUCT,ÓÒ±ßL PACK,Ö´ÐÐ·´´µ×ó²à,Ö´ÐÐ·´´µÓÒ²à,¸ü»»²¿¼þ,Fail,×óÎÂ²î,ÓÒÎÂ²î
2019-06-21 09:45,KMG,5409,737-800,20,4,24,4,4,26,,,,,4,6
2019-06-21 08:50,HAK,1785,737-800,30,6,34,9,8,37,,,,,4,7
2019-06-21 08:35,KMG,6015,737-800,20,4,30,4,4,24,,,,,10,4
2019-06-21 08:30,FOC,7113,737-800,30,8,37,6,6,37,,,,,7,7
2019-06-21 08:29,FOC,7113,737-800,30,8,38,6,6,37,,,,,8,7
2019-06-21 08:16,TYN,1728,737-800,25,4,28,5,5,24,,,,,3,-1
2019-06-21 07:51,URC,7198,737-800,22,4,24,4,3,26,,,,,2,4
2019-06-21 07:31,XMN,5480,737-800,26,6,34,6,6,32,,,,,8,6
2019-06-21 07:31,XMN,5479,737-800,28,6,34,6,5,32,,,,,6,4
2019-06-21 07:30,XMN,7399,737-800,28,4,32,4,5,30,,,,,4,2
2019-06-21 07:24,HHA,5405,737-800,31,6,35,4,6,34,,,,,4,3
2019-06-21 06:53,HHA,1347,737-800,30,7,35,4,5,34,,,,,5,4
2019-06-21 06:53,FOC,1348,737-800,30,6,36,7,7,34,,,,,6,4
2019-06-21 06:44,PEK,1213,737-800,27,6,36,6,6,34,,,,,9,7
2019-06-21 06:41,FOC,1906,737-800,30,6,35,7,6,34,,,,,5,4
2019-06-21 06:28,URC,205V,737-800,24,6,28,4,6,26,,,,,4,2
2019-06-21 06:22,SYX,1489,737-800,28,8,37,6,6,35,,,,,9,7
2019-06-21 06:22,URC,1498,737-800,21,4,29,4,4,27,,,,,8,6
2019-06-21 06:21,SYX,5662,737-800,28,8,36,6,8,32,,,,,8,4
2019-06-21 06:21,URC,5713,737-800,22,5,28,6,4,28,,,,,6,6
2019-06-21 06:20,URC,1726,737-800,22,4,29,4,4,27,,,,,7,5
2019-06-21 06:16,PEK,5538,737-800,30,7,36,4,3,36,,,,,6,6
2019-06-21 06:01,XIY,1733,737-800,20,3,29,3,2,27,,,,,9,7
2019-06-21 05:53,PEK,5539,737-800,28,9,30,6,6,26,,,,,2,-2
2019-06-21 05:47,FOC,7395,737-800,30,6,34,7,7,36,,,,,4,6
2019-06-21 05:46,CKG,1386,737-800,24,8,40,7,7,38,1,1,,11,16,14
2019-06-21 05:34,PEK ,5482,737-800,28,4,30,4,5,30,,,,,2,2
2019-06-21 05:34,PEK ,5482,737-800,28,4,30,4,4,30,,,,,2,2
2019-06-21 05:29,HGH,1101,737-800,24,3,33,2,2,30,,,,,9,6
2019-06-21 05:19,XIY,1480,737-800,21,4,26,4,4,26,,,,,5,5
2019-06-21 05:11,HHA,5540,737-800,30,5,34,6,5,35,,,,,4,5
2019-06-21 05:10,HHA,5540,737-800,30,5,34,6,5,35,,,,,4,5
2019-06-21 04:51,CAN,5483,737-800,30,6,36,4,4,36,,,,,6,6
2019-06-21 04:45,KMG,6800,737-800,20,4,26,4,4,26,,,,,6,6
2019-06-21 04:39,XIY,5116,737-800,21,4,26,4,4,27,,,,,5,6
2019-06-21 04:38,CGO,1798,737-800,22,4,33,4,4,28,,,,,11,6
2019-06-21 04:31,PEK,5580,737-800,25,3,31,2,3,35,,,,,6,10
2019-06-21 04:30,URC,2157,737-800,21,4,25,4,4,24,,,,,4,3
2019-06-21 04:29,URC,2157,737-800,21,4,25,4,4,24,,,,,4,3
2019-06-21 04:22,PEK,6061,737-800,25,6,29,5,5,30,,,,,4,5
2019-06-21 04:17,ZGC,7398,737-800,15,8,20,8,7,18,,,,,5,3
2019-06-21 04:14,URC,1323,737-800,22,3,29,3,3,26,,,,,7,4
2019-06-21 04:13,PEK,6103,737-800,27,6,30,8,8,34,,,,,3,7
2019-06-21 04:13,XIY,5115,737-800,21,3,22,6,6,24,,,,,1,3
2019-06-21 04:11,DLC,1487,737-800,20,3,28,3,3,28,,,,,8,8
2019-06-21 04:09,CAN,5418,737-800,30,6,36,6,4,36,,,,,6,6
2019-06-21 04:07,DLC,1103,737-800,20,4,28,4,4,24,,,,,8,4
2019-06-21 04:06,HHA,1542,737-800,29,2,22,4,6,23,,,,,-7,-6
2019-06-21 04:05,XIY,1482,737-800,20,6,30,6,5,24,,,,,10,4
2019-06-21 04:04,KMG,7167,737-800,20,8,30,6,6,24,,,,,10,4
2019-06-21 04:02,PEK,5465,737-800,27,4,34,4,4,36,,,,,7,9
2019-06-21 03:54,XIY,1161,737-800,20,4,31,4,4,30,,,,,11,10
2019-06-21 03:54,FOC,5406,737-800,27,6,36,5,6,32,,,,,9,5
2019-06-21 03:46,CAN,1502,737-800,28,4,32,4,4,34,,,,,4,6
2019-06-21 03:43,DLC,7173,737-800,21,4,28,4,4,28,,,,,7,7
2019-06-21 03:39,DLC,1103,737-800,20,4,28,4,4,24,,,,,8,4
2019-06-21 03:38,KMG,1208,737-800,18,3,29,3,3,28,,,,,11,10
2019-06-21 03:36,XIY,1162,737-800,20,5,28,5,5,28,,,,,8,8
2019-06-21 03:32,DLC,1547,737-800,20,6,28,6,6,28,,,,,8,8
2019-06-21 03:27,5428,DLC,737-800,21,4,26,5,4,29,,,,,5,8
2019-06-21 03:24,KMG,7991,737-800,20,6,32,6,6,30,,,,,12,10
2019-06-21 03:20,HAK,5638,737-800,28,6,37,7,7,37,,,,,9,9
2019-06-21 03:20,DLC,1496,737-800,21,6,30,5,5,30,,,,,9,9
2019-06-21 03:19,HHA,1928,737-800,29,5,27,4,4,28,,,,,-2,-1
2019-06-21 03:19,ZGC,5338,737-800,16,4,24,4,4,26,,,,,8,10
2019-06-21 03:19,ZGC,5852,737-800,15,4,26,4,4,26,,,,,11,11
2019-06-21 03:17,XIY,1729,737-800,21,4,28,4,4,29,,,,,7,8
2019-06-21 03:17,ZGC,7886,737-800,20,4,26,2,2,26,,,,,6,6
2019-06-21 03:16,CAN,5417,737-800,30,7,37,8,8,37,,,,,7,7
2019-06-21 03:13,MIG,5449,737-800,20,3,31,2,3,29,,,,,11,9
2019-06-21 03:11,PEK,1796,737-800,27,5,32,5,6,30,,,,,5,3
2019-06-21 03:03,HAK,5625,737-800,29,8,36,6,5,34,,,,,7,5
2019-06-21 02:59,XIY,1548,737-800,30,4,30,4,4,26,,,,,0,-4
2019-06-21 02:57,SZC,1346,737-800,29,4,35,5,5,35,,,,,6,6
2019-06-21 02:54,FOC,1906,737-800,30,7,36,8,7,36,,,,,6,6
2019-06-21 02:53,XIY,1481,737-800,22,6,30,6,6,32,,,,,8,10
2019-06-21 02:49,HHA,5709,737-800,30,10,39,10,11,39,1,1,,11,9,9
2019-06-21 02:47,HAK,5416,737-800,29,4,33,4,4,34,,,,,4,5
2019-06-21 02:47,CTU,1209,737-800,28,5,36,4,5,32,,,,,8,4
2019-06-21 02:44,HAK,5579,737-800,29,5,32,8,9,33,,,,,3,4
2019-06-21 02:43,XIY,1795,737-800,22,4,35,6,7,36,1,1,,11,13,14
2019-06-21 02:43,XIY,5180,737-800,20,6,32,8,8,34,,,,,12,14
2019-06-21 02:43,INC,1483,737-800,19,4,26,8,8,30,,,,,7,11
2019-06-21 02:42,HHA,5521,737-800,30,6,33,7,7,34,,,,,3,4
2019-06-21 02:41,XIY,1797,737-800,20,4,28,4,4,26,,,,,8,6
2019-06-21 02:37,SYX,5083,737-800,31,7,28,7,7,35,,,,,-3,4
2019-06-21 02:37,URC,1727,737-800,22,4,30,4,6,30,,,,,8,8
2019-06-21 02:34,CGO,7992,737-800,23,6,33,6,6,34,,,,,10,11
2019-06-21 02:32,SZX,7619,737-800,25,6,32,6,6,34,,,,,7,9
2019-06-21 02:30,URC,1725,737-800,22,4,28,2,2,26,,,,,6,4
2019-06-21 02:30,SYX,5439,737-800,30,7,36,7,6,36,,,,,6,6
2019-06-21 02:29,SZX,1372,737-800,30,6,37,7,6,36,,,,,7,6
2019-06-21 02:24,XIY,1902,737-800,20,5,30,5,5,26,,,,,10,6
2019-06-21 02:24,HGH,5712,737-800,24,2,28,2,2,24,,,,,4,0
2019-06-21 02:19,URC,1322,737-800,20,2,26,3,3,27,,,,,6,7
2019-06-21 02:19,SZX,5429,737-800,30,5,34,7,7,36,,,,,4,6
2019-06-21 02:16,PEK,5580,737-800,28,6,38,4,4,36,,,,,10,8
2019-06-21 02:16,CAN,7379,737-800,30,4,36,4,4,36,,,,,6,6
2019-06-21 02:15,URC,1325,737-800,24,4,26,4,4,22,,,,,2,-2
2019-06-21 02:10,XIY,1548,737-800,30,4,30,4,4,26,,,,,0,-4
2019-06-21 02:09,HAK,5139,737-800,29,8,31,8,7,34,,,,,2,5
2019-06-21 02:01,HAK,1215,737-800,29,7,35,8,7,34,,,,,6,5
2019-06-21 02:01,TYN,5372,737-800,25,6,26,6,7,27,,,,,1,2
2019-06-21 02:00,CGO,1587,737-800,23,5,29,4,4,27,,,,,6,4
2019-06-21 01:56,CGO,1586,737-800,24,4,30,4,4,24,,,,,6,0
2019-06-21 01:55,HGH,5637,737-800,24,4,34,2,2,32,,,,,10,8
2019-06-21 01:53,URC,5467,737-800,24,4,27,5,5,23,,,,,3,-1
2019-06-21 01:52,URAC,5611,737-800,21,4,24,4,4,26,,,,,3,5
2019-06-21 01:45,KMG,7993,737-800,20,6,28,6,6,26,,,,,8,6
2019-06-21 01:45,HRB,1562,737-800,17,4,24,4,5,26,,,,,7,9
2019-06-21 01:45,HAK,1491,737-800,29,6,36,6,6,36,,,,,7,7
2019-06-21 01:45,HAK,7378,737-800,29,6,35,6,5,35,,,,,6,6
2019-06-21 01:45,HRB,1559,737-800,16,2,25,3,3,24,,,,,9,8
2019-06-21 01:44,HAK,1735,737-800,29,8,35,5,6,32,,,,,6,3
2019-06-21 01:43,HGH,5138,737-800,24,4,34,4,4,29,,,,,10,5
2019-06-21 01:43,HAK,5466,737-800,30,6,34,8,7,32,,,,,4,2
2019-06-21 01:42,CKG,6065,737-800,26,4,34,5,5,34,,,,,8,8
2019-06-21 01:42,XIY,1163,737-800,21,3,30,2,2,30,,,,,9,9
2019-06-21 01:22,SYX,5686,737-800,30,5,35,6,6,37,,,,,5,7
2019-06-21 01:22,TYN,1996,737-800,27,4,25,4,4,26,,,,,-2,-1
2019-06-21 01:20,MIG,6809,737-800,20,6,30,6,7,32,,,,,10,12
2019-06-21 01:16,HAK,6060,737-800,30,7,36,5,4,36,,,,,6,6
2019-06-21 01:16,HAK,7175,737-800,30,4,30,4,4,30,,,,,0,0
2019-06-21 01:13,PEK,5623,737-800,26,6,36,6,8,28,1,,,1,10,2
2019-06-21 01:12,HAK,1545,737-800,35,7,35,6,6,33,,,,,0,-2
2019-06-21 01:12,YIH,1433,737-800,27,3,35,4,4,30,,,,,8,3
2019-06-21 01:09,HHA,1549,737-800,30,7,35,8,7,36,,,,,5,6
2019-06-21 01:08,HRB,1905,737-800,18,5,28,5,5,24,,,,,10,6
2019-06-21 01:07,CGO,5371,737-800,23,6,28,6,6,29,,,,,5,6
2019-06-21 01:06,URC,1995,737-800,21,6,30,6,5,30,,,,,9,9
2019-06-21 01:01,HAK,1501,737-800,35,7,35,7,6,35,,,,,0,0
2019-06-21 00:50,URC,205T,737-800,22,2,28,2,2,28,,,,,6,6
2019-06-21 00:50,URC,1996,737-800,21,6,30,6,5,30,,,,,9,9
2019-06-21 00:50,HAK,1141,737-800,30,8,36,7,7,32,,,,,6,2
2019-06-21 00:48,CAN,5337,737-800,30,6,36,5,4,35,,,,,6,5
2019-06-21 00:47,YIH,1351,737-800,25,5,30,6,5,30,,,,,5,5
2019-06-21 00:46,XIY,5522,737-800,21,4,30,6,5,25,,,,,9,4
2019-06-21 00:39,SYX,5359,737-800,30,7,36,7,6,36,,,,,6,6
2019-06-21 00:39,URC,1568,737-800,23,6,30,6,6,26,,,,,7,3
2019-06-21 00:38,HAK,5636,737-800,29,6,35,5,5,34,,,,,6,5
2019-06-21 00:36,URC,7377,737-800,21,6,20,4,3,21,,,,,-1,0
2019-06-21 00:35,ÃàÑô,5732,737-800,25,4,30,4,4,32,,,,,5,7
2019-06-21 00:32,SZX,7171,737-800,28,6,32,5,4,32,,,,,4,4
2019-06-21 00:28,CAN,1130,737-800,30,3,36,2,2,36,,,,,6,6
2019-06-21 00:25,HGH,1538,737-800,24,3,35,6,3,36,1,1,,11,11,12
2019-06-21 00:18,FOC,5430,737-800,30,6,36,6,5,36,,,,,6,6
2019-06-21 00:16,HRB,7105,737-800,18,3,27,4,4,23,,,,,9,5
2019-06-21 00:12,SZX,206H,737-800,30,4,35,4,3,36,,,,,5,6
2019-06-21 00:09,YIH,1359,737-800,29,7,34,5,5,35,,,,,5,6
2019-06-20 23:59,DLC,1786,737-800,22,4,30,4,4,24,,,,,8,2
2019-06-20 23:53,SYX,5478,737-800,30,6,36,5,6,35,,,,,6,5
2019-06-20 23:51,CAN,1490,737-800,30,5,35,4,5,35,,,,,5,5
2019-06-20 23:51,XIY,1799,737-800,30,5,35,6,4,30,,,,,5,0
2019-06-20 23:51,CAN,5346,737-800,30,7,36,5,5,35,,,,,6,5
2019-06-20 23:49,PEK ,1375,737-800,28,8,34,4,4,30,,,,,6,2
2019-06-20 23:48,ÐìÖÝ,7989,737-800,27,6,32,8,7,35,,,,,5,8
2019-06-20 23:42,CGO,5153,737-800,24,4,29,4,3,27,,,,,5,3
2019-06-20 23:33,URC,1570,737-800,24,6,30,6,6,25,,,,,6,1
2019-06-20 23:27,PEK,5687,737-800,25,5,27,7,4,32,,,,,2,7
2019-06-20 23:26,HAK,5137,737-800,30,6,30,5,5,34,,,,,0,4
2019-06-20 23:25,ÃàÑô,7990,737-800,26,3,32,3,3,30,,,,,6,4
2019-06-20 23:13,CAN,5520,737-800,30,6,36,6,6,36,,,,,6,6
2019-06-20 23:13,TYN,1503,737-800,27,4,28,4,4,28,,,,,1,1
2019-06-20 23:09,HAK,5853,737-800,29,7,36,5,6,32,,,,,7,3
2019-06-20 23:09,CGO,1569,737-800,24,2,27,2,2,25,,,,,3,1
2019-06-20 23:04,HGH,5462,737-800,24,4,30,4,4,23,,,,,6,-1
2019-06-20 22:57,URC,6995,737-800,22,4,30,6,5,24,,,,,8,2
2019-06-20 22:47,CKG,7616,737-800,26,4,28,4,6,28,,,,,2,2
2019-06-20 22:42,HGH,5358,737-800,26,6,26,4,6,28,,,,,0,2
2019-06-20 22:15,HAK,1373,737-800,29,4,35,4,5,32,,,,,6,3
2019-06-20 22:05,HAK,5733,737-800,29,8,36,6,6,33,,,,,7,4
2019-06-20 22:03,Î÷Äþ,5136,737-800,23,4,25,4,4,30,,,,,2,7
2019-06-20 22:03,URC,205U,737-800,22,1,26,3,1,27,,,,,4,5
2019-06-20 22:01,TYN,6808,737-800,28,4,28,4,4,28,,,,,0,0
2019-06-20 21:47,HAK,206F,737-800,31,3,36,3,3,32,,,,,5,1
2019-06-20 20:53,SHE,6063,737-800,25,5,32,4,4,30,,,,,7,5
2019-06-20 20:53,FOC,5503,737-800,30,4,31,4,3,31,,,,,1,1
2019-06-20 20:33,HAK,5082,737-800,30,8,37,8,8,36,,,,,7,6
2019-06-20 20:27,CGO,5855,737-800,24,6,28,6,6,28,,,,,4,4
2019-06-20 20:25,HAK,1783,737-800,31,4,36,6,5,37,,,,,5,6
2019-06-20 20:00,FOC,5503,737-800,30,4,31,4,3,31,,,,,1,1
2019-06-20 19:31,PEK,1102,737-800,30,4,32,3,4,32,,,,,2,2
2019-06-20 19:05,URC,206P,737-800,25,4,26,4,4,20,,,,,1,-5
2019-06-20 18:44,HGH,1492,737-800,24,4,32,3,3,33,,,,,8,9
2019-06-20 18:26,SYX,1541,737-800,33,7,36,8,9,37,,,,,3,4
2019-06-20 17:17,TYN,5373,737-800,30,6,26,7,6,28,,,,,-4,-2
2019-06-20 15:48,XIY,1493,737-800,23,5,27,6,6,26,,,,,4,3
2019-06-20 13:44,PEK,1213,737-800,34,6,32,4,6,34,,,,,-2,0
2019-06-20 12:07,CTU,1209,737-800,30,3,36,4,4,35,,,,,6,5
2019-06-20 11:05,CGO,1489,737-800,23,6,30,4,5,30,,,,,7,7
2019-06-20 09:58,KMG,5409,737-800,20,4,24,4,4,26,,,,,4,6
2019-06-20 09:08,KMG,1587,737-800,20,5,26,5,4,28,,,,,6,8
2019-06-20 08:48,YIH,1350,737-800,28,5,29,4,5,28,,,,,1,0
2019-06-20 08:46,DLC,1487,737-800,21,3,30,3,2,27,,,,,9,6
2019-06-20 08:45,DLC,7173,737-800,20,5,30,6,6,28,,,,,10,8
2019-06-20 08:30,PEK,1729,737-800,26,4,29,5,5,31,,,,,3,5
2019-06-20 08:22,KMG,7993,737-800,17,9,30,5,5,25,,,,,13,8
2019-06-20 07:24,ZGC,5636,737-800,19,6,18,5,6,18,,,,,-1,-1
2019-06-20 07:22,KMG,5449,737-800,20,5,34,6,6,30,,,,,14,10
2019-06-20 07:22,ZGC,5359,737-800,20,4,24,4,5,27,,,,,4,7
2019-06-20 07:20,ZGC,1797,737-800,20,6,18,4,5,20,,,,,-2,0
2019-06-20 07:18,ZGC,5480,737-800,20,6,24,7,6,25,,,,,4,5
2019-06-20 07:03,PEK,6066,737-800,25,6,34,6,6,32,,,,,9,7
2019-06-20 07:02,XIY,5116,737-800,20,3,26,4,4,25,,,,,6,5
2019-06-20 06:50,PEK,5623,737-800,25,4,34,4,5,34,,,,,9,9
2019-06-20 06:45,FOC,1906,737-800,28,5,34,6,5,35,,,,,6,7
2019-06-20 06:42,XIY,5373,737-800,21,6,29,6,6,28,,,,,8,7
2019-06-20 06:35,XIY,1351,737-800,22,5,30,5,4,31,,,,,8,9
2019-06-20 06:25,XMN,5465,737-800,28,8,36,6,8,36,,,,,8,8
2019-06-20 06:24,XMN,5405,737-800,26,6,36,5,4,24,1,,,1,10,-2
2019-06-20 06:23,XMN,7398,737-800,30,8,36,8,8,36,,,,,6,6
2019-06-20 06:23,XMN,7172,737-800,27,8,36,8,7,35,,,,,9,8
2019-06-20 06:18,HGH,5580,737-800,25,5,31,4,3,34,,,,,6,9
2019-06-20 06:09,KMG,7988,737-800,20,4,28,4,3,28,,,,,8,8
2019-06-20 06:03,PEK,1549,737-800,25,4,34,4,4,32,,,,,9,7
2019-06-20 05:59,URC,1726,737-800,26,4,28,4,4,30,,,,,2,4
2019-06-20 05:49,URC,1568,737-800,22,3,24,4,5,23,,,,,2,1
2019-06-20 05:48,URC,5467,737-800,25,2,22,2,2,22,,,,,-3,-3
2019-06-20 05:35,CAN,1785,737-800,30,3,35,5,6,35,,,,,5,5
2019-06-20 05:20,HGH,1547,737-800,28,4,30,4,4,32,,,,,2,4
2019-06-20 05:15,URC,1323,737-800,21,3,31,3,3,28,,,,,10,7
2019-06-20 05:04,MIG,5732,737-800,26,4,30,5,4,30,,,,,4,4
2019-06-20 05:02,FOC,1435,737-800,27,5,34,5,5,31,,,,,7,4
2019-06-20 05:01,FOC,1435,737-800,28,8,40,6,5,31,,,,,12,3
2019-06-20 05:00,CKG,7616,737-800,25,4,28,6,5,26,,,,,3,1
2019-06-20 04:55,XIY,5428,737-800,24,4,26,5,4,30,,,,,2,6
2019-06-20 04:44,CAN,1505,737-800,28,5,32,4,4,32,,,,,4,4
2019-06-20 04:42,SZX,5403,737-800,29,8,37,8,7,35,,,,,8,6
2019-06-20 04:41,FOC,7395,737-800,28,6,34,7,6,36,,,,,6,8
2019-06-20 04:40,FOC,7395,737-800,28,15,43,7,6,36,,,,,15,8
2019-06-20 04:37,XIY,1903,737-800,21,2,30,2,3,28,,,,,9,7
2019-06-20 04:34,SYX,6063,737-800,30,8,37,6,4,36,,,,,7,6
2019-06-20 04:34,HHA,5709,737-800,29,6,36,7,7,35,,,,,7,6
2019-06-20 04:32,URC,6268,737-800,25,4,26,4,5,26,,,,,1,1
2019-06-20 04:31,FOC,5687,737-800,27,4,30,4,4,32,,,,,3,5
2019-06-20 04:30,FOC,5687,737-800,27,4,30,4,4,32,,,,,3,5
2019-06-20 04:26,TYN ,5083 ,737-800,24,4,18,4,4,18,,,,,-6,-6
2019-06-20 04:25,KMG,6015,737-800,20,4,32,4,4,24,,,,,12,4
2019-06-20 04:17,HGH,1491,737-800,24,6,33,6,5,32,,,,,9,8
2019-06-20 04:16,CAN,5346,737-800,28,7,35,8,8,32,,,,,7,4
2019-06-20 04:14,HAK,1503,737-800,28,3,37,4,4,37,,,,,9,9
2019-06-20 04:10,SZX,1215,737-800,29,8,36,8,6,36,,,,,7,7
2019-06-20 04:07,URC,1102,737-800,25,4,25,3,4,26,,,,,0,1
2019-06-20 04:06,URC,5855,737-800,23,6,29,6,6,26,,,,,6,3
2019-06-20 04:04,HAK,1997,737-800,30,5,36,3,3,34,,,,,6,4
2019-06-20 03:58,CAN,1490,737-800,30,5,35,6,5,35,,,,,5,5
2019-06-20 03:58,XIY,5115,737-800,21,4,20,6,5,18,,,,,-1,-3
2019-06-20 03:54,HGH,5338,737-800,26,2,28,4,3,32,,,,,2,6
2019-06-20 03:52,SYX,5439,737-800,30,8,36,6,7,35,,,,,6,5
2019-06-20 03:52,HAK,7618,737-800,30,4,36,4,4,36,,,,,6,6
2019-06-20 03:49,URC,1570,737-800,22,4,26,4,4,24,,,,,4,2
2019-06-20 03:47,URC,1929,737-800,20,2,20,2,3,24,,,,,0,4
2019-06-20 03:42,SYX,5153,737-800,29,7,36,4,4,32,,,,,7,3
2019-06-20 03:40,FOC,7113,737-800,28,7,36,6,6,35,,,,,8,7
2019-06-20 03:39,XIY,5180,737-800,22,5,30,5,5,30,,,,,8,8
2019-06-20 03:38,HHA,5709,737-800,29,6,36,7,7,38,,,,,7,9
2019-06-20 03:33,URC,5713,737-800,22,4,22,5,6,22,,,,,0,0
2019-06-20 03:32,PEK,5358,737-800,25,4,26,4,4,28,,,,,1,3
2019-06-20 03:30,DLC,1545,737-800,20,5,32,5,5,32,,,,,12,12
2019-06-20 03:26,CGO,1586,737-800,25,4,32,4,4,30,,,,,7,5
2019-06-20 03:24,URC ,5661,737-800,26,3,26,4,4,28,,,,,0,2
2019-06-20 03:19,CAN,5337,737-800,27,7,36,6,7,35,,,,,9,8
2019-06-20 03:19,HAK,5483,737-800,29,7,36,7,6,32,,,,,7,3
2019-06-20 03:18,HAJ,1786,737-800,29,5,36,6,6,30,,,,,7,1
2019-06-20 03:16,FOC,5687,737-800,26,8,37,5,5,35,,,,,11,9
2019-06-20 03:15,XIY,1481,737-800,21,5,30,6,6,32,,,,,9,11
2019-06-20 03:13,URC,206P,737-800,25,4,25,3,3,24,,,,,0,-1
2019-06-20 03:12,XIY,1903,737-800,21,2,40,2,3,28,,,,,19,7
2019-06-20 03:12,SZX,7175,737-800,29,4,32,4,4,30,,,,,3,1
2019-06-20 03:09,XIY,1928,737-800,25,5,24,5,5,26,,,,,-1,1
2019-06-20 03:07,XIY,1482,737-800,21,3,32,3,3,28,,,,,11,7
2019-06-20 03:03,HAK,1346,737-800,29,7,37,5,5,35,,,,,8,6
2019-06-20 02:52,SYX,5662,737-800,29,6,30,5,3,33,,,,,1,4
2019-06-20 02:49,HHA,5540,737-800,29,6,35,4,3,32,,,,,6,3
2019-06-20 02:48,DLC,5375,737-800,19,2,27,5,5,29,,,,,8,10
2019-06-20 02:43,XIY,1493,737-800,22,6,28,6,7,24,,,,,6,2
2019-06-20 02:36,HAK,1373,737-800,28,4,32,4,4,31,,,,,4,3
2019-06-20 02:35,DLC,1375,737-800,21,5,28,4,5,24,,,,,7,3
2019-06-20 02:33,DLC,1375,737-800,21,5,28,4,5,24,,,,,7,3
2019-06-20 02:32,XIY,1162,737-800,21,3,34,3,3,30,,,,,13,9
2019-06-20 02:27,TYN,6808,737-800,20,4,30,4,4,28,,,,,10,8
2019-06-20 02:26,PEK,5539,737-800,26,5,30,6,6,28,,,,,4,2
2019-06-20 02:26,SYX ,1501,737-800,30,6,35,5,4,36,,,,,5,6
2019-06-20 02:24,PEK,1796,737-800,24,6,30,6,7,28,,,,,6,4
2019-06-20 02:22,PEK,1735,737-800,24,5,30,5,4,26,,,,,6,2
2019-06-20 02:22,URC,2157,737-800,25,4,24,4,6,27,,,,,-1,2
2019-06-20 02:21,HGH,5462,737-800,25,4,30,5,4,31,,,,,5,6
2019-06-20 02:19,SZX,5625,737-800,30,7,36,5,4,34,,,,,6,4
2019-06-20 02:18,HHA,5406,737-800,30,5,34,5,5,32,,,,,4,2
2019-06-20 02:17,KMG,7989,737-800,20,7,32,8,6,32,,,,,12,12
2019-06-20 02:16,SYX,5478,737-800,30,8,37,6,4,30,,,,,7,0
2019-06-20 02:16,KMG,7989,737-800,20,7,32,8,6,32,,,,,12,12
2019-06-20 02:16,KAK,206G,737-800,28,4,36,4,4,35,,,,,8,7
2019-06-20 02:11,URC,5637,737-800,27,3,27,3,3,26,,,,,0,-1
2019-06-20 02:11,HAK,1542,737-800,30,4,37,4,4,33,,,,,7,3
2019-06-20 02:10,URC,6268,737-800,26,3,24,2,2,25,,,,,-2,-1
2019-06-20 02:07,SYX,5686,737-800,29,8,36,6,6,34,,,,,7,5
2019-06-20 01:58,CAN,5579,737-800,29,5,35,5,6,36,,,,,6,7
2019-06-20 01:56,XIY,5581,737-800,21,4,24,5,4,28,,,,,3,7
2019-06-20 01:56,HHA,1783,737-800,30,6,33,6,7,35,,,,,3,5
2019-06-20 01:55,CGO,1569,737-800,24,4,29,4,4,29,,,,,5,5
2019-06-20 01:51,HAK,6061,737-800,30,4,34,6,4,36,,,,,4,6
2019-06-20 01:51,HAK,5733,737-800,29,9,37,5,5,33,,,,,8,4
2019-06-20 01:49,HGH,5418,737-800,23,6,30,4,5,29,,,,,7,6
2019-06-20 01:48,XIY,1480,737-800,21,4,29,5,4,28,,,,,8,7
2019-06-20 01:47,FOC,5430,737-800,28,6,34,6,5,36,,,,,6,8
2019-06-20 01:46,HHA,1995,737-800,30,7,35,7,6,35,,,,,5,5
2019-06-20 01:34,XIY,1161,737-800,21,5,30,4,4,32,,,,,9,11
2019-06-20 01:28,PEK,5482,737-800,25,4,30,7,6,30,,,,,5,5
2019-06-20 01:22,CKG,1386,737-800,25,7,37,5,5,37,,,,,12,12
2019-06-20 01:22,URC,1725,737-800,27,5,30,4,4,32,,,,,3,5
2019-06-20 01:20,XIY,5141,737-800,22,4,28,4,4,26,,,,,6,4
2019-06-20 01:19,XIY,1795,737-800,25,4,34,8,8,34,,,,,9,9
2019-06-20 01:19,XIY,1795,737-800,25,4,34,8,8,34,,,,,9,9
2019-06-20 01:19,XIY,5852,737-800,25,4,30,4,4,28,,,,,5,3
2019-06-20 01:13,URC,7198,737-800,25,3,30,3,3,28,,,,,5,3
2019-06-20 01:12,MIG,6809,737-800,26,5,30,6,5,30,,,,,4,4
2019-06-20 01:10,CGO,7167,737-800,26,5,25,6,5,26,,,,,-1,0
2019-06-20 01:10,TYN,1996,737-800,23,4,26,5,6,28,,,,,3,5
2019-06-20 01:09,URC,5611,737-800,25,6,27,6,5,27,,,,,2,2
2019-06-20 01:08,URC,1498,737-800,25,4,28,4,4,27,,,,,3,2
2019-06-20 01:08,HHA,1347,737-800,30,7,36,4,5,36,,,,,6,6
2019-06-20 01:06,SZX,6062,737-800,30,2,34,2,2,36,,,,,4,6
2019-06-20 01:04,SYX,5138,737-800,29,9,37,8,8,36,,,,,8,7
2019-06-20 00:59,XIY,1483,737-800,22,4,24,6,6,26,,,,,2,4
2019-06-20 00:52,CAN,1502,737-800,29,4,32,4,4,34,,,,,3,5
2019-06-20 00:51,URC,205V,737-800,23,5,28,3,4,28,,,,,5,5
2019-06-20 00:48,URC,1725,737-800,27,5,30,4,4,32,,,,,3,5
2019-06-20 00:46,YIH,1348,737-800,26,4,32,4,4,30,,,,,6,4
2019-06-20 00:44,URC,7377,737-800,27,6,30,6,6,29,,,,,3,2
2019-06-20 00:44,MIG,1798,737-800,24,4,36,4,4,28,1,,,1,12,4
2019-06-20 00:43,PEK,5538,737-800,25,6,35,2,4,32,,,,,10,7
2019-06-20 00:40,HRB,1905,737-800,19,4,28,4,4,24,,,,,9,5
2019-06-20 00:36,XIY,5522,737-800,26,5,31,5,5,25,,,,,5,-1
2019-06-20 00:36,CAN,5481,737-800,30,5,34,5,5,32,,,,,4,2
2019-06-20 00:35,HAK,1503,737-800,28,3,37,4,4,37,,,,,9,9
2019-06-20 00:28,HAK,1793,737-800,29,9,37,4,4,37,,,,,8,8
2019-06-20 00:14,CGO,1548,737-800,27,0,22,2,1,25,,,,,-5,-2
2019-06-20 00:10,SZX,1372,737-800,30,6,36,6,6,37,,,,,6,7
2019-06-20 00:09,CAN,5346,737-800,27,11,42,8,8,32,,,,,15,5
2019-06-20 00:08,CAN,1787,737-800,30,1,37,9,9,37,,,,,7,7
2019-06-20 00:05,SZX,5429,737-800,30,4,36,7,7,36,,,,,6,6
2019-06-20 00:05,PEK,1213,737-800,25,6,34,6,6,34,,,,,9,9
2019-06-20 00:05,YIH,1433,737-800,25,3,32,3,3,32,,,,,7,7
2019-06-20 00:00,HAK,5463,737-800,29,5,30,6,5,32,,,,,1,3
2019-06-19 23:59,CAN,1130,737-800,29,2,36,2,2,35,,,,,7,6
2019-06-19 23:59,URC,6995,737-800,33,3,28,5,4,28,,,,,-5,-5
2019-06-19 23:58,URC,6268,737-800,27,5,27,5,4,28,,,,,0,1
2019-06-19 23:55,CKG,5139,737-800,25,8,35,9,7,36,,,,,10,11
2019-06-19 23:55,HAK,5853,737-800,29,7,35,7,7,37,,,,,6,8
2019-06-19 23:46,DLC,7379,737-800,21,5,28,5,4,24,,,,,7,3
2019-06-19 23:45,HAK,5528,737-800,29,7,37,9,7,37,,,,,8,8
2019-06-19 23:44,DLC,1496,737-800,20,5,30,5,5,32,,,,,10,12
2019-06-19 23:33,HAK,6065,737-800,30,5,37,5,6,36,,,,,7,6
2019-06-19 23:26,TYN,5466,737-800,28,2,20,6,0,22,,,,,-8,-6
2019-06-19 23:19,DLC,1733,737-800,21,4,28,4,3,26,,,,,7,5
2019-06-19 23:17,SYX,1728,737-800,30,6,37,6,6,29,,,,,7,-1
2019-06-19 23:17,HHA,5521,737-800,30,6,32,5,6,33,,,,,2,3
2019-06-19 23:06,HGH,1727,737-800,23,5,30,4,5,31,,,,,7,8
2019-06-19 23:03,TYN,5372,737-800,27,8,28,8,8,28,,,,,1,1
2019-06-19 22:57,HAK,5082,737-800,29,6,35,5,4,34,,,,,6,5
2019-06-19 22:49,XIY,5408,737-800,25,4,31,3,4,27,,,,,6,2
2019-06-19 22:45,DLC,1103,737-800,19,6,32,5,4,30,1,,,1,13,11
2019-06-19 22:43,URC,1325,737-800,22,4,24,4,4,23,,,,,2,1
2019-06-19 22:42,URC,205T,737-800,28,2,29,2,4,28,,,,,1,0
2019-06-19 22:31,PEK,1927,737-800,27,3,28,6,4,29,,,,,1,2
2019-06-19 22:30,HGH,1492,737-800,25,4,30,3,3,30,,,,,5,5
2019-06-19 22:16,HAK,7171,737-800,30,5,36,5,4,33,,,,,6,3
2019-06-19 22:15,SZX,1141,737-800,30,5,35,6,6,32,,,,,5,2
2019-06-19 22:13,HAK,1538,737-800,29,5,37,7,4,37,,,,,8,8
2019-06-19 22:07,MIG,7990,737-800,24,3,31,3,2,32,,,,,7,8
2019-06-19 21:58,Î÷Äþ,5136,737-800,23,8,24,5,5,29,,,,,1,6
2019-06-19 21:58,HAK,1497,737-800,30,5,36,3,4,37,,,,,6,7
2019-06-19 21:55,TYN,5712,737-800,25,1,28,1,2,29,,,,,3,4
2019-06-19 21:19,XIY,1902,737-800,22,5,31,5,6,26,,,,,9,4
2019-06-19 21:07,URC ,205U,737-800,30,4,25,4,3,26,,,,,-5,-4
2019-06-19 21:01,CGO,6800,737-800,30,5,34,4,5,33,,,,,4,3
2019-06-19 20:40,HRB,1559,737-800,23,3,31,3,3,29,,,,,8,6
2019-06-19 20:30,CGO,7992,737-800,30,7,32,7,7,32,,,,,2,2
2019-06-19 20:25,HGH,5137,737-800,26,2,23,2,2,29,,,,,-3,3
2019-06-19 19:52,FOC,5503,737-800,29,3,29,4,3,30,,,,,0,1
2019-06-19 19:01,HAK,7619,737-800,32,6,32,6,5,33,,,,,0,1
2019-06-19 18:44,SZX,1786,737-800,31,5,34,5,4,32,,,,,3,1
2019-06-19 14:39,HAK,206H,737-800,37,4,36,4,4,36,,,,,-1,-1
2019-06-19 08:30,KMG,1798,737-800,17,5,30,5,5,24,,,,,13,7
2019-06-19 08:15,PEK,1729,737-800,27,4,28,4,4,26,,,,,1,-1
2019-06-19 08:03,CAN,1505,737-800,27,4,28,4,4,30,,,,,1,3
2019-06-19 08:00,KMG,1798,737-800,17,5,26,5,5,24,,,,,9,7
2019-06-19 07:59,PEK,5623,737-800,24,4,27,3,4,28,,,,,3,4
2019-06-19 07:40,PEK,1549,737-800,26,6,24,6,6,26,,,,,-2,0
2019-06-19 07:30,URC,5853,737-800,20,6,26,6,6,26,,,,,6,6
2019-06-19 07:14,PEK,5482,737-800,26,3,34,4,3,31,,,,,8,5
2019-06-19 07:14,Ö£ÖÝ,6800,737-800,25,4,32,5,4,30,,,,,7,5
2019-06-19 07:14,PEK,5482,737-800,26,3,34,4,3,31,,,,,8,5
2019-06-19 07:09,PEK,5687,737-800,25,4,29,4,4,28,,,,,4,3
2019-06-19 07:03,XIY,5115,737-800,28,3,24,4,4,26,,,,,-4,-2
2019-06-19 06:49,XMN,5636,737-800,26,6,36,8,8,35,1,,,1,10,9
2019-06-19 06:48,XMN,5405,737-800,26,6,34,6,6,30,,,,,8,4
2019-06-19 06:47,XMN,7398,737-800,26,8,36,8,8,30,,,,,10,4
2019-06-19 06:47,ZGC,5138,737-800,15,6,22,6,5,22,,,,,7,7
2019-06-19 06:47,XMN,5479,737-800,27,7,34,6,7,33,,,,,7,6
2019-06-19 06:40,HAK,5709,737-800,28,8,34,8,8,33,,,,,6,5
2019-06-19 06:38,ZGC,1496,737-800,15,5,28,6,6,28,,,,,13,13
2019-06-19 06:37,ZGC,5372,737-800,15,6,26,6,7,24,,,,,11,9
2019-06-19 06:36,ZGC,5359,737-800,17,6,17,5,6,18,,,,,0,1
2019-06-19 06:34,ZGC,7618,737-800,20,4,24,4,5,24,,,,,4,4
2019-06-19 06:31,XIY,1785,737-800,25,3,28,6,7,28,,,,,3,3
2019-06-19 06:29,TYN,6808,737-800,25,4,30,4,4,30,,,,,5,5
2019-06-19 06:04,TYN,1996,737-800,25,6,29,6,6,29,,,,,4,4
2019-06-19 06:04,TYN,5083,737-800,25,6,22,6,6,29,,,,,-3,4
2019-06-19 06:02,HHA,5521,737-800,25,4,30,5,4,32,,,,,5,7
2019-06-19 05:48,KMG,5409,737-800,20,4,25,4,5,27,,,,,5,7
2019-06-19 05:44,SYX,6063,737-800,30,6,36,4,6,36,,,,,6,6
2019-06-19 05:39,XMN,7398,737-800,26,8,36,8,8,30,,,,,10,4
2019-06-19 05:38,CAN,1130,737-800,27,2,36,3,2,35,,,,,9,8
2019-06-19 05:26,FOC,5430,737-800,27,0,27,4,5,27,,,,,0,0
2019-06-19 05:24,HGH,1491,737-800,24,5,34,5,5,32,,,,,10,8
2019-06-19 05:20,PEK,6103,737-800,26,5,34,5,5,34,,,,,8,8
2019-06-19 05:18,KMG,1208,737-800,20,3,30,3,3,28,,,,,10,8
2019-06-19 05:17,XMN,5141,737-800,23,5,33,6,6,32,,,,,10,9
2019-06-19 05:12,HGH,1101,737-800,24,4,35,3,3,32,,,,,11,8
2019-06-19 05:06,HAK,1346,737-800,28,8,37,7,8,37,,,,,9,9
2019-06-19 04:54,FOC ,7113,737-800,30,8,37,6,6,36,,,,,7,6
2019-06-19 04:54,Î÷°²,5579,737-800,26,7,23,5,6,30,,,,,-3,4
2019-06-19 04:51,FOC ,7113,737-800,30,8,38,6,6,38,,,,,8,8
2019-06-19 04:38,HAK,5580,737-800,27,8,36,7,8,35,,,,,9,8
2019-06-19 04:33,CGO,5373,737-800,28,6,30,7,7,30,,,,,2,2
2019-06-19 04:32,FOC,1435,737-800,28,8,37,6,6,36,,,,,9,8
2019-06-19 04:32,FOC,1435,737-800,28,8,37,6,5,28,,,,,9,0
2019-06-19 04:30,URC,1726,737-800,20,4,26,4,4,26,,,,,6,6
2019-06-19 04:21,KMG,1586,737-800,22,4,29,4,3,27,,,,,7,5
2019-06-19 04:21,CAN,1375,737-800,29,6,36,4,4,32,,,,,7,3
2019-06-19 04:16,SZX,5429,737-800,28,4,36,7,6,36,,,,,8,8
2019-06-19 04:16,HHA,5520,737-800,25,4,30,6,5,29,,,,,5,4
2019-06-19 04:14,SZX,206G,737-800,29,3,36,3,4,34,,,,,7,5
2019-06-19 04:09,HAK,1497,737-800,27,5,36,4,4,36,,,,,9,9
2019-06-19 03:53,PEK,5481,737-800,26,5,30,6,5,29,,,,,4,3
2019-06-19 03:53,KMG,7992,737-800,24,6,30,8,7,31,,,,,6,7
2019-06-19 03:47,XIY,1480,737-800,23,5,30,4,5,31,,,,,7,8
2019-06-19 03:46,XIY,1161,737-800,30,6,34,6,5,30,,,,,4,0
2019-06-19 03:44,URC,1568,737-800,25,6,24,4,4,26,,,,,-1,1
2019-06-19 03:40,URC,5467,737-800,24,2,23,3,2,21,,,,,-1,-3
2019-06-19 03:32,SYX,5358,737-800,30,8,36,6,6,34,,,,,6,4
2019-06-19 03:29,URC,2157,737-800,24,4,24,8,8,30,,,,,0,6
2019-06-19 03:28,MIG,5732,737-800,22,6,30,4,5,28,,,,,8,6
2019-06-19 03:24,URC,5661,737-800,24,4,25,5,5,28,,,,,1,4
2019-06-19 03:19,FOC,1795,737-800,29,8,36,9,8,36,,,,,7,7
2019-06-19 03:09,PEK,1503,737-800,25,3,32,4,4,33,,,,,7,8
2019-06-19 03:08,FOC ,1562,737-800,29,4,34,4,5,34,,,,,5,5
2019-06-19 03:07,CTU,1209,737-800,22,4,36,4,4,36,,1,,1,14,14
2019-06-19 03:06,HAK,1548,737-800,28,4,36,4,4,30,,,,,8,2
2019-06-19 03:05,XMN,5636,737-800,29,6,36,8,8,35,,,,,7,6
2019-06-19 03:00,XMN,5479,737-800,29,7,34,6,7,33,,,,,5,4
2019-06-19 02:59,XMN,5405,737-800,26,6,34,6,6,30,,,,,8,4
2019-06-19 02:56,HHA,1490,737-800,24,5,33,6,5,34,,,,,9,10
2019-06-19 02:54,SHA,1929,737-800,25,4,29,4,4,28,,,,,4,3
2019-06-19 02:52,CAN ,5417,737-800,27,7,35,8,8,36,,,,,8,9
2019-06-19 02:49,CAN ,7619,737-800,27,3,31,4,6,34,,,,,4,7
2019-06-19 02:48,HHA,5406,737-800,26,4,34,6,4,28,,,,,8,2
2019-06-19 02:46,XIY,7377,737-800,25,6,28,6,6,25,,,,,3,0
2019-06-19 02:46,HAK,1372,737-800,28,8,36,7,8,35,,,,,8,7
2019-06-19 02:46,HAK,1386,737-800,28,7,36,6,6,36,,,,,8,8
2019-06-19 02:43,SYX,5139,737-800,29,7,34,8,8,36,,,,,5,7
2019-06-19 02:40,URC,1725,737-800,25,4,31,4,4,34,,,,,6,9
2019-06-19 02:37,CGO,1587,737-800,30,7,32,6,4,30,,,,,2,0
2019-06-19 02:35,SZX,6062,737-800,29,4,35,4,4,36,,,,,6,7
2019-06-19 02:34,SZX,6062,737-800,29,4,35,4,4,36,,,,,6,7
2019-06-19 02:34,URC,5637,737-800,25,2,27,2,3,25,,,,,2,0
2019-06-19 02:31,XIY,5116,737-800,29,4,27,5,5,27,,,,,-2,-2
2019-06-19 02:31,HAK,1538,737-800,28,5,36,4,4,36,,,,,8,8
2019-06-19 02:31,HAK,1786,737-800,33,4,36,4,3,32,,,,,3,-1
2019-06-19 02:26,SZX,7175,737-800,29,5,29,5,5,32,,,,,0,3
2019-06-19 02:26,CAN,5638,737-800,28,4,35,4,5,36,,,,,7,8
2019-06-19 02:25,URC,205T,737-800,25,2,28,3,3,28,,,,,3,3
2019-06-19 02:25,CAN,1131,737-800,28,5,36,5,4,36,,,,,8,8
2019-06-19 02:21,HGH,7172,737-800,24,5,28,6,5,27,,,,,4,3
2019-06-19 02:18,URC,6995,737-800,27,4,30,4,4,24,,,,,3,-3
2019-06-19 02:18,PEK ,5539,737-800,27,8,30,4,5,28,,,,,3,1
2019-06-19 02:16,HAK,5082,737-800,27,6,36,8,8,36,,,,,9,9
2019-06-19 02:15,XIY,7171,737-800,27,4,27,4,4,28,,,,,0,1
2019-06-19 02:10,SZX,5371,737-800,29,7,31,8,8,36,,,,,2,7
2019-06-19 02:09,URC,1322,737-800,25,4,24,4,5,25,,,,,-1,0
2019-06-19 02:07,XIY,1482,737-800,27,6,26,6,6,25,,,,,-1,-2
2019-06-19 02:04,XIY,1162,737-800,25,2,28,4,2,30,,,,,3,5
2019-06-19 02:00,KMG,7993,737-800,20,5,30,6,6,26,,,,,10,6
2019-06-19 02:00,DLC,1797,737-800,16,3,28,3,3,28,,,,,12,12
2019-06-19 01:59,MIG,7990,737-800,25,3,30,2,2,32,,,,,5,7
2019-06-19 01:58,PEK,1498,737-800,25,4,32,4,4,29,,,,,7,4
2019-06-19 01:57,CGO,6015,737-800,27,3,35,4,4,31,,,,,8,4
2019-06-19 01:56,XIY,5408,737-800,26,4,22,4,4,23,,,,,-4,-3
2019-06-19 01:56,HHA,1373,737-800,26,4,29,4,4,27,,,,,3,1
2019-06-19 01:55,HAK,5712,737-800,28,3,35,2,2,35,,,,,7,7
2019-06-19 01:55,103,7173,737-800,27,3,32,3,3,29,,,,,5,2
2019-06-19 01:55,CGO,7167,737-800,27,6,32,6,6,32,,,,,5,5
2019-06-19 01:54,104,6103,737-800,28,5,34,4,6,34,,,,,6,6
2019-06-19 01:54,KMG,7988,737-800,20,4,28,3,4,30,,,,,8,10
2019-06-19 01:50,´óÁ¬,1103,737-800,17,4,28,4,4,24,,,,,11,7
2019-06-19 01:49,´óÁ¬,1103,737-800,17,4,28,4,4,24,,,,,11,7
2019-06-19 01:46,MIG,5449,737-800,22,4,31,4,4,32,,,,,9,10
2019-06-19 01:46,DLC,5855,737-800,19,3,28,3,5,26,,,,,9,7
2019-06-19 01:45,DLC,7399,737-800,19,3,28,3,4,29,,,,,9,10
2019-06-19 01:41,XIY,1163,737-800,28,2,32,2,2,28,,,,,4,0
2019-06-19 01:40,HHA,1347,737-800,26,5,35,4,4,34,,,,,9,8
2019-06-19 01:39,XIY,1733,737-800,28,2,30,3,3,26,,,,,2,-2
2019-06-19 01:38,URC,205V,737-800,25,4,28,2,2,28,,,,,3,3
2019-06-19 01:36,SYX,5686,737-800,29,6,35,5,4,30,,,,,6,1
2019-06-19 01:34,HGH,1542,737-800,25,4,28,4,4,30,,,,,3,5
2019-06-19 01:32,CAN,1997,737-800,28,5,37,4,4,34,,,,,9,6
2019-06-19 01:32,HGH,5480,737-800,27,4,30,5,3,30,,,,,3,3
2019-06-19 01:27,HGH,1547,737-800,24,6,27,6,5,28,,,,,3,4
2019-06-19 01:27,HAK,5540,737-800,30,6,36,4,4,30,,,,,6,0
2019-06-19 01:26,SYX,5662,737-800,30,6,36,3,6,33,,,,,6,3
2019-06-19 01:25,URC,1570,737-800,26,4,20,5,6,24,,,,,-6,-2
2019-06-19 01:20,HGH,7639,737-800,25,5,32,5,5,30,,,,,7,5
2019-06-19 01:15,XIY,5180,737-800,30,6,26,6,6,26,,,,,-4,-4
2019-06-19 01:06,SZX,1141,737-800,29,6,36,6,6,32,,,,,7,3
2019-06-19 01:06,HAK,1502,737-800,33,3,32,4,4,36,,,,,-1,3
2019-06-19 01:04,URC,1102,737-800,25,4,29,4,4,29,,,,,4,4
2019-06-19 01:04,URC,5852,737-800,25,4,29,5,5,26,,,,,4,1
2019-06-19 01:00,XIY,1433,737-800,27,3,33,4,3,27,,,,,6,0
2019-06-19 00:58,HAK,5462,737-800,28,6,34,7,7,35,,,,,6,7
2019-06-19 00:56,FOC,5503,737-800,29,4,32,3,4,32,,,,,3,3
2019-06-19 00:55,YIH,1348,737-800,30,6,32,5,6,30,,,,,2,0
2019-06-19 00:52,FOC,1906,737-800,29,6,34,7,7,36,,,,,5,7
2019-06-19 00:51,HAK,6060,737-800,28,6,36,6,6,36,,,,,8,8
2019-06-19 00:49,URC,1727,737-800,25,4,30,4,4,30,,,,,5,5
2019-06-19 00:44,TYN,1215,737-800,30,4,30,6,6,30,,,,,0,0
2019-06-19 00:40,SZX,5625,737-800,29,8,36,5,6,36,,,,,7,7
2019-06-19 00:39,SYX,7379,737-800,29,4,37,4,5,36,,,,,8,7
2019-06-19 00:38,XIY,1735,737-800,28,5,34,4,5,28,,,,,6,0
2019-06-19 00:36,TYN,1501,737-800,28,4,29,4,4,30,,,,,1,2
2019-06-19 00:34,HRB,1559,737-800,18,4,30,3,3,26,,,,,12,8
2019-06-19 00:32,CGO,1569,737-800,27,3,28,2,2,28,,,,,1,1
2019-06-19 00:30,YIH,1350,737-800,29,4,32,5,5,31,,,,,3,2
2019-06-19 00:29,URC,5611,737-800,25,6,28,5,6,29,,,,,3,4
2019-06-19 00:22,DLC,1927,737-800,17,3,24,3,5,26,,,,,7,9
2019-06-19 00:19,CAN,5337,737-800,29,8,37,8,9,36,,,,,8,7
2019-06-19 00:12,URC,1493,737-800,26,5,25,3,3,24,,,,,-1,-2
2019-06-19 00:07,HRB,7395,737-800,22,6,31,6,6,28,,,,,9,6
2019-06-19 00:06,,5733,737-800,30,8,37,4,4,34,,,,,7,4
2019-06-19 00:01,CKG,5465,737-800,26,6,33,6,6,33,,,,,7,7
2019-06-19 00:00,CKG,5416,737-800,26,5,32,5,5,32,,,,,6,6
2019-06-18 23:55,DLC,1799,737-800,20,4,28,4,4,28,,,,,8,8
2019-06-18 23:53,HRB,1905,737-800,21,4,28,4,4,26,,,,,7,5
2019-06-18 23:48,PEK,7400,737-800,26,4,30,5,5,32,,,,,4,6
2019-06-18 23:47,PEK,6066,737-800,26,6,30,6,6,30,,,,,4,4
2019-06-18 23:44,CAN,5463,737-800,26,4,30,6,6,32,,,,,4,6
2019-06-18 23:43,MIG,6809,737-800,22,2,26,6,6,32,,,,,4,10
2019-06-18 23:43,XIY,1796,737-800,25,6,30,6,4,30,,,,,5,5
2019-06-18 23:41,MIG,6809,737-800,22,2,26,6,6,32,,,,,4,10
2019-06-18 23:40,HAK,5090,737-800,28,6,36,7,8,36,,,,,8,8
2019-06-18 23:37,HAK,1783,737-800,28,4,36,6,6,36,,,,,8,8
2019-06-18 23:36,XIY,5418,737-800,28,6,28,7,7,30,,,,,0,2
2019-06-18 23:35,HAK,5082,737-800,28,10,40,8,8,36,,,,,12,8
2019-06-18 23:35,HRB,7105,737-800,20,3,28,4,4,26,,,,,8,6
2019-06-18 23:26,YIH,1351,737-800,30,8,29,8,8,30,,,,,-1,0
2019-06-18 23:26,HGH,5137,737-800,25,3,26,3,3,30,,,,,1,5
2019-06-18 23:25,URC,205U,737-800,20,3,26,4,3,27,,,,,6,7
2019-06-18 23:22,SYX ,5153,737-800,30,6,36,4,4,32,,,,,6,2
2019-06-18 23:17,DLC,1541,737-800,20,5,28,5,6,28,,,,,8,8
2019-06-18 23:13,SYX,5338,737-800,30,4,32,5,4,26,,,,,2,-4
2019-06-18 23:13,DLC,1545,737-800,20,4,28,4,4,28,,,,,8,8
2019-06-18 23:10,HAK,1487,737-800,28,8,36,4,4,34,,,,,8,6
2019-06-18 23:04,PEK,1213,737-800,28,5,29,5,5,29,,,,,1,1
2019-06-18 23:01,TYN,5375,737-800,29,3,29,5,6,32,,,,,0,3
2019-06-18 22:57,CKG,7616,737-800,27,4,32,5,5,31,,,,,5,4
2019-06-18 22:54,XNN,5136,737-800,20,5,22,6,4,27,,,,,2,7
2019-06-18 22:54,SYX ,5478,737-800,30,7,36,4,4,32,,,,,6,2
2019-06-18 22:50,DLC,5466,737-800,18,2,23,5,5,22,,,,,5,4
2019-06-18 22:36,PEK,5538,737-800,26,4,29,5,6,31,,,,,3,5
2019-06-18 22:30,DLC,5522,737-800,23,5,28,6,6,26,,,,,5,3
2019-06-18 22:27,HAK,6065,737-800,28,4,36,6,6,36,,,,,8,8
2019-06-18 22:23,HAK,5439,737-800,30,9,37,8,8,36,,,,,7,6
2019-06-18 22:12,XIY,5428,737-800,29,5,30,5,4,30,,,,,1,1
2019-06-18 22:08,URC,1323,737-800,25,4,28,4,4,30,,,,,3,5
2019-06-18 22:04,URC,7198,737-800,29,5,32,8,5,29,,,,,3,0
2019-06-18 21:35,Î÷Äþ,5581,737-800,21,4,18,5,5,25,,,,,-3,4
2019-06-18 20:50,ÐìÖÝ,7991,737-800,28,8,32,7,7,35,,,,,4,7
2019-06-18 20:36,HAK,206F,737-800,29,4,35,4,4,30,,,,,6,1
2019-06-18 19:45,HGH,1492,737-800,24,4,31,4,4,31,,,,,7,7
2019-06-18 19:23,URC,1325,737-800,25,4,24,4,5,25,,,,,-1,0
2019-06-18 19:15,XIY,1903,737-800,31,3,30,3,3,31,,,,,-1,0
2019-06-18 19:03,URC,205U,737-800,22,4,29,4,6,27,,,,,7,5
2019-06-18 19:02,URC,5709,737-800,24,7,29,6,8,30,,,,,5,6
2019-06-18 18:42,XIY,1902,737-800,30,4,34,5,5,26,,,,,4,-4
2019-06-18 18:31,XIY,1928,737-800,30,4,26,4,2,24,,,,,-4,-6
2019-06-18 17:14,CTU,1209,737-800,30,3,35,3,4,36,,,,,5,6
2019-06-18 16:49,CGO,5483,737-800,37,5,34,5,4,33,,,,,-3,-4
2019-06-18 15:48,TYN,1996,737-800,36,6,29,6,6,29,,,,,-7,-7
2019-06-18 10:47,KMG,5409,737-800,20,4,26,5,4,27,,,,,6,7
2019-06-18 08:53,PEK,6066,737-800,25,4,32,6,5,32,,,,,7,7
2019-06-18 08:49,SYX,5338,737-800,28,3,30,6,5,34,,,,,2,6
2019-06-18 08:46,PEK,1213,737-800,25,6,32,6,6,32,,,,,7,7
2019-06-18 08:45,XIY,1480,737-800,25,4,27,4,4,26,,,,,2,1
2019-06-18 08:42,XMN,1498,737-800,20,2,32,2,2,31,,,,,12,11
2019-06-18 08:41,XMN,5138,737-800,20,6,30,8,8,32,,,,,10,12
2019-06-18 08:41,XMN,1929,737-800,25,4,32,4,4,30,,,,,7,5
2019-06-18 08:40,XMN,5405,737-800,20,4,36,4,2,32,,,,,16,12
2019-06-18 08:17,YIH,1351,737-800,25,4,29,6,5,28,,,,,4,3
2019-06-18 07:51,ZGC,5581,737-800,22,4,17,5,5,25,,,,,-5,3
2019-06-18 07:36,XIY,1785,737-800,26,7,30,8,8,31,,,,,4,5
2019-06-18 06:38,FOC,1906,737-800,26,7,35,7,6,34,,,,,9,8
2019-06-18 06:37,FOC,5430,737-800,26,6,37,6,6,35,1,,,1,11,9
2019-06-18 06:33,FOC,5503,737-800,26,3,28,4,3,27,,,,,2,1
2019-06-18 06:33,SYX,5358,737-800,28,6,32,6,6,35,,,,,4,7
2019-06-18 06:32,FOC,5430,737-800,26,6,3,6,6,35,,,,,-23,9
2019-06-18 06:28,PEK,5538,737-800,23,2,33,2,2,34,,,,,10,11
2019-06-18 06:10,DLC,1797,737-800,22,3,26,4,3,26,,,,,4,4
2019-06-18 05:37,HAK,7171,737-800,27,6,36,6,6,36,,,,,9,9
2019-06-18 05:34,FOC,7113,737-800,28,6,34,6,5,35,,,,,6,7
2019-06-18 05:11,KMG,7991,737-800,20,6,31,7,6,30,,,,,11,10
2019-06-18 05:11,HAK,5139,737-800,27,7,34,7,6,34,,,,,7,7
2019-06-18 04:50,CKG,5416,737-800,22,7,28,8,8,29,,,,,6,7
2019-06-18 04:50,DLC,5855,737-800,22,6,30,6,5,28,,,,,8,6
2019-06-18 04:49,HAK,6065,737-800,27,5,36,5,5,35,,,,,9,8
2019-06-18 04:49,SZX,1995,737-800,29,9,37,6,6,36,,,,,8,7
2019-06-18 04:39,º£¿Ú,1501,737-800,30,4,36,4,2,30,,,,,6,0
2019-06-18 04:39,PEK,5467,737-800,25,1,18,2,2,20,,,,,-7,-5
2019-06-18 04:39,URC,1322,737-800,21,5,23,4,4,26,,,,,2,5
2019-06-18 04:24,DLC,1505,737-800,20,4,22,4,4,24,,,,,2,4
2019-06-18 04:16,HGH,6063,737-800,25,4,30,3,3,28,,,,,5,3
2019-06-18 04:05,HAK,5852,737-800,27,6,34,6,6,34,,,,,7,7
2019-06-18 03:50,DLC,7399,737-800,20,4,26,4,4,24,,,,,6,4
2019-06-18 03:49,SZX,206G,737-800,28,3,36,3,3,35,,,,,8,7
2019-06-18 03:48,DLC,1541,737-800,22,5,30,6,6,30,,,,,8,8
2019-06-18 03:47,DLC,1927,737-800,21,4,26,7,4,26,,,,,5,5
2019-06-18 03:46,DLC,1795,737-800,20,5,24,4,5,22,,,,,4,2
2019-06-18 03:45,PEK ,582,737-800,22,3,36,4,5,32,,,,,14,10
2019-06-18 03:45,PEK,5538,737-800,21,4,39,3,3,36,,,,,18,15
2019-06-18 03:44,HGH,1490,737-800,25,5,32,6,5,32,,,,,7,7
2019-06-18 03:44,DLC,1799,737-800,20,4,30,4,4,30,,,,,10,10
2019-06-18 03:43,DLC,5522,737-800,20,6,30,8,8,28,,,,,10,8
2019-06-18 03:42,DLC,1503,737-800,21,3,28,4,3,28,,,,,7,7
2019-06-18 03:40,DLC,5466,737-800,22,1,16,2,1,17,,,,,-6,-5
2019-06-18 03:39,HAK,1501,737-800,30,4,36,4,2,30,,,,,6,0
2019-06-18 03:36,FOC,1562,737-800,30,5,36,4,5,36,,,,,6,6
2019-06-18 03:33,HHA,6103,737-800,24,6,34,8,8,36,,1,,1,10,12
2019-06-18 03:29,XIY,1480,737-800,25,4,27,4,4,26,,,,,2,1
2019-06-18 03:28,XIY,1482,737-800,22,5,31,6,5,29,,,,,9,7
2019-06-18 03:27,URC,7198,737-800,22,8,24,6,6,22,,,,,2,0
2019-06-18 03:25,XIY,5116,737-800,24,4,28,4,4,26,,,,,4,2
2019-06-18 03:25,HAK,5540,737-800,27,9,36,6,6,34,,,,,9,7
2019-06-18 03:24,URC,205T,737-800,20,4,22,4,4,20,,,,,2,0
2019-06-18 03:15,CAN,1997,737-800,27,5,34,5,5,34,,,,,7,7
2019-06-18 03:14,TYN,5083,737-800,25,4,26,4,4,26,,,,,1,1
2019-06-18 03:14,KMG,7989,737-800,21,6,33,7,6,32,,,,,12,11
2019-06-18 03:13,XIY,1481,737-800,27,6,30,4,4,30,,,,,3,3
2019-06-18 03:12,FOC,5481,737-800,26,6,32,6,5,32,,,,,6,6
2019-06-18 03:07,HAK,5735,737-800,26,3,30,4,3,32,,,,,4,6
2019-06-18 03:02,TYN,1996,737-800,25,4,26,4,4,26,,,,,1,1
2019-06-18 03:02,XIY,1163,737-800,25,2,30,2,2,30,,,,,5,5
2019-06-18 02:56,XIY,5115,737-800,26,4,20,6,6,22,,,,,-6,-4
2019-06-18 02:56,HAK,5798,737-800,26,2,30,2,2,26,,,,,4,0
2019-06-18 02:52,HGH,5480,737-800,23,3,30,4,3,28,,,,,7,5
2019-06-18 02:50,HAK,5712,737-800,27,2,32,3,2,32,,,,,5,5
2019-06-18 02:49,TYN,6808,737-800,24,5,30,6,5,26,,,,,6,2
2019-06-18 02:46,CAN,1372,737-800,28,8,36,7,8,36,,,,,8,8
2019-06-18 02:46,HAK,1793,737-800,27,2,32,3,2,32,,,,,5,5
2019-06-18 02:43,XIY,1350,737-800,25,4,35,4,4,32,,,,,10,7
2019-06-18 02:42,XIY,7886,737-800,26,4,34,2,3,32,,,,,8,6
2019-06-18 02:41,HHA,1495,737-800,27,3,32,3,3,32,,,,,5,5
2019-06-18 02:38,CKG,7616,737-800,25,5,28,5,6,26,,,,,3,1
2019-06-18 02:37,CKG,1386,737-800,26,4,32,5,4,30,,,,,6,4
2019-06-18 02:37,XIY,5638,737-800,27,4,28,4,4,32,,,,,1,5
2019-06-18 02:33,XIY,1903,737-800,26,1,30,2,1,32,,,,,4,6
2019-06-18 02:32,SYX,5686,737-800,29,6,36,4,4,35,,,,,7,6
2019-06-18 02:27,SYX,5687,737-800,30,6,36,5,4,34,,,,,6,4
2019-06-18 02:22,URC,5713,737-800,22,4,22,4,4,26,,,,,0,4
2019-06-18 02:21,SZX,5371,737-800,29,6,34,5,5,33,,,,,5,4
2019-06-18 02:19,TYN,5375,737-800,20,0,26,4,4,26,,,,,6,6
2019-06-18 02:19,URC,5479,737-800,25,5,28,6,5,28,,,,,3,3
2019-06-18 02:19,HAK,5429,737-800,28,4,30,4,4,30,,,,,2,2
2019-06-18 02:18,PEK ,1729,737-800,25,4,29,4,4,21,,,,,4,-4
2019-06-18 02:18,CAN,5337,737-800,30,8,36,8,7,36,,,,,6,6
2019-06-18 02:17,URC,6995,737-800,22,4,28,6,6,24,,,,,6,2
2019-06-18 02:11,URC,205V,737-800,22,2,28,4,2,26,,,,,6,4
2019-06-18 02:07,HGH,1491,737-800,23,4,32,5,4,31,,,,,9,8
2019-06-18 02:05,URC,1102,737-800,24,4,28,4,4,28,,,,,4,4
2019-06-18 02:04,CGO,5439,737-800,30,5,30,4,4,31,,,,,0,1
2019-06-18 01:58,ZGC,5662,737-800,18,3,24,4,5,23,,,,,6,5
2019-06-18 01:54,URC,5623,737-800,23,6,26,4,4,24,,,,,3,1
2019-06-18 01:50,URC,6268,737-800,26,4,28,4,5,27,,,,,2,1
2019-06-18 01:49,URC,205V,737-800,22,2,28,4,2,26,,,,,6,4
2019-06-18 01:49,XIY,5372,737-800,27,8,30,8,8,30,,,,,3,3
2019-06-18 01:46,CGO,1587,737-800,30,8,34,4,4,30,,,,,4,0
2019-06-18 01:46,MIG,5732,737-800,25,2,28,2,2,30,,,,,3,5
2019-06-18 01:45,HHA,5135,737-800,25,2,28,3,3,30,,,,,3,5
2019-06-18 01:45,HAK,5373,737-800,27,6,31,8,8,34,,,,,4,7
2019-06-18 01:42,URC,1727,737-800,23,4,30,4,4,29,,,,,7,6
2019-06-18 01:38,HAK,1498,737-800,26,4,35,4,4,36,,,,,9,10
2019-06-18 01:37,HGH,5359,737-800,25,6,34,6,5,32,,,,,9,7
2019-06-18 01:35,CAN,1496,737-800,29,6,37,6,6,37,,,,,8,8
2019-06-18 01:34,XIY,1161,737-800,25,2,26,4,4,28,,,,,1,3
2019-06-18 01:28,HGH,1783,737-800,23,4,28,5,5,32,,,,,5,9
2019-06-18 01:27,PEK,7400,737-800,23,4,30,4,4,30,,,,,7,7
2019-06-18 01:27,URC,5611,737-800,23,6,30,5,5,28,,,,,7,5
2019-06-18 01:25,XIY,1162,737-800,25,3,32,3,3,26,,,,,7,1
2019-06-18 01:24,SYX,5661,737-800,28,5,34,6,5,35,,,,,6,7
2019-06-18 01:23,DLC,1927,737-800,21,4,26,7,4,26,,,,,5,5
2019-06-18 01:22,SHE,1373,737-800,20,4,27,4,4,22,,,,,7,2
2019-06-18 01:20,CAN,5418,737-800,27,6,36,4,4,36,,,,,9,9
2019-06-18 01:18,SYX,5153,737-800,29,3,35,3,4,35,,,,,6,6
2019-06-18 01:18,XIY,1733,737-800,25,4,28,3,2,26,,,,,3,1
2019-06-18 01:14,SZX,5625,737-800,29,6,37,5,4,34,,,,,8,5
2019-06-18 01:10,HAK,5082,737-800,27,5,37,4,4,34,1,,,1,10,7
2019-06-18 01:08,HRB ,1905,737-800,20,4,27,4,3,23,,,,,7,3
2019-06-18 01:07,HRB,1905,737-800,20,4,32,4,3,27,,,,,12,7
2019-06-18 01:03,HHA,5502,737-800,25,5,30,6,6,32,,,,,5,7
2019-06-18 01:03,XIY,5408,737-800,30,4,28,4,4,26,,,,,-2,-4
2019-06-18 00:54,HAK,5137,737-800,28,5,24,3,2,34,,,,,-4,6
2019-06-18 00:47,CAN,1131,737-800,27,5,36,5,5,36,,,,,9,9
2019-06-18 00:45,HRB,7395,737-800,22,5,31,6,6,28,,,,,9,6
2019-06-18 00:45,CAN,5417,737-800,30,7,35,8,8,36,,,,,5,6
2019-06-18 00:42,HGH,1101,737-800,22,2,35,2,2,31,,,,,13,9
2019-06-18 00:36,HAK,1793,737-800,27,8,36,8,8,36,,,,,9,9
2019-06-18 00:33,KMG,6800,737-800,20,4,31,4,4,29,,,,,11,9
2019-06-18 00:33,HAK,5346,737-800,31,8,37,6,6,32,,,,,6,1
2019-06-18 00:31,HA?K,5465,737-800,27,5,35,4,4,34,,,,,8,7
2019-06-18 00:30,URC,1726,737-800,24,4,28,4,3,28,,,,,4,4
2019-06-18 00:26,URC,1497,737-800,23,4,28,2,2,26,,,,,5,3
2019-06-18 00:20,KMG,5806,737-800,22,6,0,4,0,0,,,,,-22,-22
2019-06-18 00:17,XIY,5180,737-800,26,6,32,6,6,30,,,,,6,4
2019-06-18 00:15,XIY,5428,737-800,26,4,28,6,4,30,,,,,2,4
2019-06-18 00:14,PEK ,7173,737-800,24,3,30,5,4,32,,,,,6,8
2019-06-18 00:13,SZX,1141,737-800,27,5,36,5,5,32,,,,,9,5
2019-06-18 00:10,CGO,1325,737-800,27,3,28,4,4,24,,,,,1,-3
2019-06-18 00:09,FOC,1433,737-800,24,4,35,3,3,29,,,,,11,5
2019-06-18 00:01,CGO,7167,737-800,28,5,28,4,4,27,,,,,0,-1
2019-06-17 23:59,XIY,1103,737-800,27,4,34,4,4,32,,,,,7,5
2019-06-17 23:58,XIY,5372,737-800,27,8,30,8,8,30,,,,,3,3
2019-06-17 23:48,HAK,5797,737-800,27,5,29,5,5,31,,,,,2,4
2019-06-17 23:48,URC,1568,737-800,25,6,30,6,6,24,,,,,5,-1
2019-06-17 23:45,SZX,7175,737-800,28,4,30,6,6,30,,,,,2,2
2019-06-17 23:40,HHA,5520,737-800,25,5,33,5,4,33,,,,,8,8
2019-06-17 23:38,HAK,1502,737-800,27,3,31,4,4,33,,,,,4,6
2019-06-17 23:31,PEK,1130,737-800,23,3,35,2,2,35,1,1,,11,12,12
2019-06-17 23:31,HAK,1208,737-800,28,4,36,4,4,34,,,,,8,6
2019-06-17 23:29,CAN,1215,737-800,30,8,36,8,7,36,,,,,6,6
2019-06-17 23:28,CGO,5636,737-800,27,4,28,5,4,29,,,,,1,2
2019-06-17 23:25,URC,1725,737-800,22,4,28,3,5,26,,,,,6,4
2019-06-17 23:24,CAN,1538,737-800,28,4,36,4,3,36,,,,,8,8
2019-06-17 23:21,HGH,7639,737-800,25,5,34,6,5,30,,,,,9,5
2019-06-17 23:19,CGO,1586,737-800,24,4,33,4,4,30,,,,,9,6
2019-06-17 23:19,PEK,6061,737-800,24,4,30,6,6,30,,,,,6,6
2019-06-17 23:18,SYX,5478,737-800,28,7,36,5,4,33,,,,,8,5
2019-06-17 23:18,SYX,7379,737-800,28,5,35,4,4,36,,,,,7,8
2019-06-17 23:17,HHA,1347,737-800,25,4,34,4,4,32,,,,,9,7
2019-06-17 23:14,HAK,7398,737-800,28,8,35,4,3,31,,,,,7,3
2019-06-17 23:08,PEK,1728,737-800,24,5,26,6,5,24,,,,,2,0
2019-06-17 23:05,Î÷Äþ,5733,737-800,23,4,24,6,5,24,,,,,1,1
2019-06-17 23:05,TYN,5853,737-800,26,6,32,6,6,26,,,,,6,0
2019-06-17 23:04,Î÷Äþ,5136,737-800,24,6,20,6,5,28,,,,,-4,4
2019-06-17 23:04,MIG,1798,737-800,25,6,33,5,5,30,,,,,8,5
2019-06-17 23:02,KMG,6015,737-800,23,3,32,3,4,25,,,,,9,2
2019-06-17 23:00,HRB,1559,737-800,23,3,30,3,3,28,,,,,7,5
2019-06-17 22:50,KMG,7990,737-800,30,2,32,3,2,28,,,,,2,-2
2019-06-17 22:44,XIY,1796,737-800,27,6,30,4,4,28,,,,,3,1
2019-06-17 22:38,XIY,5579,737-800,25,6,28,6,6,30,,,,,3,5
2019-06-17 22:38,CAN,5463,737-800,29,4,34,6,6,36,,,,,5,7
2019-06-17 22:36,HRB ,7105,737-800,23,3,28,4,4,24,,,,,5,1
2019-06-17 22:32,URC,1323,737-800,27,3,32,3,4,28,,,,,5,1
2019-06-17 22:17,TYN,1735,737-800,20,2,28,4,4,22,,,,,8,2
2019-06-17 22:10,TYN ,206H,737-800,25,4,28,2,2,28,,,,,3,3
2019-06-17 21:59,MIG,5449,737-800,20,6,30,5,6,30,,,,,10,10
2019-06-17 21:57,URC,1493,737-800,28,6,28,6,6,26,,,,,0,-2
2019-06-17 21:55,CGO,7992,737-800,29,5,28,5,5,28,,,,,-1,-1
2019-06-17 21:06,URC ,1570,737-800,28,3,26,4,3,24,,,,,-2,-4
2019-06-17 21:05,KMG,7990,737-800,30,2,32,3,2,28,,,,,2,-2
2019-06-17 20:24,HAK,206F,737-800,28,3,34,3,3,30,,,,,6,2
2019-06-17 20:01,HAK ,5462,737-800,29,5,36,5,5,32,,,,,7,3
2019-06-17 19:39,HAK,2159,737-800,29,8,34,5,3,31,,,,,5,2
2019-06-17 19:26,HAK,5090,737-800,30,6,36,6,7,36,,,,,6,6
2019-06-17 19:15,XIY,1902,737-800,30,4,28,4,4,26,,,,,-2,-4
2019-06-17 18:55,HGH,1492,737-800,25,2,28,4,4,30,,,,,3,5
2019-06-17 18:37,HAK,6062,737-800,30,4,35,4,4,36,,,,,5,6
2019-06-17 18:00,CGO,5783,737-800,35,4,36,6,5,30,,,,,1,-5
2019-06-17 17:17,XUZ,7993,737-800,33,4,34,6,6,30,,,,,1,-3
2019-06-17 15:01,XMN,5405,737-800,27,5,30,6,5,32,,,,,3,5
2019-06-17 15:00,XMN,5467,737-800,26,4,32,6,4,29,,,,,6,3
2019-06-17 14:59,XMN,5662,737-800,24,5,32,6,6,30,,,,,8,6
2019-06-17 14:59,XMN,1542,737-800,26,4,34,4,4,30,,,,,8,4
2019-06-17 14:53,PEK,6061,737-800,20,4,25,4,5,26,,,,,5,6
2019-06-17 14:18,XMN,5467,737-800,26,4,32,6,4,29,,,,,6,3
2019-06-17 14:16,HRB,1435,737-800,30,5,28,5,6,25,,,,,-2,-5
2019-06-17 10:10,FOC,5503,737-800,26,3,28,4,3,26,,,,,2,0
2019-06-17 09:14,FOC,7113,737-800,25,5,35,5,5,35,1,1,,11,10,10
2019-06-17 09:09,HAK,1372,737-800,25,7,36,7,7,36,1,1,,11,11,11
2019-06-17 08:58,HHA,1347,737-800,26,4,30,4,4,30,,,,,4,4
2019-06-17 08:37,SHA,6103,737-800,27,5,34,8,8,36,,,,,7,9
2019-06-17 08:18,PEK,6066,737-800,20,4,30,6,6,30,,,,,10,10
2019-06-17 07:53,ZGC,5638,737-800,20,4,22,4,5,20,,,,,2,0
2019-06-17 07:52,ZGC,5338,737-800,20,5,20,4,4,19,,,,,0,-1
2019-06-17 07:51,ZGC,7377,737-800,21,5,25,5,5,24,,,,,4,3
2019-06-17 07:31,ZGC,1498,737-800,20,4,24,4,4,25,,,,,4,5
2019-06-17 07:15,PEK,7400,737-800,21,4,29,4,3,29,,,,,8,8
2019-06-17 06:27,PEK,5138,737-800,25,4,28,5,4,29,,,,,3,4
2019-06-17 06:20,HGH,7618,737-800,26,5,30,5,5,30,,,,,4,4
2019-06-17 06:19,HGH,5406,737-800,28,5,30,5,5,30,,,,,2,2
2019-06-17 06:14,PEK,5538,737-800,20,4,26,2,4,25,,,,,6,5
2019-06-17 05:55,À¥Ã÷,7992,737-800,20,4,25,4,4,26,,,,,5,6
2019-06-17 05:51,HAK,7398,737-800,27,7,36,7,7,36,,,,,9,9
2019-06-17 05:30,XIY,1483,737-800,25,5,27,6,6,27,,,,,2,2
2019-06-17 05:29,XIY,1481,737-800,28,6,31,6,6,31,,,,,3,3
2019-06-17 05:24,FOC,7395,737-800,27,8,36,7,7,33,,,,,9,6
2019-06-17 05:02,PEK,5482,737-800,20,2,30,4,4,30,,,,,10,10
2019-06-17 04:46,URC,5611,737-800,20,4,28,5,4,26,,,,,8,6
2019-06-17 04:40,XIY,1351,737-800,26,5,30,5,5,31,,,,,4,5
2019-06-17 04:24,XIY,1162,737-800,26,4,32,3,2,31,,,,,6,5
2019-06-17 04:24,HGH,1545,737-800,28,4,33,4,4,34,,,,,5,6
2019-06-17 04:23,URC,205U,737-800,15,4,26,2,2,24,,,,,11,9
2019-06-17 04:18,KMG,6016,737-800,20,4,29,6,5,28,,,,,9,8
2019-06-17 04:17,XIY ,206G,737-800,27,4,30,4,4,30,,,,,3,3
2019-06-17 04:17,KMG,6016,737-800,20,4,29,6,5,28,,,,,9,8
2019-06-17 04:12,FOC,1433,737-800,25,3,31,2,2,27,,,,,6,2
2019-06-17 04:11,FOC,1433,737-800,26,3,33,3,3,30,,,,,7,4
2019-06-17 03:54,HAK,5346,737-800,27,5,36,4,4,32,,,,,9,5
2019-06-17 03:48,SYX,5153,737-800,30,4,34,4,4,34,,,,,4,4
2019-06-17 03:47,URC,6995,737-800,15,5,26,4,4,23,,,,,11,8
2019-06-17 03:44,CAN,5579,737-800,29,6,34,6,6,30,,,,,5,1
2019-06-17 03:44,KMG,6809,737-800,20,5,27,6,5,28,,,,,7,8
2019-06-17 03:43,URC,1995,737-800,15,5,28,5,5,28,,,,,13,13
2019-06-17 03:37,XIY,1902,737-800,24,4,28,4,4,24,,,,,4,0
2019-06-17 03:37,URC,2157,737-800,20,5,26,6,4,24,,,,,6,4
2019-06-17 03:35,XIY,5852,737-800,25,4,30,4,4,27,,,,,5,2
2019-06-17 03:29,SZX,5373,737-800,28,6,30,8,8,33,,,,,2,5
2019-06-17 03:23,HHA,5465,737-800,26,5,34,4,4,33,,,,,8,7
2019-06-17 03:20,KMG,5409,737-800,20,4,26,5,5,27,,,,,6,7
2019-06-17 03:18,XIY,1482,737-800,25,4,28,4,4,24,,,,,3,-1
2019-06-17 03:15,XIY,1480,737-800,29,5,26,5,5,26,,,,,-3,-3
2019-06-17 03:14,XIY,1481,737-800,28,4,30,5,5,30,,,,,2,2
2019-06-17 03:13,URC,1497,737-800,16,4,28,3,3,26,,,,,12,10
2019-06-17 03:12,URC ,7198,737-800,20,5,30,5,4,26,,,,,10,6
2019-06-17 03:11,URC ,205T ,737-800,20,3,27,3,3,26,,,,,7,6
2019-06-17 03:06,HAK,1793,737-800,27,6,36,6,6,36,,,,,9,9
2019-06-17 03:05,HAK,5522,737-800,27,7,35,6,7,32,,,,,8,5
2019-06-17 03:02,DLC,1505,737-800,18,4,20,4,4,26,,,,,2,8
2019-06-17 03:00,SZX,7175,737-800,29,4,18,6,5,28,,,,,-11,-1
2019-06-17 02:59,DLC,1799,737-800,20,4,31,4,4,30,,,,,11,10
2019-06-17 02:50,HGH,6063,737-800,30,4,32,6,5,33,,,,,2,3
2019-06-17 02:49,DLC,1996,737-800,19,4,25,5,4,27,,,,,6,8
2019-06-17 02:49,XIY,1733,737-800,25,2,28,2,2,26,,,,,3,1
2019-06-17 02:40,CAN,1997,737-800,28,6,34,4,4,30,,,,,6,2
2019-06-17 02:39,HAK,206F,737-800,28,6,31,5,5,32,,,,,3,4
2019-06-17 02:39,MIG,5732,737-800,25,3,28,3,3,29,,,,,3,4
2019-06-17 02:30,CAN,5337,737-800,27,8,34,7,7,35,,,,,7,8
2019-06-17 02:29,SZX,1548,737-800,28,4,32,4,4,30,,,,,4,2
2019-06-17 02:27,KMG,6800,737-800,20,5,28,4,4,26,,,,,8,6
2019-06-17 02:25,URC,6268,737-800,22,4,24,4,4,22,,,,,2,0
2019-06-17 02:24,HAK,7173,737-800,27,5,35,4,4,33,,,,,8,6
2019-06-17 02:22,HHA,7172,737-800,25,5,33,4,5,32,,,,,8,7
2019-06-17 02:20,SYX,5478,737-800,27,6,36,6,6,32,,,,,9,5
2019-06-17 02:19,HAK,5137,737-800,28,6,27,4,3,25,,,,,-1,-3
2019-06-17 02:19,SYX,6065,737-800,27,4,36,6,6,34,,,,,9,7
2019-06-17 02:17,FOC,5430,737-800,25,6,35,5,5,34,,,,,10,9
2019-06-17 02:16,URC,5637,737-800,18,3,26,3,3,25,,,,,8,7
2019-06-17 02:15,KMG,7993,737-800,21,4,28,5,5,25,,,,,7,4
2019-06-17 02:14,CGO,7991,737-800,28,6,32,5,5,30,,,,,4,2
2019-06-17 02:12,URC,5853,737-800,17,6,28,5,5,22,,,,,11,5
2019-06-17 02:11,MIG,1798,737-800,26,6,31,6,6,29,,,,,5,3
2019-06-17 02:10,PEK,5141,737-800,20,4,30,4,5,31,,,,,10,11
2019-06-17 02:09,HRB,1905,737-800,18,4,27,4,3,23,,,,,9,5
2019-06-17 02:05,HGH,1492,737-800,30,3,32,3,3,30,,,,,2,0
2019-06-17 02:01,DLC,1541,737-800,19,5,27,4,5,28,,,,,8,9
2019-06-17 01:56,XIY,5116,737-800,26,3,28,3,3,28,,,,,2,2
2019-06-17 01:56,SZX,5625,737-800,28,5,32,4,5,33,,,,,4,5
2019-06-17 01:53,HAK,5540,737-800,27,7,36,5,5,34,,,,,9,7
2019-06-17 01:49,HAK,1729,737-800,29,7,32,5,4,31,,,,,3,2
2019-06-17 01:47,DLC,1797,737-800,18,4,28,4,4,25,,,,,10,7
2019-06-17 01:47,FOC,1562,737-800,26,4,32,5,5,34,,,,,6,8
2019-06-17 01:47,URC,1323,737-800,16,3,28,3,3,25,,,,,12,9
2019-06-17 01:44,CAN,5417,737-800,28,5,30,7,7,37,,,,,2,9
2019-06-17 01:37,FOC,1928,737-800,26,5,25,6,6,28,,,,,-1,2
2019-06-17 01:36,XIY,5180,737-800,27,6,30,6,6,28,,,,,3,1
2019-06-17 01:33,CAN,5502,737-800,29,5,31,6,5,32,,,,,2,3
2019-06-17 01:29,PEK,5539,737-800,20,4,30,7,6,29,,,,,10,9
2019-06-17 01:27,URC,5687,737-800,16,3,25,2,3,24,,,,,9,8
2019-06-17 01:26,XIY,1903,737-800,25,2,30,3,3,31,,,,,5,6
2019-06-17 01:25,SYX,5661,737-800,30,5,36,5,6,37,,,,,6,7
2019-06-17 01:22,HRB,1906,737-800,21,6,28,6,7,29,,,,,7,8
2019-06-17 01:22,XIY,5115,737-800,26,2,22,6,6,30,,,,,-4,4
2019-06-17 01:21,TYN ,1386,737-800,25,4,32,4,4,30,,,,,7,5
2019-06-17 01:20,HAK,5797,737-800,28,4,31,4,4,30,,,,,3,2
2019-06-17 01:19,SYX,5686,737-800,27,7,32,6,7,33,,,,,5,6
2019-06-17 01:19,URC,1726,737-800,18,4,28,4,3,30,,,,,10,12
2019-06-17 01:19,CAN,5463,737-800,30,5,27,5,5,30,,,,,-3,0
2019-06-17 01:17,TYN,5083,737-800,23,4,23,4,4,26,,,,,0,3
2019-06-17 01:16,HAK,7619,737-800,26,6,30,6,5,32,,,,,4,6
2019-06-17 01:16,HAK,1495,737-800,26,8,36,5,4,36,1,,,1,10,10
2019-06-17 01:15,XIY,1163,737-800,26,4,24,3,3,24,,,,,-2,-2
2019-06-17 01:13,HGH,1490,737-800,28,4,32,4,4,30,,,,,4,2
2019-06-17 01:12,HGH,5359,737-800,27,4,29,6,5,32,,,,,2,5
2019-06-17 01:10,PEK,5428,737-800,21,6,28,7,6,29,,,,,7,8
2019-06-17 01:10,PEK,5735,737-800,21,2,26,4,4,28,,,,,5,7
2019-06-17 01:10,CAN,1131,737-800,30,3,34,3,3,33,,,,,4,3
2019-06-17 01:09,CAN,1102,737-800,27,2,32,4,4,33,,,,,5,6
2019-06-17 01:08,CGO,1547,737-800,28,6,33,6,6,32,,,,,5,4
2019-06-17 01:07,HAK,7639,737-800,29,4,32,4,5,33,,,,,3,4
2019-06-17 01:04,HAK,5712,737-800,26,2,32,3,3,32,,,,,6,6
2019-06-17 01:04,DLC,1799,737-800,20,4,31,4,4,30,,,,,11,10
2019-06-17 01:04,CAN,1131,737-800,30,3,34,3,3,33,,,,,4,3
2019-06-17 01:03,SZX,5479,737-800,28,8,34,8,8,36,,,,,6,8
2019-06-17 01:00,CKG,7616,737-800,20,5,28,4,4,28,,,,,8,8
2019-06-17 00:59,YIH,1350,737-800,27,5,31,6,5,30,,,,,4,3
2019-06-17 00:58,YIH,1348,737-800,25,6,29,6,5,32,,,,,4,7
2019-06-17 00:54,PEK,5481,737-800,21,6,28,6,5,26,,,,,7,5
2019-06-17 00:53,HHA,1727,737-800,25,5,34,5,5,33,,,,,9,8
2019-06-17 00:53,URC,1725,737-800,18,4,26,4,4,26,,,,,8,8
2019-06-17 00:48,XIY,5480,737-800,25,4,28,2,2,24,,,,,3,-1
2019-06-17 00:46,XIY,7886,737-800,26,4,32,3,3,31,,,,,6,5
2019-06-17 00:46,TYN,5358,737-800,22,4,20,4,5,24,,,,,-2,2
2019-06-17 00:44,CAN,5139,737-800,27,6,30,7,4,31,,,,,3,4
2019-06-17 00:43,XIY,5580,737-800,26,3,30,4,3,32,,,,,4,6
2019-06-17 00:40,URC,1728,737-800,16,4,25,5,4,22,,,,,9,6
2019-06-17 00:36,DLC,5855,737-800,20,5,28,4,4,27,,,,,8,7
2019-06-17 00:35,HAK,1793,737-800,27,6,36,6,6,36,,,,,9,9
2019-06-17 00:33,URC,1493,737-800,22,4,24,4,4,24,,,,,2,2
2019-06-17 00:27,HAK,5429,737-800,27,4,31,5,4,32,,,,,4,5
2019-06-17 00:21,DLC,1795,737-800,25,2,30,4,4,32,,,,,5,7
2019-06-17 00:20,URC,5623,737-800,24,5,28,5,5,26,,,,,4,2
2019-06-17 00:16,HGH,1929,737-800,30,2,28,4,4,28,,,,,-2,-2
2019-06-17 00:13,SYX,5466,737-800,30,5,30,8,6,29,,,,,0,-1
2019-06-17 00:13,HAK,1215,737-800,26,7,35,8,8,35,,,,,9,9
2019-06-17 00:12,XIY,1103,737-800,25,4,34,5,4,32,,,,,9,7
2019-06-17 00:08,KMG,1208,737-800,20,3,31,3,3,30,,,,,11,10
2019-06-17 00:04,PEK,1501,737-800,21,3,32,3,3,32,,,,,11,11
2019-06-17 00:04,MIG,7990,737-800,25,2,29,4,4,29,,,,,4,4
2019-06-17 00:02,SYX,7379,737-800,29,5,36,4,4,37,,,,,7,8
2019-06-17 00:01,CGO,7989,737-800,30,6,30,7,6,30,,,,,0,0
2019-06-17 00:01,SZX,1141,737-800,28,6,34,6,6,32,,,,,6,4
2019-06-16 23:59,PEK,1549,737-800,21,5,29,5,4,29,,,,,8,8
2019-06-16 23:59,CGO,5483,737-800,28,4,29,5,5,28,,,,,1,0
2019-06-16 23:53,XIY,1785,737-800,27,6,34,8,8,30,,,,,7,3
2019-06-16 23:53,TYN,6808,737-800,20,6,30,6,4,28,,,,,10,8
2019-06-16 23:50,URC,205V,737-800,22,4,28,4,4,26,,,,,6,4
2019-06-16 23:49,XIY,1796,737-800,30,4,31,5,4,29,,,,,1,-1
2019-06-16 23:49,SZX,5371,737-800,29,4,28,6,6,32,,,,,-1,3
2019-06-16 23:46,XIY,5372,737-800,26,6,26,8,8,28,,,,,0,2
2019-06-16 23:45,HAK,5090,737-800,27,4,33,4,5,33,,,,,6,6
2019-06-16 23:42,HAK,5429,737-800,25,4,31,5,4,32,,,,,6,7
2019-06-16 23:40,DLC,1489,737-800,19,4,28,4,4,22,,,,,9,3
2019-06-16 23:36,CGO,5636,737-800,29,5,31,6,5,31,,,,,2,2
2019-06-16 23:34,KMG,1587,737-800,22,4,31,4,3,28,,,,,9,6
2019-06-16 23:33,DLC,1927,737-800,20,3,24,4,4,26,,,,,4,6
2019-06-16 23:27,HRB,1559,737-800,19,2,28,4,4,25,,,,,9,6
2019-06-16 23:21,PEK,5798,737-800,21,4,26,3,3,30,,,,,5,9
2019-06-16 23:19,CAN,1538,737-800,28,2,34,3,3,33,,,,,6,5
2019-06-16 23:19,MIG,5449,737-800,30,6,32,6,6,29,,,,,2,-1
2019-06-16 23:19,DLC,7399,737-800,20,4,26,4,4,24,,,,,6,4
2019-06-16 23:19,DLC,7399,737-800,20,4,26,4,4,24,,,,,6,4
2019-06-16 23:13,CKG,5581,737-800,22,4,23,5,4,30,,,,,1,8
2019-06-16 23:09,CAN,1502,737-800,29,3,32,4,4,32,,,,,3,3
2019-06-16 23:04,TYN,1503,737-800,24,2,26,4,4,29,,,,,2,5
2019-06-16 23:01,CGO,1325,737-800,30,4,30,4,4,26,,,,,0,-4
2019-06-16 22:58,SZX,1375,737-800,28,8,36,5,4,30,,,,,8,2
2019-06-16 22:49,TYN,1496,737-800,22,4,28,3,4,27,,,,,6,5
2019-06-16 22:45,XNN,5733,737-800,20,4,26,4,4,23,,,,,6,3
2019-06-16 22:33,CTI,1209,737-800,24,3,36,3,3,36,,1,,1,12,12
2019-06-16 22:31,SYX,1101,737-800,29,4,37,4,3,37,,,,,8,8
2019-06-16 22:29,URC,1569,737-800,20,2,28,2,2,28,,,,,8,8
2019-06-16 22:26,HAK,7171,737-800,26,5,32,4,4,31,,,,,6,5
2019-06-16 22:22,HAK,5521,737-800,26,3,31,7,6,35,,,,,5,9
2019-06-16 22:18,HAK,206H,737-800,27,3,34,3,2,33,,,,,7,6
2019-06-16 22:12,HAK,5082,737-800,27,6,36,6,5,34,,,,,9,7
2019-06-16 22:11,PEK,1213,737-800,21,7,32,6,4,33,,,,,11,12
2019-06-16 22:10,URC,1570,737-800,21,4,18,4,5,22,,,,,-3,1
2019-06-16 22:04,HGH,1491,737-800,30,5,31,6,5,30,,,,,1,0
2019-06-16 21:47,XNN,5136,737-800,20,4,23,5,5,26,,,,,3,6
2019-06-16 21:42,HAK,1735,737-800,27,4,36,4,5,32,,,,,9,5
2019-06-16 21:36,HAK,5418,737-800,30,7,34,6,6,33,,,,,4,3
2019-06-16 20:25,TYN,5375,737-800,27,3,24,4,4,25,,,,,-3,-2
2019-06-16 19:47,HRB,7105,737-800,22,5,29,4,3,26,,,,,7,4
2019-06-16 19:43,CGO,1586,737-800,30,4,30,3,4,28,,,,,0,-2
2019-06-16 19:42,HAK,7378,737-800,28,6,35,6,6,35,,,,,7,7
2019-06-16 19:23,GGO,7167,737-800,30,5,28,5,5,27,,,,,-2,-3
2019-06-16 19:14,CKG,5439,737-800,22,4,28,4,4,26,,,,,6,4
2019-06-16 18:04,URC,6268,737-800,28,4,29,4,5,28,,,,,1,0
2019-06-16 16:26,XMN,6103,737-800,26,6,36,8,8,37,,,,,10,11
2019-06-16 13:13,PEK,7400,737-800,20,5,26,6,5,25,,,,,6,5
2019-06-16 11:59,URC,1568,737-800,28,6,28,7,8,30,,,,,0,2
2019-06-16 09:03,SZX,5712,737-800,28,2,32,2,2,31,,,,,4,3
2019-06-16 08:34,KMG,1208,737-800,20,6,26,4,5,27,,,,,6,7
2019-06-16 07:57,SZX,7175,737-800,28,4,21,6,5,30,,,,,-7,2
2019-06-16 07:47,205,1130,737-800,22,2,32,3,3,31,,,,,10,9
2019-06-16 07:15,PEK,5481,737-800,24,5,28,6,5,26,,,,,4,2
2019-06-16 07:14,PEK,5478,737-800,23,5,30,3,4,27,,,,,7,4
2019-06-16 07:12,KMG,7988,737-800,20,5,30,4,6,32,,,,,10,12
2019-06-16 06:58,HAK,5429,737-800,29,4,32,5,4,32,,,,,3,3
2019-06-16 06:54,CAN,1502,737-800,27,4,32,3,4,32,,,,,5,5
2019-06-16 06:37,SZX,5462,737-800,28,4,31,4,5,33,,,,,3,5
2019-06-16 06:37,FOC,7113,737-800,26,5,30,6,6,32,,,,,4,6
2019-06-16 06:32,TYN,7399,737-800,25,4,28,4,4,25,,,,,3,0
2019-06-16 06:11,FOC,7113,737-800,26,5,30,6,6,32,,,,,4,6
2019-06-16 06:10,FOC,7113,737-800,26,6,35,6,6,32,,,,,9,6
2019-06-16 06:02,XIY,1162,737-800,25,2,33,4,3,33,,,,,8,8
2019-06-16 05:59,HHA,7172,737-800,26,6,30,6,4,30,,,,,4,4
2019-06-16 05:49,CAN,1502,737-800,27,4,32,3,4,32,,,,,5,5
2019-06-16 05:47,ZGC,5405,737-800,15,7,22,6,4,25,,,,,7,10
2019-06-16 05:33,XIY,1162,737-800,22,2,33,4,3,33,,,,,11,11
2019-06-16 05:31,HHA,7173,737-800,26,5,34,5,6,32,,,,,8,6
2019-06-16 05:29,URC,7198,737-800,24,6,30,6,5,28,,,,,6,4
2019-06-16 05:18,XIY,1902,737-800,24,4,28,4,4,26,,,,,4,2
2019-06-16 05:17,HAK,5522,737-800,27,5,37,8,8,36,,,,,10,9
2019-06-16 05:15,FOC,5430,737-800,21,0,0,6,6,30,,,,,-21,9
2019-06-16 05:14,FOC,5430,737-800,24,6,34,6,6,35,,,,,10,11
2019-06-16 05:14,TSN,5449,737-800,24,4,28,4,4,28,,,,,4,4
2019-06-16 05:07,FOC,7395,737-800,23,5,28,5,5,26,,,,,5,3
2019-06-16 05:04,URC,205T,737-800,23,3,28,3,3,27,,,,,5,4
2019-06-16 04:57,SYX,7379,737-800,25,6,30,4,4,30,,,,,5,5
2019-06-16 04:56,SYX,5466,737-800,25,5,30,8,8,30,,,,,5,5
2019-06-16 04:55,CAN,1997,737-800,27,6,34,6,5,34,,,,,7,7
2019-06-16 04:55,ÈýÑÇ,5466,737-800,25,5,30,8,8,30,,,,,5,5
2019-06-16 04:54,CAN,1495,737-800,29,6,35,5,6,34,,,,,6,5
2019-06-16 04:53,CAN,5463,737-800,27,5,30,6,6,32,,,,,3,5
2019-06-16 04:43,XIY,5115,737-800,22,4,28,4,4,30,,,,,6,8
2019-06-16 04:36,URC,5798,737-800,20,2,24,2,3,23,,,,,4,3
2019-06-16 04:36,PEK,5539,737-800,25,6,34,6,6,30,,,,,9,5
2019-06-16 04:36,URC,2157,737-800,22,4,22,5,3,26,,,,,0,4
2019-06-16 04:33,URC,5853,737-800,26,5,26,4,4,22,,,,,0,-4
2019-06-16 04:28,CGO,5409,737-800,28,3,28,6,5,30,,,,,0,2
2019-06-16 04:17,PEK,5538,737-800,21,4,31,3,3,33,,,,,10,12
2019-06-16 04:13,CGO,7989,737-800,28,5,28,6,5,28,,,,,0,0
2019-06-16 04:07,KMG,1586,737-800,20,2,30,2,2,24,,,,,10,4
2019-06-16 04:06,URC,6995,737-800,20,3,28,5,5,26,,,,,8,6
2019-06-16 04:00,KMG,6800,737-800,22,4,30,4,4,28,,,,,8,6
2019-06-16 03:57,URC,205U,737-800,22,4,28,4,4,26,,,,,6,4
2019-06-16 03:56,XIY,5372,737-800,23,7,26,6,7,27,,,,,3,4
2019-06-16 03:55,FOC,1729,737-800,23,5,28,5,5,26,,,,,5,3
2019-06-16 03:54,URC,5611,737-800,25,6,28,6,6,26,,,,,3,1
2019-06-16 03:44,SZX,206F,737-800,28,3,32,3,3,30,,,,,4,2
2019-06-16 03:42,TYN,5479,737-800,25,6,28,4,4,26,,,,,3,1
2019-06-16 03:40,HHA,5375,737-800,26,2,30,4,4,28,,,,,4,2
2019-06-16 03:40,HHA,7172,737-800,26,5,34,5,6,32,,,,,8,6
2019-06-16 03:39,HGH,7619,737-800,25,5,27,4,5,28,,,,,2,3
2019-06-16 03:34,URC,5623,737-800,25,6,26,6,6,24,,,,,1,-1
2019-06-16 03:30,HGH,7377,737-800,25,6,32,6,6,30,,,,,7,5
2019-06-16 03:29,KMG,7991,737-800,20,6,28,5,5,29,,,,,8,9
2019-06-16 03:27,HHA,1783,737-800,27,4,28,6,5,30,,,,,1,3
2019-06-16 03:18,URC,5359,737-800,25,4,24,4,4,26,,,,,-1,1
2019-06-16 03:13,HAK,1496,737-800,28,6,36,2,2,32,,,,,8,4
2019-06-16 03:09,HGH,1545,737-800,26,5,29,5,5,31,,,,,3,5
2019-06-16 03:08,PEK,7400,737-800,25,5,28,4,4,26,,,,,3,1
2019-06-16 03:05,XIY,1906,737-800,23,6,31,7,6,31,,,,,8,8
2019-06-16 03:03,XIY,5797,737-800,23,5,25,6,5,24,,,,,2,1
2019-06-16 03:01,XIY,5141,737-800,25,6,26,6,5,26,,,,,1,1
2019-06-16 02:53,HGH,1346,737-800,24,6,29,7,7,30,,,,,5,6
2019-06-16 02:51,FOC,5503,737-800,24,3,29,4,3,27,,,,,5,3
2019-06-16 02:49,HAK,1793,737-800,28,7,37,6,6,36,,,,,9,8
2019-06-16 02:48,SYX,5581,737-800,30,8,36,5,5,34,,,,,6,4
2019-06-16 02:41,XIY,206H,737-800,20,4,21,4,4,22,,,,,1,2
2019-06-16 02:40,KMG,7992,737-800,20,7,30,8,8,30,,,,,10,10
2019-06-16 02:39,º£¿Ú,1492,737-800,30,4,34,5,4,33,,,,,4,3
2019-06-16 02:37,PEK,1549,737-800,25,4,28,4,4,26,,,,,3,1
2019-06-16 02:37,TYN,5852,737-800,23,5,29,5,5,29,,,,,6,6
2019-06-16 02:36,XIY,1480,737-800,23,4,28,5,5,28,,,,,5,5
2019-06-16 02:33,URC,2159,737-800,25,2,28,2,4,26,,,,,3,1
2019-06-16 02:31,HAK,5418,737-800,26,7,30,6,5,32,,,,,4,6
2019-06-16 02:29,HAK,5540,737-800,27,8,37,6,6,34,,,,,10,7
2019-06-16 02:28,,FOC,737-800,23,3,33,3,3,26,,,,,10,3
2019-06-16 02:18,PEK,1733,737-800,25,4,27,3,3,25,,,,,2,0
2019-06-16 02:17,CAN,1495,737-800,29,6,35,5,6,34,,,,,6,5
2019-06-16 02:15,XIY ,1481,737-800,23,5,28,5,6,28,,,,,5,5
2019-06-16 02:13,ZGC,5638,737-800,17,8,25,8,7,26,,,,,8,9
2019-06-16 02:10,HGH,5139,737-800,25,4,30,7,4,30,,,,,5,5
2019-06-16 02:09,URC,1323,737-800,25,4,26,4,6,26,,,,,1,1
2019-06-16 02:09,URC,5637,737-800,20,2,26,4,2,26,,,,,6,6
2019-06-16 02:08,XIY,1903,737-800,25,2,28,2,2,30,,,,,3,5
2019-06-16 02:06,XIY,1483,737-800,23,4,24,4,4,26,,,,,1,3
2019-06-16 02:02,HAK,7378,737-800,27,5,28,8,6,34,,,,,1,7
2019-06-16 02:02,HAK,5579,737-800,26,6,36,6,6,34,1,,,1,10,8
2019-06-16 02:01,DLC,1489,737-800,20,3,27,3,3,28,,,,,7,8
2019-06-16 02:00,SYX,5661,737-800,30,4,34,6,6,36,,,,,4,6
2019-06-16 01:57,ZGC,5416,737-800,15,6,26,8,7,24,,,,,11,9
2019-06-16 01:55,CAN,5463,737-800,27,5,30,6,6,32,,,,,3,5
2019-06-16 01:54,ZGC,5338,737-800,20,8,26,6,8,24,,,,,6,4
2019-06-16 01:54,URC,1569,737-800,25,2,28,2,2,26,,,,,3,1
2019-06-16 01:49,TYN,6808,737-800,20,2,26,2,2,24,,,,,6,4
2019-06-16 01:48,DLC,1797,737-800,20,3,28,4,3,24,,,,,8,4
2019-06-16 01:47,XIY,1796,737-800,25,5,29,5,4,28,,,,,4,3
2019-06-16 01:47,HAK,5371,737-800,27,7,31,7,7,34,,,,,4,7
2019-06-16 01:47,XIY,1796,737-800,25,5,29,5,4,28,,,,,4,3
2019-06-16 01:44,URC,5687,737-800,25,4,27,5,5,26,,,,,2,1
2019-06-16 01:43,XIY,5180,737-800,25,8,28,6,6,24,,,,,3,-1
2019-06-16 01:42,HGH,5406,737-800,28,4,30,4,4,28,,,,,2,0
2019-06-16 01:40,TYN,5083,737-800,26,4,26,3,4,24,,,,,0,-2
2019-06-16 01:37,SYX,5686,737-800,30,6,36,5,5,35,,,,,6,5
2019-06-16 01:33,HGH,1929,737-800,26,4,27,4,4,27,,,,,1,1
2019-06-16 01:33,KMG,6016,737-800,20,6,34,4,4,33,,,,,14,13
2019-06-16 01:31,108,5482,737-800,25,2,30,3,3,31,,,,,5,6
2019-06-16 01:26,DLC,1541,737-800,22,4,28,4,4,28,,,,,6,6
2019-06-16 01:25,HAK,1727,737-800,27,5,36,6,6,34,,,,,9,7
2019-06-16 01:24,HHA,1347,737-800,27,4,29,4,4,28,,,,,2,1
2019-06-16 01:21,SYX,5709,737-800,29,6,37,7,9,37,,,,,8,8
2019-06-16 01:18,HHA,5135,737-800,28,3,26,4,5,32,,,,,-2,4
2019-06-16 01:17,CAN,5502,737-800,28,5,31,6,5,32,,,,,3,4
2019-06-16 01:16,DLC,1215,737-800,21,3,28,3,4,29,,,,,7,8
2019-06-16 01:15,XIY,5358,737-800,30,5,24,4,5,26,,,,,-6,-4
2019-06-16 01:14,Ö£ÖÝ,7167,737-800,29,6,32,6,5,30,,,,,3,1
2019-06-16 01:12,URC,1725,737-800,20,5,28,4,4,28,,,,,8,8
2019-06-16 01:09,ÃàÑô,6809,737-800,23,5,28,6,5,30,,,,,5,7
2019-06-16 01:08,CTU,1209,737-800,25,3,31,3,3,32,,,,,6,7
2019-06-16 01:07,CAN,1372,737-800,27,6,37,7,7,36,,,,,10,9
2019-06-16 01:05,XIY,5408,737-800,24,5,30,5,4,27,,,,,6,3
2019-06-16 01:05,XIY,5580,737-800,23,4,26,5,4,26,,,,,3,3
2019-06-16 01:01,HHA,1373,737-800,30,4,32,4,5,28,,,,,2,-2
2019-06-16 00:59,YIH,1435,737-800,25,6,31,6,6,30,,,,,6,5
2019-06-16 00:52,CAN,5417,737-800,29,4,32,8,7,37,,,,,3,8
2019-06-16 00:52,HAK,6062,737-800,30,2,34,4,4,36,,,,,4,6
2019-06-16 00:51,URC,1726,737-800,20,4,25,4,4,26,,,,,5,6
2019-06-16 00:51,MIG,5732,737-800,20,2,26,3,2,28,,,,,6,8
2019-06-16 00:50,SZX,1375,737-800,28,7,36,4,4,31,,,,,8,3
2019-06-16 00:44,CAN,1491,737-800,28,4,34,6,6,35,,,,,6,7
2019-06-16 00:43,FOC,1562,737-800,24,4,29,4,4,32,,,,,5,8
2019-06-16 00:42,URC,1548,737-800,20,3,25,4,4,25,,,,,5,5
2019-06-16 00:40,SYX,6065,737-800,28,5,37,4,3,34,,,,,9,6
2019-06-16 00:40,HRB,1905,737-800,20,4,26,4,3,26,,,,,6,6
2019-06-16 00:39,XIY,7886,737-800,23,4,32,3,3,31,,,,,9,8
2019-06-16 00:38,FOC,7395,737-800,26,6,30,5,6,26,,,,,4,0
2019-06-16 00:36,KMG,1587,737-800,20,6,34,5,3,30,,,,,14,10
2019-06-16 00:33,HAK,7639,737-800,26,6,37,7,6,33,1,,,1,11,7
2019-06-16 00:30,XIY,5116,737-800,24,3,26,4,4,25,,,,,2,1
2019-06-16 00:30,URC,1493,737-800,20,3,28,7,7,24,,,,,8,4
2019-06-16 00:28,HAK,1102,737-800,26,8,36,7,6,37,1,1,,11,10,11
2019-06-16 00:28,PEK,5337,737-800,24,5,32,5,5,30,,,,,8,6
2019-06-16 00:25,YIH,1348,737-800,24,4,32,4,4,28,,,,,8,4
2019-06-16 00:22,CKG,5636,737-800,20,6,28,5,5,28,,,,,8,8
2019-06-16 00:15,º£¿Ú,6015,737-800,30,2,35,2,2,30,,,,,5,0
2019-06-15 23:58,MIG,1798,737-800,20,3,33,3,3,26,1,,,1,13,6
2019-06-15 23:56,SZX,5373,737-800,28,6,30,8,8,34,,,,,2,6
2019-06-15 23:49,XIY,1103,737-800,24,4,33,4,4,32,,,,,9,8
2019-06-15 23:48,SZX,5625,737-800,28,6,32,5,5,34,,,,,4,6
2019-06-15 23:44,104,1213,737-800,23,6,32,6,6,32,,,,,9,9
2019-06-15 23:43,SYX,1490,737-800,30,6,35,6,6,34,,,,,5,4
2019-06-15 23:41,Ì«Ô­,5136,737-800,25,5,26,5,5,24,,,,,1,-1
2019-06-15 23:39,HRB,1351,737-800,16,3,30,4,4,30,,,,,14,14
2019-06-15 23:39,HAK,5346,737-800,27,6,37,7,7,35,,,,,10,8
2019-06-15 23:36,HRB,7105,737-800,17,3,27,4,4,25,,,,,10,8
2019-06-15 23:35,DLC,1505,737-800,22,2,20,4,4,26,,,,,-2,4
2019-06-15 23:31,CAN,1131,737-800,29,6,36,6,5,36,,,,,7,7
2019-06-15 23:30,CAN,5137,737-800,28,7,28,4,3,35,,,,,0,7
2019-06-15 23:30,DLC,1795,737-800,21,4,28,3,4,29,,,,,7,8
2019-06-15 23:28,DLC,5855,737-800,21,6,28,6,7,26,,,,,7,5
2019-06-15 23:26,CKG,7616,737-800,20,4,23,4,5,24,,,,,3,4
2019-06-15 23:23,HAK,5465,737-800,28,6,35,4,4,35,,,,,7,7
2019-06-15 23:20,CGO,1325,737-800,30,4,28,4,4,25,,,,,-2,-5
2019-06-15 23:18,HGH,7618,737-800,29,4,28,6,6,28,,,,,-1,-1
2019-06-15 23:16,XNN,7171,737-800,20,7,18,6,6,17,,,,,-2,-3
2019-06-15 23:13,HAK,1786,737-800,27,4,33,5,4,32,,,,,6,5
2019-06-15 23:11,HRB,1559,737-800,22,3,30,3,3,27,,,,,8,5
2019-06-15 23:11,PEK,1927,737-800,27,4,24,2,5,28,,,,,-3,1
2019-06-15 23:06,CGO,5483,737-800,30,6,28,6,4,29,,,,,-2,-1
2019-06-15 22:53,DLC,1386,737-800,20,3,28,3,3,27,,,,,8,7
2019-06-15 22:52,CKG,5439,737-800,20,4,29,4,4,29,,,,,9,9
2019-06-15 22:40,URC,1995,737-800,30,4,28,4,4,30,,,,,-2,0
2019-06-15 22:35,HAK,206G,737-800,26,3,34,4,4,34,,,,,8,8
2019-06-15 22:33,URC,5853,737-800,22,6,27,6,7,24,,,,,5,2
2019-06-15 22:27,HGH,6063,737-800,25,6,32,6,6,30,,,,,7,5
2019-06-15 22:26,DLC,1928,737-800,20,5,25,5,6,26,,,,,5,6
2019-06-15 22:17,CAN,1538,737-800,30,3,34,3,3,35,,,,,4,5
2019-06-15 22:12,HAK,5521,737-800,28,5,31,5,4,32,,,,,3,4
2019-06-15 22:07,Î÷Äþ,5733,737-800,21,4,23,6,5,21,,,,,2,0
2019-06-15 22:05,DLC,1503,737-800,24,4,28,2,2,26,,,,,4,2
2019-06-15 22:02,SYX,5153,737-800,29,6,35,4,4,32,,,,,6,3
2019-06-15 21:48,HHA,5520,737-800,28,5,32,6,5,34,,,,,4,6
2019-06-15 21:35,URC,1570,737-800,30,6,20,6,6,24,,,,,-10,-6
2019-06-15 19:03,HAK,5082,737-800,26,6,34,4,5,33,,,,,8,7
2019-06-15 17:48,YIH,1350,737-800,28,4,33,4,4,32,,,,,5,4
2019-06-15 17:07,PEK,1996,737-800,30,5,32,5,5,32,,,,,2,2
2019-06-15 16:31,KMG,1208,737-800,20,6,26,5,4,27,,,,,6,7
2019-06-15 15:32,TYN,1799,737-800,35,4,32,4,4,30,,,,,-3,-5
2019-06-15 15:30,PEK,6066,737-800,30,6,34,6,5,32,,,,,4,2
2019-06-15 12:20,URC ,1568,737-800,30,6,30,8,8,32,,,,,0,2
2019-06-15 11:04,CTU ,1209,737-800,23,4,32,4,4,32,,,,,9,9
2019-06-15 09:20,KMG,6800,737-800,20,3,28,4,4,26,,,,,8,6
2019-06-15 08:51,KMG,6016,737-800,20,5,35,5,5,35,,,,,15,15
2019-06-15 08:39,HAK,5338,737-800,29,2,30,5,5,34,,,,,1,5
2019-06-15 08:05,YIH,1348,737-800,27,4,32,4,4,32,,,,,5,5
2019-06-15 08:02,¹ãÖÝ,5358,737-800,27,4,30,4,5,32,,,,,3,5
2019-06-15 07:43,ZGC,5416,737-800,18,8,26,6,7,25,,,,,8,7
2019-06-15 07:40,PEK ,1729,737-800,25,4,30,3,3,28,,,,,5,3
2019-06-15 07:28,FOC,1562,737-800,27,3,30,4,4,31,,,,,3,4
2019-06-15 07:22,XMN,1733,737-800,25,4,32,5,4,27,,,,,7,2
2019-06-15 07:21,XMN,7173,737-800,20,4,29,5,7,30,,,,,9,10
2019-06-15 07:20,XMN,1796,737-800,26,4,30,5,4,31,,,,,4,5
2019-06-15 07:20,XMN,1542,737-800,25,4,25,4,5,28,,,,,0,3
2019-06-15 07:15,FOC,7113,737-800,24,5,36,5,5,32,1,,,1,12,8
2019-06-15 06:44,SYX,6065,737-800,30,5,35,5,5,36,,,,,5,6
2019-06-15 06:27,HAK,5430,737-800,28,3,35,4,5,36,,,,,7,8
2019-06-15 06:27,SYX,5686,737-800,28,5,32,4,4,28,,,,,4,0
2019-06-15 06:24,HGH,5478,737-800,25,4,24,2,2,24,,,,,-1,-1
2019-06-15 06:18,FOC,1562,737-800,26,4,31,4,4,32,,,,,5,6
2019-06-15 06:16,CAN,1502,737-800,27,4,30,4,4,32,,,,,3,5
2019-06-15 06:12,URC,5797,737-800,26,6,20,6,6,26,,,,,-6,0
2019-06-15 06:10,URC,7198,737-800,24,2,28,2,2,26,,,,,4,2
2019-06-15 05:55,CKG,1101,737-800,27,3,30,2,2,28,,,,,3,1
2019-06-15 05:54,CKG,7377,737-800,27,6,30,7,7,30,,,,,3,3
2019-06-15 05:50,º£¿Ú,1103,737-800,27,6,36,4,4,36,,,,,9,9
2019-06-15 05:49,HAK ,1102,737-800,27,3,36,4,4,36,,,,,9,9
2019-06-15 05:34,SYX,5418,737-800,31,6,34,6,6,34,,,,,3,3
2019-06-15 05:32,FOC,7113,737-800,24,8,40,10,10,40,,,,,16,16
2019-06-15 05:31,XIY,5481,737-800,28,5,30,5,6,28,,,,,2,0
2019-06-15 05:08,CGO,5465,737-800,30,3,29,4,4,31,,,,,-1,1
2019-06-15 05:07,XIY,5855,737-800,29,4,26,7,7,27,,,,,-3,-2
2019-06-15 04:58,XIY,1163,737-800,26,4,32,2,3,30,,,,,6,4
2019-06-15 04:50,HAK,1793,737-800,28,8,36,7,6,36,,,,,8,8
2019-06-15 04:43,PEK,5581,737-800,25,4,25,4,4,20,,,,,0,-5
2019-06-15 04:41,HGH,1545,737-800,23,5,30,6,6,30,,,,,7,7
2019-06-15 04:25,ÃàÑô,5449,737-800,26,6,32,5,5,30,,,,,6,4
2019-06-15 04:24,XIY,1481,737-800,25,6,30,6,6,30,,,,,5,5
2019-06-15 04:23,HAK,1793,737-800,28,8,38,7,6,36,,,,,10,8
2019-06-15 04:17,KMG,1208,737-800,21,5,31,3,3,28,,,,,10,7
2019-06-15 04:14,URC,1323,737-800,22,2,28,2,2,24,,,,,6,2
2019-06-15 04:10,XIY,5480,737-800,26,3,27,3,3,26,,,,,1,0
2019-06-15 04:03,TYN,5083,737-800,20,0,24,4,4,26,,,,,4,6
2019-06-15 04:00,HAK,1141,737-800,27,5,33,5,5,32,,,,,6,5
2019-06-15 03:58,XMN,1542,737-800,25,4,25,4,5,28,,,,,0,3
2019-06-15 03:58,XMN,7173,737-800,20,4,29,5,7,30,,,,,9,10
2019-06-15 03:57,XMN,1733,737-800,25,4,32,5,4,27,,,,,7,2
2019-06-15 03:55,XIY,1483,737-800,25,5,28,6,6,28,,,,,3,3
2019-06-15 03:54,URC,1568,737-800,20,2,28,5,4,26,,,,,8,6
2019-06-15 03:53,SZX,5462,737-800,27,4,32,4,4,34,,,,,5,7
2019-06-15 03:49,XMN,1796,737-800,26,4,30,5,4,31,,,,,4,5
2019-06-15 03:40,SHA,1501,737-800,23,9,33,3,4,29,,,,,10,6
2019-06-15 03:39,º£¿Ú,5520,737-800,28,5,24,7,6,34,,,,,-4,6
2019-06-15 03:38,HGH,5139,737-800,23,4,24,6,4,30,,,,,1,7
2019-06-15 03:37,SHA,5662,737-800,23,2,27,2,5,26,,,,,4,3
2019-06-15 03:35,DLC,1795,737-800,20,4,28,4,4,28,,,,,8,8
2019-06-15 03:32,URC ,1569,737-800,25,4,25,4,5,26,,,,,0,1
2019-06-15 03:31,XIY,5180,737-800,26,6,30,6,6,34,,,,,4,8
2019-06-15 03:31,DLC,1215,737-800,24,4,32,4,4,32,,,,,8,8
2019-06-15 03:30,CAN,6063,737-800,28,6,34,6,6,34,,,,,6,6
2019-06-15 03:25,DLC,1503,737-800,21,2,28,2,2,28,,,,,7,7
2019-06-15 03:25,CGO,7989,737-800,27,5,27,5,5,27,,,,,0,0
2019-06-15 03:25,PEK ,5539,737-800,25,5,30,5,5,28,,,,,5,3
2019-06-15 03:25,TYN,6808,737-800,25,5,28,4,4,26,,,,,3,1
2019-06-15 03:25,DLC,1503,737-800,21,2,28,2,2,28,,,,,7,7
2019-06-15 03:22,CAN,5463,737-800,26,4,36,6,5,29,1,,,1,10,3
2019-06-15 03:19,XIY,1906,737-800,25,4,27,3,4,28,,,,,2,3
2019-06-15 03:16,URC,1725,737-800,22,4,30,4,4,30,,,,,8,8
2019-06-15 03:09,XIY,1161,737-800,26,6,29,4,4,28,,,,,3,2
2019-06-15 03:08,FOC,1433,737-800,25,3,33,3,3,28,,,,,8,3
2019-06-15 03:07,HAK,5502,737-800,27,8,32,8,8,32,,,,,5,5
2019-06-15 03:07,SZX,1735,737-800,29,5,33,5,4,28,,,,,4,-1
2019-06-15 03:06,HAK,1927,737-800,27,4,30,4,4,30,,,,,3,3
2019-06-15 03:03,HAK,5712,737-800,28,3,23,3,3,32,,,,,-5,4
2019-06-15 03:01,MIG,1798,737-800,25,5,34,3,4,28,,,,,9,3
2019-06-15 02:58,SYX,6065,737-800,30,6,38,9,9,38,,,,,8,8
2019-06-15 02:56,SZX,5625,737-800,28,4,30,4,4,32,,,,,2,4
2019-06-15 02:55,ZGC,5709,737-800,15,6,28,8,6,28,,,,,13,13
2019-06-15 02:54,URC,5611,737-800,22,6,28,4,4,24,,,,,6,2
2019-06-15 02:54,ZGC,1498,737-800,15,6,25,4,4,24,,,,,10,9
2019-06-15 02:52,HGH,1497,737-800,23,3,26,3,2,22,,,,,3,-1
2019-06-15 02:52,TYN,1799,737-800,25,4,26,4,4,26,,,,,1,1
2019-06-15 02:52,URC,5637,737-800,21,1,27,1,1,24,,,,,6,3
2019-06-15 02:52,FOC ,1350,737-800,25,5,27,5,4,27,,,,,2,2
2019-06-15 02:48,XIY,1482,737-800,26,5,30,6,6,28,,,,,4,2
2019-06-15 02:47,XIY,5580,737-800,30,3,28,4,4,32,,,,,-2,2
2019-06-15 02:46,DLC,1541,737-800,20,4,28,6,4,28,,,,,8,8
2019-06-15 02:45,HRB,1351,737-800,14,4,28,0,0,0,,,,,14,-14
2019-06-15 02:45,HGH,7619,737-800,22,3,24,3,2,25,,,,,2,3
2019-06-15 02:44,URC,1728,737-800,25,4,28,4,4,24,,,,,3,-1
2019-06-15 02:41,KMG,6015,737-800,18,3,28,4,4,25,,,,,10,7
2019-06-15 02:40,TYN,5479,737-800,25,4,25,5,5,24,,,,,0,-1
2019-06-15 02:35,HAK,7398,737-800,27,7,36,8,8,36,,,,,9,9
2019-06-15 02:28,SYX,5661,737-800,30,5,37,7,5,37,,,,,7,7
2019-06-15 02:26,DLC,1505,737-800,21,3,22,4,3,24,,,,,1,3
2019-06-15 02:26,URC,6268,737-800,22,2,28,3,3,28,,,,,6,6
2019-06-15 02:23,DLC,1797,737-800,20,6,28,4,4,26,,,,,8,6
2019-06-15 02:23,CAN,1495,737-800,30,7,36,5,5,35,,,,,6,5
2019-06-15 02:20,DLC,1549,737-800,20,6,28,4,5,26,,,,,8,6
2019-06-15 02:17,URC,5623,737-800,23,6,27,7,6,24,,,,,4,1
2019-06-15 02:17,FOC,7400,737-800,25,5,25,5,4,27,,,,,0,2
2019-06-15 02:15,DLC,1489,737-800,22,4,29,4,4,30,,,,,7,8
2019-06-15 02:15,PEK ,5482,737-800,25,2,30,4,4,32,,,,,5,7
2019-06-15 02:12,HAK,1587,737-800,30,7,37,6,5,33,,,,,7,3
2019-06-15 02:11,XIY,5141,737-800,27,5,28,7,7,30,,,,,1,3
2019-06-15 02:10,PEK ,6066,737-800,25,5,30,5,5,29,,,,,5,4
2019-06-15 02:10,DLC,1386,737-800,21,4,30,4,3,28,,,,,9,7
2019-06-15 02:04,HHA,1347,737-800,25,4,34,4,4,32,,,,,9,7
2019-06-15 02:00,SYX,5466,737-800,30,0,21,5,0,22,,,,,-9,-8
2019-06-15 02:00,SYX,7379,737-800,30,4,36,5,4,36,,,,,6,6
2019-06-15 01:59,CAN,5371,737-800,25,4,32,4,5,32,,,,,7,7
2019-06-15 01:57,HRB,7105,737-800,15,5,26,5,6,24,,,,,11,9
2019-06-15 01:54,HAK,5733,737-800,28,6,37,4,4,34,,,,,9,6
2019-06-15 01:54,HRB,7105,737-800,15,5,30,5,6,26,,,,,15,11
2019-06-15 01:53,HHA,1373,737-800,26,4,30,4,4,24,,,,,4,-2
2019-06-15 01:52,SZX,1727,737-800,28,5,35,4,4,31,,,,,7,3
2019-06-15 01:51,URC,2157,737-800,20,2,22,4,5,23,,,,,2,3
2019-06-15 01:48,URC,5798,737-800,23,6,27,4,4,25,,,,,4,2
2019-06-15 01:46,HAK,1538,737-800,29,2,36,2,2,36,,,,,7,7
2019-06-15 01:42,SZX,206F,737-800,25,4,32,4,4,32,,,,,7,7
2019-06-15 01:42,CAN,7639,737-800,27,6,35,6,6,32,,,,,8,5
2019-06-15 01:36,HRB,1351,737-800,15,4,30,4,4,28,,,,,15,13
2019-06-15 01:34,HAK,7378,737-800,28,6,33,8,5,34,,,,,5,6
2019-06-15 01:34,HAK ,5337,737-800,27,8,37,8,8,36,1,1,,11,10,9
2019-06-15 01:34,HHA,1547,737-800,25,6,35,6,5,32,,,,,10,7
2019-06-15 01:34,HAK ,5337,737-800,27,8,37,8,8,36,,,,,10,9
2019-06-15 01:31,PEK,5735,737-800,30,2,26,2,2,26,,,,,-4,-4
2019-06-15 01:30,XIY,5638,737-800,27,4,29,4,4,32,,,,,2,5
2019-06-15 01:30,PEK,5375,737-800,30,2,26,2,2,26,,,,,-4,-4
2019-06-15 01:29,XIY,1480,737-800,27,4,28,4,5,30,,,,,1,3
2019-06-15 01:29,Ö£ÖÝ,5483,737-800,30,3,27,3,3,25,,,,,-3,-5
2019-06-15 01:29,HGH,5405,737-800,23,5,30,5,5,30,,,,,7,7
2019-06-15 01:26,XIY,1162,737-800,25,4,34,4,4,32,,,,,9,7
2019-06-15 01:20,SZX,1492,737-800,27,4,36,3,3,31,,,,,9,4
2019-06-15 01:13,CAN,1131,737-800,28,5,35,5,4,34,,,,,7,6
2019-06-15 01:12,PEK ,1213,737-800,25,5,30,5,5,30,,,,,5,5
2019-06-15 01:12,HHA,5135,737-800,25,2,28,3,2,29,,,,,3,4
2019-06-15 01:10,SYX,5430,737-800,33,5,36,5,5,34,,,,,3,1
2019-06-15 01:03,HGH,5406,737-800,22,4,30,6,4,28,,,,,8,6
2019-06-15 01:02,URC,1493,737-800,23,6,28,6,6,24,,,,,5,1
2019-06-15 01:02,URC,205T,737-800,20,2,28,5,4,25,,,,,8,5
2019-06-15 00:55,KMG,7991,737-800,20,6,30,6,5,30,,,,,10,10
2019-06-15 00:55,XIY,1903,737-800,26,4,28,3,4,27,,,,,2,1
2019-06-15 00:52,HHA,6103,737-800,26,5,33,7,7,36,,,,,7,10
2019-06-15 00:51,URC,2159,737-800,24,2,24,2,2,22,,,,,0,-2
2019-06-15 00:40,YIH,1435,737-800,25,5,29,6,5,28,,,,,4,3
2019-06-15 00:39,PEK,5138,737-800,25,4,29,5,6,28,,,,,4,3
2019-06-15 00:33,XIY,1929,737-800,30,4,26,4,3,28,,,,,-4,-2
2019-06-15 00:32,CAN,1372,737-800,28,6,36,5,6,36,,,,,8,8
2019-06-15 00:27,HRB,1905,737-800,17,3,28,4,3,26,,,,,11,9
2019-06-15 00:26,PEK,1996,737-800,26,5,27,6,6,30,,,,,1,4
2019-06-15 00:26,SZX,7175,737-800,28,4,20,4,4,28,,,,,-8,0
2019-06-15 00:26,HGH,5417,737-800,23,4,26,4,4,32,,,,,3,9
2019-06-15 00:18,CGO,7988,737-800,30,4,32,4,4,30,,,,,2,0
2019-06-15 00:17,TYN,1375,737-800,26,4,24,4,4,25,,,,,-2,-1
2019-06-15 00:14,XIY,7886,737-800,27,4,30,4,4,30,,,,,3,3
2019-06-15 00:13,MIG,6809,737-800,25,5,30,6,6,31,,,,,5,6
2019-06-15 00:12,MIG,6809,737-800,25,5,30,6,6,31,,,,,5,6
2019-06-15 00:10,CKG,7616,737-800,27,4,28,5,5,28,,,,,1,1
2019-06-15 00:05,HAK,5136,737-800,28,5,34,4,4,37,,,,,6,9
2019-06-15 00:03,PEK,1491,737-800,25,5,32,5,5,32,,,,,7,7
2019-06-15 00:03,URC,1325,737-800,27,2,26,4,6,24,,,,,-1,-3
2019-06-14 23:57,CGO,7618,737-800,30,6,28,6,5,26,,,,,-2,-4
2019-06-14 23:50,216,5540,737-800,25,5,34,5,5,30,,,,,9,5
2019-06-14 23:49,HAK,5082,737-800,28,4,35,4,4,30,,,,,7,2
2019-06-14 23:49,XIY,1997,737-800,27,5,30,5,6,27,,,,,3,0
2019-06-14 23:45,7399,21,737-800,6,28,4,4,4,25,,,,,-2,19
2019-06-14 23:41,HAK,5136,737-800,28,34,5,4,4,37,,,,,-23,9
2019-06-14 23:38,HAK,1786,737-800,27,4,35,4,4,31,,,,,8,4
2019-06-14 23:31,CGO,1570,737-800,28,4,26,4,4,26,,,,,-2,-2
2019-06-14 23:30,XIY,1785,737-800,29,2,26,4,4,28,,,,,-3,-1
2019-06-14 23:29,ZGC,5375,737-800,15,7,24,5,5,21,,,,,9,6
2019-06-14 23:24,SYX,1490,737-800,28,3,32,4,4,34,,,,,4,6
2019-06-14 23:24,XNN,5116,737-800,22,4,20,6,5,21,,,,,-2,-1
2019-06-14 23:22,CAN,5579,737-800,25,4,34,4,4,32,,,,,9,7
2019-06-14 23:13,HAK,1488,737-800,27,6,35,6,6,30,,,,,8,3
2019-06-14 23:13,PEK,1213,737-800,28,6,34,6,6,32,,,,,6,4
2019-06-14 23:07,SYX,5153,737-800,30,5,36,3,3,32,,,,,6,2
2019-06-14 23:07,XIY,5521,737-800,30,4,28,0,2,25,,,,,-2,-5
2019-06-14 23:04,TYN,5852,737-800,26,6,24,4,4,22,,,,,-2,-4
2019-06-14 22:58,CAN,6062,737-800,30,3,34,4,3,35,,,,,4,5
2019-06-14 22:54,XNN,7171,737-800,17,4,21,5,4,24,,,,,4,7
2019-06-14 22:52,TYN,5687,737-800,27,5,28,5,5,28,,,,,1,1
2019-06-14 22:41,HHA,1783,737-800,29,4,21,5,6,34,,,,,-8,5
2019-06-14 22:21,URC,6995,737-800,27,3,28,4,4,24,,,,,1,-3
2019-06-14 22:20,HAK,1496,737-800,27,5,36,6,6,36,,,,,9,9
2019-06-14 22:19,HAK,5346,737-800,28,8,37,6,5,32,,,,,9,4
2019-06-14 22:05,HHA,5359,737-800,28,5,32,5,5,32,,,,,4,4
2019-06-14 21:56,Î÷Äþ,1548,737-800,20,4,23,5,5,21,,,,,3,1
2019-06-14 21:45,CGO,1586,737-800,31,4,32,4,4,30,,,,,1,-1
2019-06-14 21:45,CAN,5137,737-800,30,4,34,3,3,32,,,,,4,2
2019-06-14 21:30,HRB,1559,737-800,16,3,30,3,3,26,,,,,14,10
2019-06-14 21:28,ÃàÑô,7993,737-800,24,6,31,6,6,28,,,,,7,4
2019-06-14 20:49,FOC,5503,737-800,26,3,28,4,3,26,,,,,2,0
2019-06-14 20:05,HAK,5090,737-800,28,5,36,6,6,37,,,,,8,9
2019-06-14 19:04,SZX,5462,737-800,30,2,30,4,4,35,,,,,0,5
2019-06-14 17:51,HGH,1346,737-800,28,6,34,5,5,31,,,,,6,3
2019-06-14 17:50,ÐìÖÝ,7992,737-800,34,5,33,7,7,33,,,,,-1,-1
2019-06-14 15:56,CGO,7167,737-800,34,6,31,6,6,30,,,,,-3,-4
2019-06-14 15:00,URC,5372,737-800,30,8,30,6,6,24,,,,,0,-6
2019-06-14 14:29,URC,5372,737-800,30,8,30,6,6,24,,,,,0,-6
2019-06-14 13:37,YIH,7395,737-800,31,9,29,8,8,30,,,,,-2,-1
2019-06-14 09:26,XIY,1482,737-800,25,6,22,6,6,24,,,,,-3,-1
2019-06-14 08:30,KMG,7992,737-800,20,8,30,7,7,31,,,,,10,11
2019-06-14 08:27,HAK,206G,737-800,28,4,36,4,4,36,,,,,8,8
2019-06-14 08:03,KMG ,5409,737-800,20,4,24,4,4,22,,,,,4,2
2019-06-14 07:43,PEK,5538,737-800,24,3,36,3,2,34,,,,,12,10
2019-06-14 07:39,URC,5853,737-800,20,4,24,3,4,24,,,,,4,4
2019-06-14 07:33,KMG,5449,737-800,21,6,26,6,5,24,,,,,5,3
2019-06-14 07:26,HAK,5082,737-800,30,8,36,7,7,36,,,,,6,6
2019-06-14 07:17,FOC,1350,737-800,24,4,34,3,4,30,,,,,10,6
2019-06-14 07:16,PEK,1501,737-800,26,4,29,4,4,29,,,,,3,3
2019-06-14 07:15,SYX,5439,737-800,30,9,37,7,7,37,,,,,7,7
2019-06-14 06:31,CAN,6062,737-800,28,3,34,3,3,35,,,,,6,7
2019-06-14 06:28,XIY,1480,737-800,25,4,26,4,5,26,,,,,1,1
2019-06-14 06:06,PEK,5538,737-800,24,3,36,3,2,34,,,,,12,10
2019-06-14 05:58,URC,6995,737-800,20,3,26,7,6,24,,,,,6,4
2019-06-14 05:57,HAK,5636,737-800,30,8,37,8,8,36,,,,,7,6
2019-06-14 05:54,TYN,5083,737-800,25,4,24,4,4,28,,,,,-1,3
2019-06-14 05:52,XIY,5115,737-800,30,3,24,6,4,30,,,,,-6,0
2019-06-14 05:45,SZX,7398,737-800,28,6,37,6,6,36,,,,,9,8
2019-06-14 05:30,FOC,1562,737-800,24,0,0,4,4,32,,,,,-24,8
2019-06-14 05:29,SZX,7378,737-800,26,3,32,6,6,32,,,,,6,6
2019-06-14 05:28,FOC,1562,737-800,24,5,30,5,4,34,,,,,6,10
2019-06-14 05:12,DLC,1215,737-800,21,4,30,2,3,30,,,,,9,9
2019-06-14 05:11,URC,1569,737-800,20,2,28,2,2,24,,,,,8,4
2019-06-14 05:08,HAK,5135,737-800,29,8,36,6,6,35,,,,,7,6
2019-06-14 05:07,CAN,6063,737-800,26,6,32,6,6,30,,,,,6,4
2019-06-14 05:06,URC,6995,737-800,18,3,26,7,6,24,,,,,8,6
2019-06-14 05:02,CAN,1490,737-800,26,4,32,4,4,31,,,,,6,5
2019-06-14 04:56,URC,5405,737-800,20,4,27,3,4,24,,,,,7,4
2019-06-14 04:50,HAK,5480,737-800,30,8,36,7,6,24,,,,,6,-6
2019-06-14 04:49,PEK,5482,737-800,27,2,30,4,3,30,,,,,3,3
2019-06-14 04:47,SZX,5373,737-800,28,6,30,8,8,34,,,,,2,6
2019-06-14 04:43,HAK,5502,737-800,30,8,36,9,8,37,,,,,6,7
2019-06-14 04:42,HAK,5687,737-800,30,9,37,6,5,36,,,,,7,6
2019-06-14 04:39,KMG,7991,737-800,20,8,32,6,6,30,,,,,12,10
2019-06-14 04:39,DLC,1386,737-800,21,4,28,2,3,26,,,,,7,5
2019-06-14 04:38,KMG,6015,737-800,21,4,30,4,4,25,,,,,9,4
2019-06-14 04:35,SZX,1992,737-800,28,4,35,6,4,36,,,,,7,8
2019-06-14 04:33,ZGC,5661,737-800,20,4,22,6,7,20,,,,,2,0
2019-06-14 04:25,HAK,5338,737-800,29,4,34,4,5,34,,,,,5,5
2019-06-14 04:23,PEK,5539,737-800,15,7,37,7,7,28,1,,,1,22,13
2019-06-14 04:23,HGH,5406,737-800,21,3,29,5,3,23,,,,,8,2
2019-06-14 04:21,DLC,1503,737-800,21,4,30,3,2,28,,,,,9,7
2019-06-14 04:21,DLC,1503,737-800,21,4,30,3,2,28,,,,,9,7
2019-06-14 04:20,º£¿Ú,5478,737-800,29,7,37,4,4,34,,,,,8,5
2019-06-14 04:17,HAK,5136,737-800,27,4,34,4,4,36,,,,,7,9
2019-06-14 04:16,DLC,1375,737-800,22,4,30,4,4,27,,,,,8,5
2019-06-14 04:14,DLC,1795,737-800,22,4,31,4,6,30,,,,,9,8
2019-06-14 04:12,PEK,5138,737-800,25,4,32,5,6,28,,,,,7,3
2019-06-14 04:11,PEK,1130,737-800,24,2,30,2,3,28,,,,,6,4
2019-06-14 04:06,URC,206P,737-800,20,4,25,5,5,25,,,,,5,5
2019-06-14 04:05,CTU,1209,737-800,30,4,35,4,4,36,,,,,5,6
2019-06-14 04:03,CAN,5520,737-800,26,5,33,5,5,31,,,,,7,5
2019-06-14 04:02,FOC,7113,737-800,23,7,31,6,5,32,,,,,8,9
2019-06-14 04:00,URC,5611,737-800,20,5,28,6,6,26,,,,,8,6
2019-06-14 03:54,CGO,5732,737-800,26,3,29,4,3,28,,,,,3,2
2019-06-14 03:48,DLC,5855,737-800,21,4,26,4,3,22,,,,,5,1
2019-06-14 03:48,KMG,7990,737-800,20,4,24,3,3,30,,,,,4,10
2019-06-14 03:45,DLC,1549,737-800,21,5,30,6,4,28,,,,,9,7
2019-06-14 03:42,XIY,7172,737-800,25,4,26,3,4,32,,,,,1,7
2019-06-14 03:42,DLC,1928,737-800,21,4,24,4,4,24,,,,,3,3
2019-06-14 03:41,HAK,1797,737-800,29,5,32,5,5,30,,,,,3,1
2019-06-14 03:40,XIY,1902,737-800,25,4,28,4,4,26,,,,,3,1
2019-06-14 03:37,HAK,5521,737-800,30,6,34,8,8,36,,,,,4,6
2019-06-14 03:32,MIG,7993,737-800,30,5,35,6,6,30,,,,,5,0
2019-06-14 03:32,URC,1493,737-800,22,5,25,6,6,23,,,,,3,1
2019-06-14 03:26,CAN,5463,737-800,25,5,28,5,5,28,,,,,3,3
2019-06-14 03:24,KMG,6016,737-800,20,4,35,4,4,34,1,,,1,15,14
2019-06-14 03:13,HHA,1347,737-800,25,4,32,4,3,30,,,,,7,5
2019-06-14 03:13,ZGC,5416,737-800,20,6,26,6,6,26,,,,,6,6
2019-06-14 03:11,XIY,1903,737-800,27,2,26,3,3,30,,,,,-1,3
2019-06-14 03:02,SYX ,7379,737-800,31,5,28,6,4,30,,,,,-3,-1
2019-06-14 03:02,KMG,1587,737-800,19,4,24,4,3,29,,,,,5,10
2019-06-14 03:01,HGH,1786,737-800,20,3,26,3,3,26,,,,,6,6
2019-06-14 02:58,PEK,1796,737-800,25,4,28,5,6,30,,,,,3,5
2019-06-14 02:57,PEK,1102,737-800,26,4,30,4,6,32,,,,,4,6
2019-06-14 02:57,HGH,1542,737-800,25,4,28,4,4,26,,,,,3,1
2019-06-14 02:54,HAK,7639,737-800,30,6,36,7,6,36,,,,,6,6
2019-06-14 02:54,SYX,7619,737-800,29,6,32,6,5,33,,,,,3,4
2019-06-14 02:49,SZX,5625,737-800,26,5,36,5,5,35,,,,,10,9
2019-06-14 02:42,PEK,1213,737-800,24,7,35,6,6,36,1,1,,11,11,12
2019-06-14 02:41,HHA,1373,737-800,25,4,30,4,4,28,,,,,5,3
2019-06-14 02:40,SZX,1492,737-800,27,4,33,4,4,32,,,,,6,5
2019-06-14 02:39,XIY,5180,737-800,24,5,26,5,6,24,,,,,2,0
2019-06-14 02:36,HGH,5417,737-800,18,4,24,4,4,30,,,,,6,12
2019-06-14 02:31,HAK,5346,737-800,29,7,35,7,7,36,,,,,6,7
2019-06-14 02:31,CKG,5733,737-800,25,4,31,4,4,31,,,,,6,6
2019-06-14 02:29,URC,5798,737-800,20,2,24,2,2,24,,,,,4,4
2019-06-14 02:23,XIY,1929,737-800,25,0,22,0,0,20,,,,,-3,-5
2019-06-14 02:23,HGH,5139,737-800,20,4,25,6,4,28,,,,,5,8
2019-06-14 02:22,HAK,1547,737-800,30,7,37,7,6,37,,,,,7,7
2019-06-14 02:21,PEK,1491,737-800,27,5,29,6,5,29,,,,,2,2
2019-06-14 02:20,CAN,1131,737-800,27,5,36,5,4,32,,,,,9,5
2019-06-14 02:16,URC,7198,737-800,20,4,26,6,4,28,,,,,6,8
2019-06-14 02:16,URC,1725,737-800,20,6,28,5,6,27,,,,,8,7
2019-06-14 02:13,HHA,1497,737-800,25,4,32,4,4,33,,,,,7,8
2019-06-14 02:12,HHA,1347,737-800,25,32,4,4,3,30,,,,,-21,5
2019-06-14 02:05,URC,1323,737-800,18,3,30,4,4,26,,,,,12,8
2019-06-14 02:04,SYX,5153,737-800,30,5,33,4,4,33,,,,,3,3
2019-06-14 02:03,URC,5797,737-800,20,5,21,5,4,24,,,,,1,4
2019-06-14 02:00,DLC,7399,737-800,22,4,26,4,4,24,,,,,4,2
2019-06-14 01:59,HAK,1141,737-800,30,6,34,6,5,33,,,,,4,3
2019-06-14 01:58,ZGC,5416,737-800,20,6,26,26,6,6,,,,,6,-14
2019-06-14 01:58,ZGC,5416,737-800,20,6,26,26,6,6,,,,,6,-14
2019-06-14 01:54,HHA,6103,737-800,26,5,30,4,5,32,,,,,4,6
2019-06-14 01:51,FOC,1905,737-800,24,4,30,3,3,26,,,,,6,2
2019-06-14 01:51,XMN,1498,737-800,24,8,30,6,8,30,,,,,6,6
2019-06-14 01:51,XMN,5662,737-800,20,3,29,2,7,30,,,,,9,10
2019-06-14 01:50,KMG,1208,737-800,20,4,30,3,3,28,,,,,10,8
2019-06-14 01:50,XMN,7173,737-800,25,6,30,8,6,30,,,,,5,5
2019-06-14 01:49,XMN,5581,737-800,20,8,30,9,8,32,,,,,10,12
2019-06-14 01:47,CAN,1502,737-800,34,3,31,4,4,34,,,,,-3,0
2019-06-14 01:47,SZX,7175,737-800,28,4,24,6,5,32,,,,,-4,4
2019-06-14 01:46,CAN,1490,737-800,25,5,34,5,5,32,,,,,9,7
2019-06-14 01:43,URC,1996,737-800,15,5,22,4,5,28,,,,,7,13
2019-06-14 01:43,CGO,1586,737-800,26,4,30,4,4,30,,,,,4,4
2019-06-14 01:43,CGO,7988,737-800,27,4,29,5,5,29,,,,,2,2
2019-06-14 01:43,PEK,5408,737-800,25,4,32,4,3,28,,,,,7,3
2019-06-14 01:39,TYN ,1505,737-800,23,4,20,4,4,26,,,,,-3,3
2019-06-14 01:39,MIG,1798,737-800,27,4,37,5,6,30,1,,,1,10,3
2019-06-14 01:39,SYX,5358,737-800,30,6,34,6,6,34,,,,,4,4
2019-06-14 01:34,HAK,1496,737-800,29,6,36,6,6,37,,,,,7,8
2019-06-14 01:31,HAK,1538,737-800,30,6,34,4,4,35,,,,,4,5
2019-06-14 01:29,URC,205V,737-800,20,2,30,4,2,28,,,,,10,8
2019-06-14 01:25,HAK,1101,737-800,27,4,36,2,2,36,,,,,9,9
2019-06-14 01:21,HRB,1559,737-800,19,3,27,2,3,26,,,,,8,7
2019-06-14 01:20,TYN,5083,737-800,25,4,22,4,4,28,,,,,-3,3
2019-06-14 01:18,HAK,5371,737-800,30,8,31,8,8,35,,,,,1,5
2019-06-14 01:18,YIH,1435,737-800,23,4,32,5,5,26,,,,,9,3
2019-06-14 01:13,XIY,1162,737-800,22,3,32,3,3,30,,,,,10,8
2019-06-14 01:12,HAK,7400,737-800,29,7,35,5,6,35,,,,,6,6
2019-06-14 01:06,URC,5623,737-800,21,5,29,5,6,25,,,,,8,4
2019-06-14 01:04,XIY,1906,737-800,27,6,28,6,6,28,,,,,1,1
2019-06-14 01:03,XIY,5638,737-800,25,4,29,3,4,31,,,,,4,6
2019-06-14 01:01,DLC,1541,737-800,20,6,28,6,5,30,,,,,8,10
2019-06-14 01:01,YIH,7395,737-800,23,6,32,6,6,30,,,,,9,7
2019-06-14 00:59,URC,1995,737-800,20,6,28,6,7,28,,,,,8,8
2019-06-14 00:59,HGH,1346,737-800,25,6,31,4,4,26,,,,,6,1
2019-06-14 00:56,XIY,1785,737-800,25,2,28,6,6,30,,,,,3,5
2019-06-14 00:55,HRB,1351,737-800,19,5,32,4,5,31,1,,,1,13,12
2019-06-14 00:51,HHA,5359,737-800,24,4,26,4,4,30,,,,,2,6
2019-06-14 00:44,ZGC,5375,737-800,25,5,22,5,6,21,,,,,-3,-4
2019-06-14 00:44,PEK,1729,737-800,26,4,30,4,4,28,,,,,4,2
2019-06-14 00:43,HHA,1783,737-800,27,6,32,6,5,32,,,,,5,5
2019-06-14 00:43,URC,2159,737-800,20,2,20,2,2,22,,,,,0,2
2019-06-14 00:42,HRB,1559,737-800,19,3,30,30,2,3,,,,,11,-16
2019-06-14 00:42,HHA,5522,737-800,27,7,33,6,6,33,,,,,6,6
2019-06-14 00:41,HRB,7105,737-800,20,3,29,3,4,26,,,,,9,6
2019-06-14 00:38,XIY,7886,737-800,28,4,30,4,3,30,,,,,2,2
2019-06-14 00:36,SZX,5428,737-800,27,4,30,6,4,36,,,,,3,9
2019-06-14 00:30,HGH,5540,737-800,25,5,32,5,5,28,,,,,7,3
2019-06-14 00:27,SYX,5429,737-800,32,5,34,8,8,36,,,,,2,4
2019-06-14 00:19,PEK,6066,737-800,27,6,30,6,6,28,,,,,3,1
2019-06-14 00:18,CKG,7616,737-800,26,6,30,4,7,30,,,,,4,4
2019-06-14 00:16,XIY,7886,737-800,29,4,30,4,3,30,,,,,1,1
2019-06-14 00:15,HGH,5709,737-800,20,5,30,7,6,32,,,,,10,12
2019-06-14 00:12,XIY,1489,737-800,27,4,32,4,4,21,,,,,5,-6
2019-06-14 00:12,MIG,7989,737-800,30,8,36,8,6,36,,,,,6,6
2019-06-14 00:12,SYX,5483,737-800,31,6,36,6,4,35,,,,,5,4
2019-06-14 00:03,XIY,5481,737-800,26,5,28,6,5,28,,,,,2,2
2019-06-14 00:03,HRB,1433,737-800,22,4,30,4,4,29,,,,,8,7
2019-06-14 00:01,CAN,206G,737-800,26,3,34,3,3,33,,,,,8,7
2019-06-13 23:57,DLC,1549,737-800,21,5,30,6,4,28,,,,,9,7
2019-06-13 23:55,XIY,5467,737-800,25,0,26,3,1,21,,,,,1,-4
2019-06-13 23:54,XIY,1488,737-800,26,5,26,5,4,18,,,,,0,-8
2019-06-13 23:51,TYN,6808,737-800,25,4,22,4,4,23,,,,,-3,-2
2019-06-13 23:48,URC,1568,737-800,20,6,28,6,6,23,,,,,8,3
2019-06-13 23:42,HAK,1927,737-800,29,7,34,8,4,32,,,,,5,3
2019-06-13 23:38,URC,205U,737-800,27,2,28,2,2,26,,,,,1,-1
2019-06-13 23:35,PEK,5637,737-800,29,2,32,3,2,30,,,,,3,1
2019-06-13 23:33,TYN,1103,737-800,25,4,26,3,3,25,,,,,1,0
2019-06-13 23:33,TYN,1733,737-800,25,3,27,3,3,24,,,,,2,-1
2019-06-13 23:32,CAN,1372,737-800,30,5,36,5,5,36,,,,,6,6
2019-06-13 23:27,CGO,1570,737-800,28,6,28,6,6,28,,,,,0,0
2019-06-13 23:22,CGO,7618,737-800,30,5,30,5,5,30,,,,,0,0
2019-06-13 23:15,SYX,5466,737-800,31,6,30,8,8,30,,,,,-1,-1
2019-06-13 23:08,XNN,5116,737-800,23,3,20,4,4,21,,,,,-3,-2
2019-06-13 23:07,URC,1325,737-800,20,4,22,3,3,22,,,,,2,2
2019-06-13 22:59,CKG,7377,737-800,25,6,34,6,5,32,,,,,9,7
2019-06-13 22:57,TYN,1799,737-800,20,5,30,4,5,30,,,,,10,10
2019-06-13 22:56,Î÷Äþ,7171,737-800,25,2,25,5,5,24,,,,,0,-1
2019-06-13 22:55,CAN,5579,737-800,29,5,34,5,5,32,,,,,5,3
2019-06-13 22:45,URC,1728,737-800,20,5,24,5,5,24,,,,,4,4
2019-06-13 22:40,XIY,5580,737-800,30,4,32,2,4,34,,,,,2,4
2019-06-13 22:37,HGH,1545,737-800,23,5,30,4,4,30,,,,,7,7
2019-06-13 22:33,HAK,5090,737-800,30,7,36,7,7,36,,,,,6,6
2019-06-13 22:33,HAK,1735,737-800,30,6,34,6,5,32,,,,,4,2
2019-06-13 22:32,HAK,206F,737-800,30,3,35,3,3,32,,,,,5,2
2019-06-13 22:28,XIY,1997,737-800,30,6,30,4,4,26,,,,,0,-4
2019-06-13 22:28,HAK,5137,737-800,30,8,30,6,6,36,,,,,0,6
2019-06-13 22:07,Î÷Äþ,5462,737-800,25,6,22,5,6,26,,,,,-3,1
2019-06-13 21:41,URC,205T,737-800,20,3,25,2,3,25,,,,,5,5
2019-06-13 20:36,ÐìÖÝ,6800,737-800,25,6,30,3,4,28,,,,,5,3
2019-06-13 19:12,URC,205U,737-800,27,4,28,2,2,28,,,,,1,1
2019-06-13 18:57,XIY,5141,737-800,34,6,30,6,6,30,,,,,-4,-4
2019-06-13 18:55,CGO,5479,737-800,33,8,33,5,5,32,,,,,0,-1
2019-06-13 18:39,XIY,1163,737-800,39,3,34,2,2,32,,,,,-5,-7
2019-06-13 18:20,XIY,1161,737-800,38,5,35,4,5,30,,,,,-3,-8
2019-06-13 17:57,CAN,5687,737-800,31,8,36,5,5,35,,,,,5,4
2019-06-13 17:27,PEK,7639,737-800,30,6,32,7,7,30,,,,,2,0
2019-06-13 16:52,HAK,5503,737-800,37,6,33,6,6,34,,,,,-4,-3
2019-06-13 14:51,YIH,1348,737-800,33,4,33,4,4,27,,,,,0,-6
2019-06-13 13:51,HGH,5406,737-800,23,4,29,4,5,21,,,,,6,-2
2019-06-13 11:21,HAK,5439,737-800,32,8,37,8,8,37,,,,,5,5
2019-06-13 11:09,CTU,7992,737-800,30,7,34,8,7,34,,,,,4,4
2019-06-13 09:29,CAN,5463,737-800,26,5,32,4,6,33,,,,,6,7
2019-06-13 09:20,SZX,5636,737-800,27,6,35,8,7,34,,,,,8,7
2019-06-13 09:08,CAN,1372,737-800,27,7,36,5,6,36,,,,,9,9
2019-06-13 08:56,XMN,5735,737-800,23,4,28,4,4,34,,,,,5,11
2019-06-13 08:55,XMN,5661,737-800,23,4,18,4,4,32,,,,,-5,9
2019-06-13 08:55,XMN,1729,737-800,24,6,32,3,6,29,,,,,8,5
2019-06-13 08:54,XMN,1783,737-800,23,4,30,4,4,32,,,,,7,9
2019-06-13 08:34,CAN,1490,737-800,25,5,35,6,6,35,1,1,,11,10,10
2019-06-13 08:06,SYX ,5358   ,737-800,30,6,30,6,6,30,,,,,0,0
2019-06-13 08:04,PEK,1491,737-800,25,5,29,4,5,30,,,,,4,5
2019-06-13 08:01,YIH,1348,737-800,23,4,25,4,4,28,,,,,2,5
2019-06-13 07:57,PEK,1542,737-800,25,4,32,3,4,30,,,,,7,5
2019-06-13 07:35,CAN,6063,737-800,26,4,32,5,4,34,,,,,6,8
2019-06-13 07:26,CAN,5136,737-800,27,5,33,5,4,35,,,,,6,8
2019-06-13 07:25,HAK,1545,737-800,29,6,34,5,6,35,,,,,5,6
2019-06-13 07:22,ZGC,1498,737-800,10,5,26,5,5,24,,,,,16,14
2019-06-13 07:21,ZGC,5465,737-800,17,5,26,4,5,22,,,,,9,5
2019-06-13 07:16,Ö£ÖÝ,1586,737-800,28,4,33,4,3,33,,,,,5,5
2019-06-13 07:13,Ö£ÖÝ,5686,737-800,26,4,28,4,5,27,,,,,2,1
2019-06-13 07:11,SYX,5358,737-800,25,6,30,6,6,30,,,,,5,5
2019-06-13 07:07,PEK,5853,737-800,27,6,26,6,6,26,,,,,-1,-1
2019-06-13 06:37,KMG,6800,737-800,20,4,25,4,4,24,,,,,5,4
2019-06-13 06:21,HAK,1547,737-800,28,9,34,8,9,33,,,,,6,5
2019-06-13 06:20,URC,1568,737-800,16,6,28,6,6,22,,,,,12,6
2019-06-13 06:19,HGH,5709,737-800,23,6,32,6,8,32,,,,,9,9
2019-06-13 06:19,HAK,1496,737-800,28,6,34,7,6,34,,,,,6,6
2019-06-13 06:18,URC,5637,737-800,16,2,26,2,2,22,,,,,10,6
2019-06-13 06:09,HAK,206H,737-800,29,5,31,3,2,33,,,,,2,4
2019-06-13 06:07,CGO,1587,737-800,30,4,33,3,3,28,,,,,3,-2
2019-06-13 05:52,PEK,5580,737-800,26,4,32,8,8,33,,,,,6,7
2019-06-13 05:45,URC,5637,737-800,16,2,26,2,2,22,,,,,10,6
2019-06-13 05:42,HGH,5375,737-800,22,5,28,6,6,27,,,,,6,5
2019-06-13 05:36,KMG,6015,737-800,20,3,28,3,4,24,,,,,8,4
2019-06-13 05:36,HGH,6065,737-800,25,5,32,5,4,30,,,,,7,5
2019-06-13 05:31,HGH,1928,737-800,24,4,22,5,6,22,,,,,-2,-2
2019-06-13 05:30,XIY,5116,737-800,20,4,24,4,4,24,,,,,4,4
2019-06-13 05:20,PEK,5538,737-800,23,7,30,4,4,32,,,,,7,9
2019-06-13 05:05,FOC,1350,737-800,22,3,33,3,3,31,,,,,11,9
2019-06-13 05:04,KMG,5732,737-800,20,2,26,4,4,27,,,,,6,7
2019-06-13 05:04,FOC,1350,737-800,22,5,36,4,5,34,,,,,14,12
2019-06-13 05:03,XIY ,1497,737-800,25,6,26,6,6,26,,,,,1,1
2019-06-13 05:00,URC,7198,737-800,16,4,26,4,4,26,,,,,10,10
2019-06-13 04:59,URC,1325,737-800,15,4,24,4,4,20,,,,,9,5
2019-06-13 04:55,PEK,5539,737-800,26,5,29,6,6,30,,,,,3,4
2019-06-13 04:50,KMG,1209,737-800,20,3,32,4,4,33,,,,,12,13
2019-06-13 04:49,KMG,7988,737-800,19,4,27,4,4,20,,,,,8,1
2019-06-13 04:44,MIG,7989,737-800,30,6,36,6,6,34,,,,,6,4
2019-06-13 04:40,SZX,5373,737-800,27,6,30,9,9,30,,,,,3,3
2019-06-13 04:33,URC,6268,737-800,16,4,28,5,5,27,,,,,12,11
2019-06-13 04:30,XIY,5115,737-800,21,4,20,8,8,22,,,,,-1,1
2019-06-13 04:28,SZX,7398,737-800,27,9,36,8,7,36,,,,,9,9
2019-06-13 04:26,CAN,5687,737-800,27,7,36,5,4,34,,,,,9,7
2019-06-13 04:13,HAK,5338,737-800,29,4,32,5,4,32,,,,,3,3
2019-06-13 04:11,HAK,7378,737-800,29,6,34,5,4,33,,,,,5,4
2019-06-13 04:09,PEK,5372,737-800,26,6,27,6,6,29,,,,,1,3
2019-06-13 04:05,FOC,5503,737-800,20,3,28,3,3,25,,,,,8,5
2019-06-13 04:01,SYX,7619,737-800,30,6,31,6,5,34,,,,,1,4
2019-06-13 04:00,CAN,5520,737-800,24,5,35,5,6,36,1,1,,11,11,12
2019-06-13 03:59,HAK,5139,737-800,26,8,32,7,8,35,,,,,6,9
2019-06-13 03:58,HHA,7173,737-800,22,4,32,6,4,32,,,,,10,10
2019-06-13 03:58,DLC,1549,737-800,21,5,28,4,5,29,,,,,7,8
2019-06-13 03:47,KMG,7988,737-800,19,4,29,4,4,29,,,,,10,10
2019-06-13 03:41,HHA,1495,737-800,25,5,34,4,4,32,,,,,9,7
2019-06-13 03:40,URC,205U,737-800,20,4,24,4,4,26,,,,,4,6
2019-06-13 03:35,SYX,7377,737-800,30,7,36,7,6,35,,,,,6,5
2019-06-13 03:26,HAK,5137,737-800,29,5,34,5,5,35,,,,,5,6
2019-06-13 03:21,SYX,1346,737-800,30,6,36,6,0,30,,,,,6,0
2019-06-13 03:20,URC,206P,737-800,16,4,26,4,4,23,,,,,10,7
2019-06-13 03:19,HAK,1131,737-800,29,3,36,6,5,35,,,,,7,6
2019-06-13 03:18,XIY,5180,737-800,26,5,32,5,6,28,,,,,6,2
2019-06-13 03:17,SZX,5625,737-800,27,5,34,5,4,33,,,,,7,6
2019-06-13 03:13,HAK,7993,737-800,29,5,34,5,5,32,,,,,5,3
2019-06-13 03:09,PEK,5482,737-800,27,3,32,6,5,34,,,,,5,7
2019-06-13 03:09,HHA,6103,737-800,21,6,31,7,7,34,,,,,10,13
2019-06-13 03:06,XIY,1929,737-800,20,4,24,4,3,22,,,,,4,2
2019-06-13 03:02,HGH,5480,737-800,25,4,26,3,4,28,,,,,1,3
2019-06-13 02:56,SZX,1492,737-800,273,4,34,3,3,32,,,,,-239,-241
2019-06-13 02:54,FOC,1435,737-800,23,6,32,6,6,26,,,,,9,3
2019-06-13 02:51,URC,5623,737-800,15,6,30,6,6,23,,,,,15,8
2019-06-13 02:50,URC,2159,737-800,16,2,22,3,3,21,,,,,6,5
2019-06-13 02:48,SZX,5478,737-800,25,6,34,4,6,32,,,,,9,7
2019-06-13 02:40,XIY,1903,737-800,20,4,30,4,4,32,,,,,10,12
2019-06-13 02:39,PEK ,1501,737-800,26,3,30,3,4,28,,,,,4,2
2019-06-13 02:38,111,1213,737-800,26,6,30,4,6,31,,,,,4,5
2019-06-13 02:35,CAN,5520,737-800,27,5,35,6,5,36,,,,,8,9
2019-06-13 02:34,DLC,1489,737-800,25,4,27,3,4,28,,,,,2,3
2019-06-13 02:29,URC,1996,737-800,18,3,21,2,2,25,,,,,3,7
2019-06-13 02:27,XIY,1488,737-800,22,7,30,6,6,26,,,,,8,4
2019-06-13 02:25,CAN,1502,737-800,26,4,32,4,5,34,,,,,6,8
2019-06-13 02:25,SYX,5466,737-800,29,0,20,3,1,25,,,,,-9,-4
2019-06-13 02:22,URC,1503,737-800,20,4,26,3,3,26,,,,,6,6
2019-06-13 02:21,HAK,5502,737-800,29,8,36,7,7,35,,,,,7,6
2019-06-13 02:20,CGO,1130,737-800,29,3,30,2,2,30,,,,,1,1
2019-06-13 02:17,HAK,1141,737-800,29,7,34,7,7,32,,,,,5,3
2019-06-13 02:14,DLC,1386,737-800,21,2,28,2,2,28,,,,,7,7
2019-06-13 02:13,FOC,1562,737-800,24,4,32,4,4,34,,,,,8,10
2019-06-13 02:11,CKG,7618,737-800,23,6,26,7,6,28,,,,,3,5
2019-06-13 02:11,MIG,6809,737-800,25,6,30,6,6,30,,,,,5,5
2019-06-13 02:11,FOC,1796,737-800,22,4,32,4,4,30,,,,,10,8
2019-06-13 02:06,HHA,5359,737-800,21,2,23,4,3,24,,,,,2,3
2019-06-13 02:06,CAN,5687,737-800,27,7,36,5,4,34,,,,,9,7
2019-06-13 02:06,URC,5611,737-800,15,5,26,6,5,25,,,,,11,10
2019-06-13 02:05,HHA,5337,737-800,20,4,32,5,5,32,,,,,12,12
2019-06-13 02:04,URC,6995,737-800,16,4,26,6,5,24,,,,,10,8
2019-06-13 02:01,CGO,7990,737-800,26,4,28,3,3,28,,,,,2,2
2019-06-13 01:58,HGH,5405,737-800,23,4,30,4,4,28,,,,,7,5
2019-06-13 01:49,HAK,5852,737-800,29,6,31,5,7,32,,,,,2,3
2019-06-13 01:48,HAK,5579,737-800,29,5,33,5,4,32,,,,,4,3
2019-06-13 01:39,PEK,5581,737-800,30,4,22,5,4,30,,,,,-8,0
2019-06-13 01:39,XIY,1483,737-800,21,4,26,6,5,26,,,,,5,5
2019-06-13 01:36,PEK,1215,737-800,28,3,33,4,4,34,,,,,5,6
2019-06-13 01:33,KMG,5409,737-800,19,4,24,4,4,28,,,,,5,9
2019-06-13 01:29,DLC,1375,737-800,18,4,26,3,3,27,,,,,8,9
2019-06-13 01:23,SYX,5483,737-800,30,5,36,5,5,34,,,,,6,4
2019-06-13 01:21,XIY,1161,737-800,20,4,31,4,3,30,,,,,11,10
2019-06-13 01:16,MIG,1798,737-800,30,6,36,6,6,28,,,,,6,-2
2019-06-13 01:14,DLC,5417,737-800,25,5,25,5,6,28,,,,,0,3
2019-06-13 01:11,KMG,7991,737-800,17,6,28,6,6,27,,,,,11,10
2019-06-13 01:08,URC,1493,737-800,20,4,26,6,6,21,,,,,6,1
2019-06-13 01:03,XIY,1480,737-800,25,4,26,4,4,28,,,,,1,3
2019-06-13 00:58,FOC,1905,737-800,23,4,3,4,5,26,,,,,-20,3
2019-06-13 00:56,HGH,1786,737-800,26,4,30,3,3,27,,,,,4,1
2019-06-13 00:51,CGO,7167,737-800,28,6,30,6,5,29,,,,,2,1
2019-06-13 00:51,HGH,5540,737-800,22,5,30,6,6,32,,,,,8,10
2019-06-13 00:49,URC,205T,737-800,15,3,26,3,2,30,,,,,11,15
2019-06-13 00:47,SZX ,1728,737-800,28,5,35,5,5,27,,,,,7,-1
2019-06-13 00:46,URC,1725,737-800,15,5,30,4,4,31,,,,,15,16
2019-06-13 00:45,TYN,1541,737-800,25,5,29,6,5,29,,,,,4,4
2019-06-13 00:44,URC,205V,737-800,16,2,31,4,2,25,,,,,15,9
2019-06-13 00:43,TYN,5083,737-800,20,2,22,2,2,20,,,,,2,0
2019-06-13 00:42,HAK,5467,737-800,29,5,33,7,5,32,,,,,4,3
2019-06-13 00:39,HAK,1102,737-800,25,4,36,5,5,36,,,,,11,11
2019-06-13 00:36, HAK,1538,737-800,29,3,35,3,3,35,,,,,6,6
2019-06-13 00:35,YIH,7113,737-800,20,6,29,4,5,30,,,,,9,10
2019-06-13 00:32,CAN,5371,737-800,25,7,32,7,7,34,,,,,7,9
2019-06-13 00:30,URC,5797,737-800,15,6,20,5,6,24,,,,,5,9
2019-06-13 00:28,URC,5798,737-800,20,2,22,2,2,20,,,,,2,0
2019-06-13 00:28,HAK,5418,737-800,29,9,34,8,8,33,,,,,5,4
2019-06-13 00:24,XIY,1785,737-800,20,5,30,6,6,29,,,,,10,9
2019-06-13 00:23,TYN,6808,737-800,25,4,26,4,4,27,,,,,1,2
2019-06-13 00:22,HAK,1927,737-800,28,5,32,7,8,28,,,,,4,0
2019-06-13 00:19,Ö£ÖÝ,5479,737-800,29,6,28,6,6,32,,,,,-1,3
2019-06-13 00:17,115,6066,737-800,29,7,32,5,6,30,,,,,3,1
2019-06-13 00:08,XIY,1997,737-800,22,5,28,2,3,25,,,,,6,3
2019-06-13 00:08,HRB,1351,737-800,25,5,31,5,5,33,,,,,6,8
2019-06-13 00:08,URC,1726,737-800,15,4,21,2,3,22,,,,,6,7
2019-06-13 00:08,HRB,1559,737-800,23,3,33,3,3,31,,,,,10,8
2019-06-13 00:07,XIY,5141,737-800,21,6,28,5,5,26,,,,,7,5
2019-06-13 00:01,CGO,1570,737-800,29,5,24,5,5,25,,,,,-5,-4
2019-06-13 00:00,´óÁ¬,1795,737-800,19,4,28,6,5,24,,,,,9,5
2019-06-13 00:00,URC,1995,737-800,14,6,26,6,5,27,,,,,12,13
2019-06-12 23:59,KMG,1208,737-800,20,3,28,4,3,26,,,,,8,6
2019-06-12 23:59,XIY,7399,737-800,20,5,26,4,4,25,,,,,6,5
2019-06-12 23:53,NKG,5481,737-800,25,8,28,7,8,27,,,,,3,2
2019-06-12 23:52,PEK,5138,737-800,26,4,30,5,4,20,,,,,4,-6
2019-06-12 23:52,PEK,5138,737-800,26,4,30,5,4,20,,,,,4,-6
2019-06-12 23:51,CAN,6062,737-800,28,4,36,4,4,34,,,,,8,6
2019-06-12 23:51,CKG,5733,737-800,23,3,30,3,3,30,,,,,7,7
2019-06-12 23:50,XIY,1797,737-800,20,2,26,4,2,28,,,,,6,8
2019-06-12 23:50,CKG,5462,737-800,23,4,30,4,4,30,,,,,7,7
2019-06-12 23:45,KMG,1208,737-800,20,3,28,4,3,26,,,,,8,6
2019-06-12 23:44,HRB,7105,737-800,24,3,30,4,3,26,,,,,6,2
2019-06-12 23:44,XIY,7886,737-800,25,3,32,3,3,30,,,,,7,5
2019-06-12 23:38,DLC,1799,737-800,22,4,28,4,4,28,,,,,6,6
2019-06-12 23:34,PEK,1501,737-800,28,3,34,4,4,30,,,,,6,2
2019-06-12 23:33,PEK,1501,737-800,28,3,34,4,4,30,,,,,6,2
2019-06-12 23:30,HRB,1433,737-800,23,3,30,3,3,24,,,,,7,1
2019-06-12 23:29,HAK,5408,737-800,28,8,32,8,7,34,,,,,4,6
2019-06-12 23:25,DLC,5855,737-800,25,6,28,6,6,26,,,,,3,1
2019-06-12 23:10,HAK,5428,737-800,29,4,35,4,4,36,,,,,6,7
2019-06-12 23:08,ZGC,5638,737-800,18,4,26,5,5,26,,,,,8,8
2019-06-12 23:05,TYN,1505,737-800,23,3,20,4,4,25,,,,,-3,2
2019-06-12 23:04,ZGC,5153,737-800,22,4,19,4,5,20,,,,,-3,-2
2019-06-12 23:00,DLC,7616,737-800,20,4,28,4,4,28,,,,,8,8
2019-06-12 22:52,SHE,5429,737-800,25,3,28,4,3,30,,,,,3,5
2019-06-12 22:51,URC,1323,737-800,15,3,30,2,3,24,,,,,15,9
2019-06-12 22:50,HHA,1373,737-800,22,3,29,4,4,25,,,,,7,3
2019-06-12 22:47,HAK,5712,737-800,29,5,35,3,3,32,,,,,6,3
2019-06-12 22:46,Î÷Äþ,1735,737-800,23,5,24,6,6,21,,,,,1,-2
2019-06-12 22:39,HAK,1101,737-800,30,3,36,2,3,36,,,,,6,6
2019-06-12 22:35,PEK,1548,737-800,27,3,27,3,3,26,,,,,0,-1
2019-06-12 22:30,HAK,5090,737-800,30,8,36,8,7,36,,,,,6,6
2019-06-12 22:25,SYX,7400,737-800,30,5,33,6,5,34,,,,,3,4
2019-06-12 22:22,SYX,7379,737-800,30,2,34,4,4,35,,,,,4,5
2019-06-12 22:10,HAK,5082,737-800,28,6,35,6,6,34,,,,,7,6
2019-06-12 22:06,XNN,7171,737-800,23,4,23,4,5,25,,,,,0,2
2019-06-12 21:23,TYN,1733,737-800,23,4,24,3,2,24,,,,,1,1
2019-06-12 21:23,TYN,1733,737-800,23,4,24,3,2,24,,,,,1,1
2019-06-12 20:04,PEK,5538,737-800,29,16,40,4,4,32,1,,,1,11,3
2019-06-12 19:52,FOC,5503,737-800,24,3,29,3,4,26,,,,,5,2
2019-06-12 18:30,FOC,1480,737-800,26,5,30,6,5,32,,,,,4,6
2019-06-12 18:20,FOC,1480,737-800,26,30,5,32,5,6,,,,,-21,-20
2019-06-12 17:46,HHA,1347,737-800,24,4,28,6,6,29,,,,,4,5
2019-06-12 17:16,XUZ,6016,737-800,34,6,36,4,4,36,,,,,2,2
2019-06-12 15:59,PEK,1542,737-800,40,3,33,4,4,31,,,,,-7,-9
2019-06-12 14:16,YIH,7395,737-800,25,5,31,5,4,32,,,,,6,7
2019-06-12 13:55,PEK,1491,737-800,34,5,34,4,5,33,,,,,0,-1
2019-06-12 13:05,URC,6268,737-800,20,4,28,4,5,26,,,,,8,6
2019-06-12 12:03,HAK,1131,737-800,38,4,37,6,6,37,,,,,-1,-1
2019-06-12 10:42,HAK,5182,737-800,37,7,37,7,7,36,,,,,0,-1
2019-06-12 10:01,SHA,1725,737-800,23,5,38,5,5,38,1,1,,11,15,15
2019-06-12 09:52,YIH,7395,737-800,20,5,32,5,5,31,,,,,12,11
2019-06-12 09:13,SYX,5429,737-800,32,4,34,5,6,34,,,,,2,2
2019-06-12 08:27,HHA,5439,737-800,28,7,36,7,8,36,,,,,8,8
2019-06-12 08:20,PEK,5637,737-800,27,6,33,4,5,30,,,,,6,3
2019-06-12 08:18,XMN,5465,737-800,26,4,35,4,3,35,,,,,9,9
2019-06-12 08:18,XMN,6066,737-800,26,5,28,6,4,30,,,,,2,4
2019-06-12 08:18,SZX,5373,737-800,26,6,31,7,6,32,,,,,5,6
2019-06-12 08:17,XMN,1783,737-800,26,4,26,5,4,34,,,,,0,8
2019-06-12 08:16,XMN,1729,737-800,26,6,29,4,4,30,,,,,3,4
2019-06-12 08:13,FOC,7105,737-800,25,3,30,4,3,29,,,,,5,4
2019-06-12 08:10,FOC,5503,737-800,24,4,29,4,3,26,,,,,5,2
2019-06-12 08:10,FOC,7105,737-800,25,3,34,4,5,33,,,,,9,8
2019-06-12 07:59,XIY,1162,737-800,25,3,34,3,3,30,,,,,9,5
2019-06-12 07:31,HGH,5480,737-800,24,4,28,6,6,30,,,,,4,6
2019-06-12 06:51,XIY,7172,737-800,23,4,30,5,4,28,,,,,7,5
2019-06-12 06:21,HGH,1727,737-800,23,5,32,5,4,29,,,,,9,6
2019-06-12 06:07,HAK,5428,737-800,30,6,36,7,4,37,,,,,6,7
2019-06-12 06:03,ZGC,1498,737-800,20,4,26,4,4,26,,,,,6,6
2019-06-12 06:02,HAK,5141,737-800,29,8,35,8,8,36,,,,,6,7
2019-06-12 06:02,ZGC,5638,737-800,20,2,26,2,3,22,,,,,6,2
2019-06-12 06:01,ZGC,7619,737-800,15,5,24,6,5,22,,,,,9,7
2019-06-12 05:59,ZGC,5661,737-800,15,4,20,5,4,24,,,,,5,9
2019-06-12 05:56,DLC,1786,737-800,18,3,27,4,4,23,,,,,9,5
2019-06-12 05:51,SZX,5636,737-800,26,7,30,6,5,33,,,,,4,7
2019-06-12 05:31,HAK,5135,737-800,29,8,35,4,4,34,,,,,6,5
2019-06-12 05:24,PEK,5539,737-800,25,6,32,4,4,28,,,,,7,3
2019-06-12 05:23,CAN,6062,737-800,25,4,34,4,4,34,,,,,9,9
2019-06-12 05:23,DLC,5406,737-800,20,4,26,6,6,28,,,,,6,8
2019-06-12 05:18,CAN,1372,737-800,25,6,36,6,6,36,,,,,11,11
2019-06-12 05:15,XIY,1785,737-800,26,6,30,8,8,28,,,,,4,2
2019-06-12 05:14,XIY,1785,737-800,26,6,30,8,8,28,,,,,4,2
2019-06-12 05:14,HAK,5462,737-800,28,7,37,7,7,36,,,,,9,8
2019-06-12 05:08,HAK,1131,737-800,27,18,46,18,20,42,1,1,,11,19,15
2019-06-12 05:07,HAK,5082,737-800,32,6,35,5,5,34,,,,,3,2
2019-06-12 04:56,DLC,1795,737-800,20,4,26,4,4,24,,,,,6,4
2019-06-12 04:55,DLC,5581,737-800,20,4,22,4,4,32,,,,,2,12
2019-06-12 04:53,DLC,1375,737-800,22,4,30,4,4,26,,,,,8,4
2019-06-12 04:52,FOC,1905,737-800,24,4,30,4,3,29,,,,,6,5
2019-06-12 04:51,DLC,1497,737-800,20,4,28,4,4,28,,,,,8,8
2019-06-12 04:50,DLC,1505,737-800,20,4,22,4,4,26,,,,,2,6
2019-06-12 04:48,DLC,1489,737-800,21,4,28,4,4,29,,,,,7,8
2019-06-12 04:47,URC,1569,737-800,21,2,28,2,2,27,,,,,7,6
2019-06-12 04:47,KMG,6016,737-800,20,4,33,4,4,32,,,,,13,12
2019-06-12 04:47,DLC,1141,737-800,21,6,28,6,6,28,,,,,7,7
2019-06-12 04:45,DLC,5372,737-800,21,6,26,6,6,26,,,,,5,5
2019-06-12 04:42,URC,5540,737-800,22,4,30,4,4,24,,,,,8,2
2019-06-12 04:31,KMG,6800,737-800,25,4,28,4,4,26,,,,,3,1
2019-06-12 04:28,XIY,1163,737-800,28,4,32,2,2,32,,,,,4,4
2019-06-12 04:14,TYN,206G,737-800,22,3,28,4,4,27,,,,,6,5
2019-06-12 04:13,HAK,7173,737-800,30,7,37,37,6,6,,,,,7,-24
2019-06-12 04:12,HAK,1346,737-800,28,6,37,6,7,33,,,,,9,5
2019-06-12 04:11,URC,1215,737-800,20,0,20,2,3,24,,,,,0,4
2019-06-12 04:11,CAN,5371,737-800,27,8,31,6,6,31,,,,,4,4
2019-06-12 04:10,URC,1726,737-800,20,2,20,2,4,24,,,,,0,4
2019-06-12 04:10,KMG,6015,737-800,20,4,32,4,4,28,,,,,12,8
2019-06-12 04:08,CAN,5138,737-800,27,4,32,4,4,30,,,,,5,3
2019-06-12 03:54,CAN,1927,737-800,23,6,29,8,6,28,,,,,6,5
2019-06-12 03:49,HAK,5467,737-800,30,8,36,8,8,35,,,,,6,5
2019-06-12 03:48,HAK,7639,737-800,30,6,36,6,6,34,,,,,6,4
2019-06-12 03:47,CKG,7618,737-800,22,5,28,5,5,28,,,,,6,6
2019-06-12 03:39,CAN,1502,737-800,27,4,32,4,4,33,,,,,5,6
2019-06-12 03:29,CGO,1587,737-800,26,4,23,5,3,28,,,,,-3,2
2019-06-12 03:17,HAK,5686,737-800,28,8,36,5,4,34,,,,,8,6
2019-06-12 03:17,TYN,5478,737-800,25,2,22,2,2,20,,,,,-3,-5
2019-06-12 03:16,FOC,1435,737-800,26,6,34,6,6,30,,,,,8,4
2019-06-12 03:16,TYN,1733,737-800,25,3,26,2,2,24,,,,,1,-1
2019-06-12 03:16,SZX,5136,737-800,27,5,32,4,4,35,,,,,5,8
2019-06-12 03:07,XIY,1483,737-800,23,5,26,6,5,26,,,,,3,3
2019-06-12 03:05,SZX,6808,737-800,25,4,36,4,4,32,1,,,1,11,7
2019-06-12 03:04,SZX,5137,737-800,25,6,27,3,3,33,,,,,2,8
2019-06-12 03:02,CAN,7378,737-800,29,6,32,7,6,33,,,,,3,4
2019-06-12 03:02,HGH,1501,737-800,24,4,33,4,4,28,,,,,9,4
2019-06-12 02:49,URC,205T,737-800,20,2,28,4,2,28,,,,,8,8
2019-06-12 02:48,SZX,5625,737-800,25,5,32,5,4,32,,,,,7,7
2019-06-12 02:47,XIY,1906,737-800,23,7,29,7,7,29,,,,,6,6
2019-06-12 02:46,XIY,1350,737-800,26,4,34,4,4,32,,,,,8,6
2019-06-12 02:45,URC,206P,737-800,20,4,24,4,4,24,,,,,4,4
2019-06-12 02:41,HRB,1559,737-800,17,4,32,3,4,24,1,,,1,15,7
2019-06-12 02:40,HRB,1559,737-800,17,2,24,2,2,25,,,,,7,8
2019-06-12 02:38,KMG,7990,737-800,21,4,28,3,3,30,,,,,7,9
2019-06-12 02:36,TYN ,5083,737-800,20,3,23,5,4,28,,,,,3,8
2019-06-12 02:32,URC,6995,737-800,20,4,27,5,5,25,,,,,7,5
2019-06-12 02:31,HHA,1929,737-800,28,4,30,4,4,30,,,,,2,2
2019-06-12 02:31,HHA,5579,737-800,27,6,28,6,6,30,,,,,1,3
2019-06-12 02:30,PEK,5538,737-800,25,8,24,8,8,24,,,,,-1,-1
2019-06-12 02:28,CGO,1570,737-800,27,2,22,2,3,21,,,,,-5,-6
2019-06-12 02:28,CGO,1570,737-800,27,2,22,2,3,21,,,,,-5,-6
2019-06-12 02:27,PEK,1548,737-800,25,4,28,5,4,26,,,,,3,1
2019-06-12 02:26,HAK,1490,737-800,29,6,37,6,6,35,,,,,8,6
2019-06-12 02:26,HGH,1101,737-800,26,3,34,2,2,32,,,,,8,6
2019-06-12 02:25,SYX,5408,737-800,28,9,36,5,6,34,,,,,8,6
2019-06-12 02:23,KMG,7989,737-800,22,4,34,4,5,32,,,,,12,10
2019-06-12 02:20,CAN,5359,737-800,25,5,35,4,5,31,1,,,1,10,6
2019-06-12 02:15,HHA,1495,737-800,29,4,34,4,4,34,,,,,5,5
2019-06-12 02:12,URC,7198,737-800,19,4,28,4,4,26,,,,,9,7
2019-06-12 02:11,CGO  Ö£ÖÝ,1586,737-800,30,4,32,4,4,30,,,,,2,0
2019-06-12 02:09,FOC,7398,737-800,24,6,36,4,4,36,1,1,,11,12,12
2019-06-12 02:07,URC,1568,737-800,20,6,26,6,7,22,,,,,6,2
2019-06-12 02:07,SYX,1130,737-800,28,4,36,2,2,37,,,,,8,9
2019-06-12 02:02,HGH,6065,737-800,24,4,34,4,4,35,,,,,10,11
2019-06-12 02:01,URC,1493,737-800,20,6,26,4,4,22,,,,,6,2
2019-06-12 02:00,HAK,5853,737-800,29,6,35,6,6,30,,,,,6,1
2019-06-12 01:56,º£¿Ú,1347,737-800,30,8,37,8,8,35,,,,,7,5
2019-06-12 01:55,XIY,5116,737-800,26,3,26,4,4,25,,,,,0,-1
2019-06-12 01:54,XIY,1902,737-800,21,4,30,4,4,24,,,,,9,3
2019-06-12 01:52,PEK,1213,737-800,25,6,32,6,6,32,,,,,7,7
2019-06-12 01:50,SZX,206H,737-800,25,3,33,3,3,32,,,,,8,7
2019-06-12 01:50,SYX,7379,737-800,30,3,36,5,4,36,,,,,6,6
2019-06-12 01:47,CAN,5481,737-800,27,6,32,6,5,31,,,,,5,4
2019-06-12 01:46,SZX,1492,737-800,25,5,34,3,3,32,,,,,9,7
2019-06-12 01:46,HAK,1793,737-800,30,9,37,8,8,36,,,,,7,6
2019-06-12 01:45,XIY,1482,737-800,23,6,32,5,6,24,,,,,9,1
2019-06-12 01:45,HAK,7175,737-800,29,5,35,6,5,32,,,,,6,3
2019-06-12 01:45,CAN,6063,737-800,26,6,35,6,6,34,,,,,9,8
2019-06-12 01:44,HGH,5375,737-800,23,2,24,4,4,26,,,,,1,3
2019-06-12 01:41,XIY,5416,737-800,30,8,26,8,8,30,,,,,-4,0
2019-06-12 01:37,HHA,1373,737-800,28,32,3,4,3,30,,,,,-25,2
2019-06-12 01:37,CTU,7992,737-800,25,6,29,6,6,30,,,,,4,5
2019-06-12 01:36,MIG,5449,737-800,23,3,30,3,3,28,,,,,7,5
2019-06-12 01:36,HHA,5337,737-800,28,4,35,4,4,33,,,,,7,5
2019-06-12 01:35,URC,1996,737-800,17,5,20,6,6,28,,,,,3,11
2019-06-12 01:34,MIG,5409,737-800,20,5,29,4,4,29,,,,,9,9
2019-06-12 01:34,XIY,7886,737-800,25,4,30,4,4,30,,,,,5,5
2019-06-12 01:33,URC,5797,737-800,23,6,18,6,6,24,,,,,-5,1
2019-06-12 01:30,HGH,5153,737-800,24,4,28,4,4,24,,,,,4,0
2019-06-12 01:28,KMG,7991,737-800,22,5,30,7,8,30,,,,,8,8
2019-06-12 01:23,CAN,5479,737-800,29,8,34,7,6,36,,,,,5,7
2019-06-12 01:22,HAK,1545,737-800,28,6,36,6,6,37,,,,,8,9
2019-06-12 01:20,CGO,7167,737-800,29,6,30,6,6,28,,,,,1,-1
2019-06-12 01:13,HHA,5522,737-800,28,6,32,7,7,34,,,,,4,6
2019-06-12 01:12,XIY,1547,737-800,26,7,36,7,8,37,,,,,10,11
2019-06-12 01:12,URC,7399,737-800,20,4,20,4,4,22,,,,,0,2
2019-06-12 01:11,URC,205V,737-800,20,2,28,2,2,26,,,,,8,6
2019-06-12 01:09,SYX,5483,737-800,30,8,36,5,6,35,,,,,6,5
2019-06-12 01:07,YIH,1348,737-800,23,4,32,4,4,30,,,,,9,7
2019-06-12 01:04,HRB,1351,737-800,17,6,37,6,6,33,,,,,20,16
2019-06-12 01:04,URC ,205U ,737-800,22,4,26,2,2,30,,,,,4,8
2019-06-12 01:04,HRB,1351,737-800,17,4,30,5,5,30,,,,,13,13
2019-06-12 01:03,URC ,205U ,737-800,22,4,26,2,2,30,,,,,4,8
2019-06-12 00:56,SZX,1728,737-800,25,4,34,5,5,27,,,,,9,2
2019-06-12 00:53,TYN,1103,737-800,24,4,30,4,4,30,,,,,6,6
2019-06-12 00:51,MIG,1798,737-800,20,6,31,6,6,26,,,,,11,6
2019-06-12 00:49,YIH,7113,737-800,23,5,31,6,5,32,,,,,8,9
2019-06-12 00:40,URC,1995,737-800,22,5,26,6,5,28,,,,,4,6
2019-06-12 00:38,SYX,5466,737-800,31,0,20,6,0,20,,,,,-11,-11
2019-06-12 00:29,XIY,1997,737-800,25,5,28,3,3,26,,,,,3,1
2019-06-12 00:27,SYX,7377,737-800,30,8,37,6,6,36,,,,,7,6
2019-06-12 00:24,XIY,5417,737-800,26,5,24,5,5,26,,,,,-2,0
2019-06-12 00:23,HRB,1433,737-800,18,3,26,3,4,25,,,,,8,7
2019-06-12 00:22,CKG,5418,737-800,20,5,26,5,5,28,,,,,6,8
2019-06-12 00:14,KMG,7993,737-800,20,5,28,6,6,26,,,,,8,6
2019-06-12 00:13,CAN,5852,737-800,25,2,34,2,2,34,,,,,9,9
2019-06-12 00:12,HAK,7616,737-800,30,6,37,4,4,3,,,,,7,-27
2019-06-12 00:12,CGO,1209,737-800,29,4,32,4,4,33,,,,,3,4
2019-06-12 00:10,CGO,7990,737-800,29,4,32,4,4,33,,,,,3,4
2019-06-12 00:09,SYX,5709,737-800,30,8,37,7,9,36,,,,,7,6
2019-06-12 00:07,XIY,1488,737-800,25,6,20,4,5,26,,,,,-5,1
2019-06-12 00:01,HAK,1208,737-800,30,6,37,4,4,32,,,,,7,2
2019-06-11 23:59,URC,5623,737-800,23,6,30,6,6,25,,,,,7,2
2019-06-11 23:58,URC,5623,737-800,23,6,30,6,6,25,,,,,7,2
2019-06-11 23:53,URC,1325,737-800,21,4,26,4,4,22,,,,,5,1
2019-06-11 23:48,HGH,5855,737-800,25,6,30,6,6,26,,,,,5,1
2019-06-11 23:46,º£¿Ú,5090,737-800,30,7,37,8,8,37,,,,,7,7
2019-06-11 23:43,XIY,1102,737-800,30,4,30,4,4,32,,,,,0,2
2019-06-11 23:39,URC,1323,737-800,22,2,21,3,3,24,,,,,-1,2
2019-06-11 23:38,ÐìÖÝ,7988,737-800,30,4,34,5,3,33,,,,,4,3
2019-06-11 23:38,TYN,1541,737-800,26,5,28,5,4,28,,,,,2,2
2019-06-11 23:35,HAK,5520,737-800,33,6,37,9,7,37,,,,,4,4
2019-06-11 23:11,XIY,1503,737-800,25,4,28,4,6,30,,,,,3,5
2019-06-11 23:09,HAK,5687,737-800,29,9,37,6,5,36,,,,,8,7
2019-06-11 23:08,PEK,1491,737-800,27,6,34,6,5,32,,,,,7,5
2019-06-11 23:07,CGO,5358,737-800,29,6,26,6,6,30,,,,,-3,1
2019-06-11 23:01,HRB,1562,737-800,20,4,28,4,4,29,,,,,8,9
2019-06-11 22:58,PEK,5502,737-800,27,4,26,4,6,32,,,,,-1,5
2019-06-11 22:57,FOC,7105,737-800,25,30,3,4,3,29,,,,,-22,4
2019-06-11 22:54,SYX,7400,737-800,30,3,35,3,3,34,,,,,5,4
2019-06-11 22:48,HAK,5712,737-800,30,6,37,4,4,36,,,,,7,6
2019-06-11 22:42,CKG,5733,737-800,22,5,30,5,4,28,,,,,8,6
2019-06-11 22:34,Î÷Äþ,1735,737-800,21,4,25,6,5,20,,,,,4,-1
2019-06-11 22:32,PEK ,5735,737-800,26,4,30,2,4,28,,,,,4,2
2019-06-11 22:32,HAK,5713,737-800,32,6,35,5,5,32,,,,,3,0
2019-06-11 22:14,XIY,1797,737-800,26,3,26,3,4,26,,,,,0,0
2019-06-11 22:04,Î÷Äþ,7171,737-800,21,4,21,6,5,24,,,,,0,3
2019-06-11 21:56,HAK,206F,737-800,30,3,36,3,3,32,,,,,6,2
2019-06-11 21:29,MIG,6809,737-800,20,5,28,6,6,29,,,,,8,9
2019-06-11 19:54,FOC,7105,737-800,25,3,34,4,5,33,,,,,9,8
2019-06-11 19:07,HHA,6103,737-800,34,7,36,7,7,37,,,,,2,3
2019-06-11 18:23,CGO,5139,737-800,33,4,22,5,4,28,,,,,-11,-5
2019-06-11 17:13,TYN,1799,737-800,34,4,32,4,4,30,,,,,-2,-4
2019-06-11 15:35,DLC,5372,737-800,25,8,28,6,8,26,,,,,3,1
2019-06-11 15:09,PEK,1542,737-800,33,7,22,6,7,26,,,,,-11,-7
2019-06-11 13:02,XIY,5135,737-800,28,4,28,4,5,28,,,,,0,0
2019-06-11 12:58,CTU ,7992 ,737-800,26,7,32,7,7,32,,,,,6,6
2019-06-11 09:25,PEK,5538,737-800,24,4,28,3,4,26,,,,,4,2
2019-06-11 09:14,URC,205U,737-800,19,4,27,4,4,28,,,,,8,9
2019-06-11 09:01,PEK,6103,737-800,35,6,35,7,6,34,,,,,0,-1
2019-06-11 08:33,PEK,1347,737-800,25,4,30,4,4,30,,,,,5,5
2019-06-11 08:18,XMN,5580,737-800,27,6,36,5,6,35,,,,,9,8
2019-06-11 08:17,XMN,1783,737-800,27,4,34,8,8,34,,,,,7,7
2019-06-11 08:16,XMN,7619,737-800,20,6,28,5,4,29,,,,,8,9
2019-06-11 08:15,XMN,1928,737-800,20,5,29,7,6,28,,,,,9,8
2019-06-11 08:08,PEK,6103,737-800,26,6,35,16,22,38,,,,,9,12
2019-06-11 08:05,CGO,5405,737-800,29,5,32,4,4,30,,,,,3,1
2019-06-11 08:05,CGO,1209,737-800,29,3,29,4,4,30,,,,,0,1
2019-06-11 07:55,HAK,1785,737-800,32,1,37,7,8,36,,,,,5,4
2019-06-11 07:47,PEK,1375,737-800,23,5,30,5,4,26,,,,,7,3
2019-06-11 07:13,XIY,5661,737-800,28,4,28,4,4,30,,,,,0,2
2019-06-11 06:40,CKG,5418,737-800,24,3,24,3,3,28,,,,,0,4
2019-06-11 06:21,HAK,1541,737-800,30,6,35,6,6,34,,,,,5,4
2019-06-11 06:13,FOC,1435,737-800,25,6,38,6,6,28,,,,,13,3
2019-06-11 06:13,FOC,1435,737-800,25,5,33,6,6,28,,,,,8,3
2019-06-11 06:05,HHA,1373,737-800,28,7,33,7,6,32,,,,,5,4
2019-06-11 06:04,HHA,1496,737-800,28,6,32,6,5,32,,,,,4,4
2019-06-11 05:51,HAK,6063,737-800,29,7,36,6,6,35,,,,,7,6
2019-06-11 05:50,HHA,1929,737-800,27,4,30,3,3,28,,,,,3,1
2019-06-11 05:37,HAK,1541,737-800,30,6,35,6,6,34,,,,,5,4
2019-06-11 05:26,FOC,7113,737-800,26,7,36,6,7,35,,,,,10,9
2019-06-11 05:23,À¥Ã÷,7993,737-800,20,6,20,6,6,28,,,,,0,8
2019-06-11 05:07,FOC ,5503,737-800,25,5,30,3,3,26,,,,,5,1
2019-06-11 04:40,HAK,5521,737-800,28,4,33,7,7,36,,,,,5,8
2019-06-11 04:39,HAK,5521,737-800,28,4,33,7,7,36,,,,,5,8
2019-06-11 04:36,SZX,6808,737-800,28,5,36,5,5,33,,,,,8,5
2019-06-11 04:25,URC,1568,737-800,20,6,28,6,6,23,,,,,8,3
2019-06-11 04:13,PEK,1488,737-800,25,6,30,6,5,28,,,,,5,3
2019-06-11 04:12,SYX ,5709,737-800,31,5,25,5,6,24,,,,,-6,-7
2019-06-11 04:10,DLC,,737-800,20,2,28,4,4,24,,,,,8,4
2019-06-11 04:07,HGH,5375,737-800,25,2,25,4,4,28,,,,,0,3
2019-06-11 04:05,XIY,5180,737-800,27,6,32,6,5,31,,,,,5,4
2019-06-11 04:05,SYX,5481,737-800,30,8,34,6,7,33,,,,,4,3
2019-06-11 04:05,SYX,1729,737-800,30,8,36,7,7,34,,,,,6,4
2019-06-11 04:02,23,5462,737-800,30,6,36,7,7,36,,,,,6,6
2019-06-11 04:00,HGH,5540,737-800,27,6,28,6,6,30,,,,,1,3
2019-06-11 03:58,SZX,5136,737-800,27,6,32,3,3,34,,,,,5,7
2019-06-11 03:48,HGH,5855,737-800,30,6,29,7,7,27,,,,,-1,-3
2019-06-11 03:44,ZGC,5638,737-800,25,4,24,4,6,24,,,,,-1,-1
2019-06-11 03:43,ZGC,5686,737-800,20,3,27,2,2,22,,,,,7,2
2019-06-11 03:42,FOC,1905,737-800,22,4,29,4,4,28,,,,,7,6
2019-06-11 03:41,DLC,5581,737-800,18,4,22,6,4,24,,,,,4,6
2019-06-11 03:41,FOC,1905,737-800,22,5,32,4,4,28,,,,,10,6
2019-06-11 03:41,URC,5798,737-800,22,2,24,2,3,22,,,,,2,0
2019-06-11 03:40,ZGC,1997,737-800,25,6,5,4,4,22,,,,,-20,-3
2019-06-11 03:39,ZGC,7377,737-800,25,9,27,5,5,25,,,,,2,0
2019-06-11 03:39,XIY,1796,737-800,28,4,30,4,4,32,,,,,2,4
2019-06-11 03:38,HAK,5371,737-800,32,7,32,7,7,36,,,,,0,4
2019-06-11 03:37,SZX,1490,737-800,29,6,34,5,5,34,,,,,5,5
2019-06-11 03:32,XIY,1906,737-800,28,7,30,6,6,30,,,,,2,2
2019-06-11 03:32,XIY,1491,737-800,36,4,32,5,5,30,,,,,-4,-6
2019-06-11 03:31,KMG,1798,737-800,24,6,28,5,5,27,,,,,4,3
2019-06-11 03:31,XIY,1491,737-800,36,4,32,5,5,30,,,,,-4,-6
2019-06-11 03:26,PEK,1213,737-800,25,5,29,6,5,28,,,,,4,3
2019-06-11 03:24,KMG,7991,737-800,23,5,28,5,5,28,,,,,5,5
2019-06-11 03:22,CAN,5852,737-800,28,5,34,6,5,32,,,,,6,4
2019-06-11 03:21,DLC,1141,737-800,18,4,28,6,5,27,,,,,10,9
2019-06-11 03:19,URC,206P,737-800,20,5,24,4,5,24,,,,,4,4
2019-06-11 03:17,XIY,1482,737-800,28,6,30,5,6,30,,,,,2,2
2019-06-11 03:17,URC,7399,737-800,23,5,27,4,4,23,,,,,4,0
2019-06-11 03:17,DLC,1489,737-800,18,4,30,5,4,28,,,,,12,10
2019-06-11 03:15,DLC,1497,737-800,20,2,22,2,2,22,,,,,2,2
2019-06-11 03:14,DLC,1497,737-800,20,2,22,2,2,24,,,,,2,4
2019-06-11 03:13,XMN,1928,737-800,20,5,29,7,6,28,,,,,9,8
2019-06-11 03:12,TYN,7171,737-800,20,4,24,5,4,26,,,,,4,6
2019-06-11 03:12,XMN,7619,737-800,20,6,28,5,4,29,,,,,8,9
2019-06-11 03:12,HHA,5735,737-800,27,4,28,4,4,30,,,,,1,3
2019-06-11 03:11,DLC,7379,737-800,18,4,28,4,4,29,,,,,10,11
2019-06-11 03:11,XMN,1783,737-800,27,4,34,8,8,34,,,,,7,7
2019-06-11 03:10,XMN,5580,737-800,27,6,36,5,6,35,,,,,9,8
2019-06-11 03:07,DLC,1103,737-800,18,5,30,4,4,24,,,,,12,6
2019-06-11 03:06,HAK,6066,737-800,29,7,35,8,7,35,,,,,6,6
2019-06-11 03:06,SHA,6065,737-800,22,8,36,5,5,35,1,,,1,14,13
2019-06-11 03:04,SHA,1725,737-800,24,4,35,4,4,32,,,,,11,8
2019-06-11 02:59,SYX,5358,737-800,29,6,31,5,5,34,,,,,2,5
2019-06-11 02:57,SZX,5373,737-800,26,4,34,7,7,35,,,,,8,9
2019-06-11 02:54,KMG,6015,737-800,20,4,32,4,4,26,,,,,12,6
2019-06-11 02:52,CAN,5466,737-800,25,2,24,8,3,26,,,,,-1,1
2019-06-11 02:51,HAK,5346,737-800,29,8,36,8,8,31,,,,,7,2
2019-06-11 02:50,KMG,7988,737-800,24,4,29,5,4,30,,,,,5,6
2019-06-11 02:50,SYX,1498,737-800,29,6,36,5,5,35,,,,,7,6
2019-06-11 02:46,URC,6995,737-800,25,4,28,5,5,24,,,,,3,-1
2019-06-11 02:46,URC,7198,737-800,15,4,28,5,4,28,,,,,13,13
2019-06-11 02:40,CGO,5416,737-800,26,4,28,5,4,30,,,,,2,4
2019-06-11 02:39,CAN,5479,737-800,26,8,35,5,6,36,,,,,9,10
2019-06-11 02:37,SZX,7175,737-800,26,4,34,4,6,32,,,,,8,6
2019-06-11 02:36,HAK,5338,737-800,28,3,32,5,4,34,,,,,4,6
2019-06-11 02:35,HRB,1562,737-800,19,5,27,4,5,29,,,,,8,10
2019-06-11 02:34,FOC,5182,737-800,23,2,22,4,4,28,,,,,-1,5
2019-06-11 02:34,HAK,1787,737-800,30,2,36,8,8,36,,,,,6,6
2019-06-11 02:30,HAK,5520,737-800,30,7,36,8,8,37,,,,,6,7
2019-06-11 02:27,PEK,5482,737-800,23,2,30,4,4,33,,,,,7,10
2019-06-11 02:26,XIY,1903,737-800,27,2,35,2,2,32,,,,,8,5
2019-06-11 02:26,PEK,5539,737-800,22,4,30,3,2,29,,,,,8,7
2019-06-11 02:26,FOC,5417,737-800,23,4,32,4,4,34,,,,,9,11
2019-06-11 02:23,CAN,6062,737-800,24,4,24,3,4,24,,,,,0,0
2019-06-11 02:20,HHA,5337,737-800,29,6,32,5,6,33,,,,,3,4
2019-06-11 02:19,CAN,1545,737-800,24,5,36,4,5,35,,,,,12,11
2019-06-11 02:19,SYX,1101,737-800,29,2,37,3,2,36,,,,,8,7
2019-06-11 02:17,URC,2159,737-800,23,2,28,2,2,27,,,,,5,4
2019-06-11 02:08,HGH,1786,737-800,26,4,29,4,4,25,,,,,3,-1
2019-06-11 02:06,URC,1995,737-800,22,5,28,6,6,28,,,,,6,6
2019-06-11 02:05,XIY,1483,737-800,29,4,30,6,5,30,,,,,1,1
2019-06-11 02:04,XIY,5115,737-800,29,4,24,6,6,20,,,,,-5,-9
2019-06-11 02:04,XIY,1102,737-800,30,4,30,3,3,29,,,,,0,-1
2019-06-11 02:03,XIY,7886,737-800,29,4,30,4,4,30,,,,,1,1
2019-06-11 02:03,MIG,5449,737-800,20,6,29,7,7,29,,,,,9,9
2019-06-11 02:01,CAN,1502,737-800,25,4,36,3,3,32,,,,,11,7
2019-06-11 01:57,HGH,1727,737-800,23,4,30,5,4,28,,,,,7,5
2019-06-11 01:56,XIY,1902,737-800,28,4,32,8,6,26,,,,,4,-2
2019-06-11 01:54,URC,1726,737-800,21,3,20,3,2,24,,,,,-1,3
2019-06-11 01:49,HAK,1492,737-800,29,4,35,2,2,32,,,,,6,3
2019-06-11 01:48,HAK,1492,737-800,29,4,35,2,2,32,,,,,6,3
2019-06-11 01:47,SYX,7400,737-800,30,4,34,5,4,34,,,,,4,4
2019-06-11 01:39,HAK,5662,737-800,29,6,36,4,6,33,,,,,7,4
2019-06-11 01:34,SZX,5625,737-800,28,6,36,5,4,35,,,,,8,7
2019-06-11 01:32,HGH,1501,737-800,26,2,28,4,4,29,,,,,2,3
2019-06-11 01:28,URC,1215,737-800,22,4,28,4,6,30,,,,,6,8
2019-06-11 01:28,XIY,1162,737-800,25,4,23,4,5,26,,,,,-2,1
2019-06-11 01:27,URC,6268,737-800,20,5,27,4,5,27,,,,,7,7
2019-06-11 01:26,URC,5611,737-800,20,6,30,6,6,26,,,,,10,6
2019-06-11 01:26,XIY,1386,737-800,25,3,24,4,3,24,,,,,-1,-1
2019-06-11 01:24,SYX,7173,737-800,29,4,36,5,5,35,,,,,7,6
2019-06-11 01:22,HAK,5467,737-800,29,8,36,7,8,36,,,,,7,7
2019-06-11 01:22,CGO,7167,737-800,28,3,28,5,5,28,,,,,0,0
2019-06-11 01:20,XIY,1350,737-800,27,4,33,4,4,30,,,,,6,3
2019-06-11 01:19,URC,2159,737-800,23,2,28,2,2,27,,,,,5,4
2019-06-11 01:18,CKG,5733,737-800,25,6,32,6,6,34,,,,,7,9
2019-06-11 01:16,XIY,1161,737-800,28,4,34,4,4,30,,,,,6,2
2019-06-11 01:05,HRB,1480,737-800,20,5,27,5,5,27,,,,,7,7
2019-06-11 01:02,TYN,5478,737-800,26,7,30,6,7,25,,,,,4,-1
2019-06-11 00:57,CGO,1586,737-800,26,4,30,4,4,30,,,,,4,4
2019-06-11 00:55,TYN ,1728,737-800,25,4,26,6,6,24,,,,,1,-1
2019-06-11 00:50,XIY,1503,737-800,30,2,25,4,3,31,,,,,-5,1
2019-06-11 00:49,HAK,7639,737-800,30,5,33,4,4,30,,,,,3,0
2019-06-11 00:47,URC,5623,737-800,20,6,28,6,6,24,,,,,8,4
2019-06-11 00:43,HGH,5480,737-800,30,4,29,5,3,27,,,,,-1,-3
2019-06-11 00:43,SZX,5137,737-800,29,5,25,4,3,32,,,,,-4,3
2019-06-11 00:38,URC,5623,737-800,20,6,28,6,6,24,,,,,8,4
2019-06-11 00:34,KMG,7989,737-800,25,6,26,6,5,28,,,,,1,3
2019-06-11 00:34,CAN,1131,737-800,26,5,36,4,4,36,,,,,10,10
2019-06-11 00:32,CAN,5463,737-800,23,5,33,6,5,34,,,,,10,11
2019-06-11 00:31,URC,205V,737-800,19,2,25,2,2,25,,,,,6,6
2019-06-11 00:28,HAK,1793,737-800,30,8,36,8,6,36,,,,,6,6
2019-06-11 00:26,HGH,5153,737-800,24,3,30,2,2,26,,,,,6,2
2019-06-11 00:24,DLC,1547,737-800,20,4,26,5,5,28,,,,,6,8
2019-06-11 00:23,PEK,5502,737-800,23,2,24,2,2,26,,,,,1,3
2019-06-11 00:09,MIG,6809,737-800,20,5,29,6,6,28,,,,,9,8
2019-06-11 00:03,CKG,5418,737-800,24,4,26,3,3,28,,,,,2,4
2019-06-11 00:01,CAN,5138,737-800,25,5,33,3,3,34,,,,,8,9
2019-06-10 23:56,CAN,1372,737-800,26,5,36,5,5,36,1,1,,11,10,10
2019-06-10 23:49,TYN,5083,737-800,26,4,26,3,4,25,,,,,0,-1
2019-06-10 23:49,DLC,1795,737-800,20,4,28,4,4,30,,,,,8,10
2019-06-10 23:48,HRB,1562,737-800,19,5,28,4,5,30,,,,,9,11
2019-06-10 23:47,XNN,7398,737-800,21,5,27,4,4,28,,,,,6,7
2019-06-10 23:44,URC,205T,737-800,24,3,24,3,3,27,,,,,0,3
2019-06-10 23:43,HAK,7616,737-800,30,6,35,4,4,33,,,,,5,3
2019-06-10 23:42,XIY,1549,737-800,30,6,32,6,6,30,,,,,2,0
2019-06-10 23:42,SZX,5636,737-800,27,8,36,6,6,36,,,,,9,9
2019-06-10 23:41,URC,1548,737-800,23,4,24,3,2,22,,,,,1,-1
2019-06-10 23:41,PEK,5465,737-800,25,3,29,4,3,29,,,,,4,4
2019-06-10 23:39,CAN,5439,737-800,24,8,36,8,7,36,1,1,,11,12,12
2019-06-10 23:32,PEK,5687,737-800,23,4,30,4,4,30,,,,,7,7
2019-06-10 23:30,HHA,1495,737-800,30,6,36,4,4,31,,,,,6,1
2019-06-10 23:28,URC,5797,737-800,22,6,20,5,5,0,,,,,-2,-22
2019-06-10 23:19,MIG,6016,737-800,28,4,34,4,4,28,,,,,6,0
2019-06-10 23:18,KMG,6800,737-800,22,4,28,4,4,26,,,,,6,4
2019-06-10 23:08,TYN,7395,737-800,25,8,20,8,7,22,,,,,-5,-3
2019-06-10 23:07,HAK,5090,737-800,30,6,36,7,8,36,,,,,6,6
2019-06-10 23:06,CGO,1570,737-800,29,4,28,6,6,28,,,,,-1,-1
2019-06-10 23:04,CKG,5141,737-800,25,5,29,5,5,29,,,,,4,4
2019-06-10 23:01,URC,1493,737-800,23,5,24,6,6,22,,,,,1,-1
2019-06-10 22:57,URC,1325,737-800,20,4,23,4,4,22,,,,,3,2
2019-06-10 22:55,TYN,1505,737-800,20,2,20,4,4,22,,,,,0,2
2019-06-10 22:53,CAN,7378,737-800,26,5,34,6,6,33,,,,,8,7
2019-06-10 22:52,HHA,5522,737-800,28,7,35,6,6,34,,,,,7,6
2019-06-10 22:45,URC,1323,737-800,25,4,28,4,4,26,,,,,3,1
2019-06-10 22:35,URC,5483,737-800,24,3,28,5,5,26,,,,,4,2
2019-06-10 22:24,TYN,206G,737-800,26,3,26,3,3,25,,,,,0,-1
2019-06-10 22:16,XNN,1735,737-800,23,5,26,6,6,22,,,,,3,-1
2019-06-10 22:14,HAK,1733,737-800,35,3,30,4,4,32,,,,,-5,-3
2019-06-10 22:08,XIY,5139,737-800,30,4,26,7,4,29,,,,,-4,-1
2019-06-10 22:00,PEK,1996,737-800,24,3,26,4,4,26,,,,,2,2
2019-06-10 21:49,URC,1569,737-800,24,2,30,2,2,27,,,,,6,3
2019-06-10 21:49,XNM,5116,737-800,20,3,20,4,4,21,,,,,0,1
2019-06-10 21:27,CAN,5359,737-800,23,8,36,5,6,34,,,,,13,11
2019-06-10 20:41,CGO,7990,737-800,30,3,28,4,4,29,,,,,-2,-1
2019-06-10 20:36,HAK,5429,737-800,36,8,36,9,9,37,,,,,0,1
2019-06-10 20:27,HAK,7618,737-800,30,5,36,6,6,36,,,,,6,6
2019-06-10 20:10,HAK,1785,737-800,32,1,42,16,16,42,,,,,10,10
2019-06-10 19:05,HRB,1559,737-800,23,3,24,5,3,23,,,,,1,0
2019-06-10 18:06,HAK,206F,737-800,34,5,36,2,2,31,,,,,2,-3
2019-06-10 17:43,XUZ,1208,737-800,32,2,32,3,3,30,,,,,0,-2
2019-06-10 16:54,CGO,1130,737-800,30,2,30,3,2,28,,,,,0,-2
2019-06-10 16:47,CGO,1130,737-800,30,2,30,3,2,28,,,,,0,-2
2019-06-10 13:53,YIH,1348,737-800,32,8,30,8,9,29,,,,,-2,-3
2019-06-10 12:29,MIG,5409,737-800,30,4,28,4,4,32,,,,,-2,2
2019-06-10 12:23,KMG,7993,737-800,20,6,26,6,5,24,,,,,6,4
2019-06-10 10:16,FOC,5430,737-800,26,0,0,6,6,36,,,,,-26,10
2019-06-10 09:25,HAK,5138,737-800,29,8,36,8,8,35,,,,,7,6
2019-06-10 08:21,KMG,6809,737-800,21,5,26,6,6,27,,,,,5,6
2019-06-10 08:09,KMG,7993,737-800,20,6,26,4,5,24,,,,,6,4
2019-06-10 07:59,XMN,5686,737-800,22,8,32,7,5,35,,1,,1,10,13
2019-06-10 07:58,XMN,1783,737-800,22,3,35,6,6,35,,,,,13,13
2019-06-10 07:57,XMN,1727,737-800,21,4,36,5,5,30,1,,,1,15,9
2019-06-10 07:57,XMN,5502,737-800,28,5,32,8,8,33,,,,,4,5
2019-06-10 07:19,KMG,1587,737-800,20,5,23,5,4,29,,,,,3,9
2019-06-10 07:03,ZGC,5417,737-800,20,3,21,3,4,23,,,,,1,3
2019-06-10 07:01,ZGC,7173,737-800,20,3,25,5,5,20,,,,,5,0
2019-06-10 06:56,PEK,7379,737-800,25,4,28,4,4,28,,,,,3,3
2019-06-10 06:47,CAN,5338,737-800,31,4,30,5,4,34,,,,,-1,3
2019-06-10 06:35,TYN,5136,737-800,26,4,24,6,6,28,,,,,-2,2
2019-06-10 06:26,PEK,1492,737-800,22,28,3,3,2,27,,,,,-19,5
2019-06-10 05:56,PEK,1213,737-800,26,6,34,5,5,34,,,,,8,8
2019-06-10 05:33,URC,1726,737-800,18,4,20,3,2,26,,,,,2,8
2019-06-10 05:27,FOC,1906,737-800,25,5,34,6,6,32,,,,,9,7
2019-06-10 05:26,HAK,206H,737-800,30,2,36,3,2,35,,,,,6,5
2019-06-10 05:20,DLC,1547,737-800,17,4,27,4,5,28,,,,,10,11
2019-06-10 05:19,DLC,1386,737-800,19,2,26,4,4,27,,,,,7,8
2019-06-10 05:12,PEK,5538,737-800,25,7,35,3,2,34,1,,,1,10,9
2019-06-10 04:55,HAK,5636,737-800,28,6,36,6,6,3,,,,,8,-25
2019-06-10 04:53,SYX ,5141,737-800,30,6,36,8,8,36,,,,,6,6
2019-06-10 04:51,SYX ,1141   ,737-800,30,6,36,6,6,32,,,,,6,2
2019-06-10 04:47,CAN,5466,737-800,30,6,32,6,6,31,,,,,2,1
2019-06-10 04:39,URC,205U,737-800,15,6,26,4,4,24,,,,,11,9
2019-06-10 04:30,URC,7198,737-800,15,6,26,4,4,24,,,,,11,9
2019-06-10 04:29,XIY,1163,737-800,25,2,32,2,2,30,,,,,7,5
2019-06-10 04:24,CAN,5479,737-800,26,6,35,6,7,34,,,,,9,8
2019-06-10 04:22,ÃàÑô,5409,737-800,25,5,27,5,4,31,,,,,2,6
2019-06-10 04:19,HAK,206G,737-800,28,2,32,4,4,33,,,,,4,5
2019-06-10 04:17,SZX,1785,737-800,29,2,37,6,7,36,,,,,8,7
2019-06-10 04:14,HAK,7639,737-800,28,8,36,8,9,37,,,,,8,9
2019-06-10 04:13,CAN,5479,737-800,26,8,38,8,9,36,,,,,12,10
2019-06-10 04:13,FOC,1562,737-800,27,4,35,4,5,37,,,,,8,10
2019-06-10 04:09,FOC,1797,737-800,26,4,32,6,6,30,,,,,6,4
2019-06-10 04:07,KMG,6800,737-800,20,4,28,6,5,26,,,,,8,6
2019-06-10 04:05,PEK,5538,737-800,23,8,36,3,2,34,,,,,13,11
2019-06-10 04:05,URC,5798,737-800,18,2,23,2,2,22,,,,,5,4
2019-06-10 04:01,FOC,1435,737-800,26,5,37,5,5,33,1,,,1,11,7
2019-06-10 03:58,HGH,5713,737-800,25,5,29,5,6,30,,,,,4,5
2019-06-10 03:57,HHA,5522,737-800,25,6,36,4,5,30,1,,,1,11,5
2019-06-10 03:55,HAK,5462,737-800,30,4,34,4,4,32,,,,,4,2
2019-06-10 03:55,HAK,5462,737-800,30,4,34,4,4,32,,,,,4,2
2019-06-10 03:47,CAN,1927,737-800,30,7,36,8,4,31,,,,,6,1
2019-06-10 03:47,FOC,5430,737-800,25,4,36,6,6,36,,,,,11,11
2019-06-10 03:46,FOC,5430,737-800,25,6,40,6,6,36,,,,,15,11
2019-06-10 03:45,CAN,5479,737-800,26,13,36,10,9,36,,,,,10,10
2019-06-10 03:45,HHA,5852,737-800,26,4,30,5,5,32,,,,,4,6
2019-06-10 03:45,XIY,1903,737-800,25,3,32,4,4,32,,,,,7,7
2019-06-10 03:38,HAK,5481,737-800,25,6,35,6,6,36,1,1,,11,10,11
2019-06-10 03:38,URC,205T,737-800,18,3,27,3,3,30,,,,,9,12
2019-06-10 03:37,HAK,1541,737-800,25,6,36,8,8,35,1,1,,11,11,10
2019-06-10 03:36,HAK,5481,737-800,25,6,35,6,6,36,,,,,10,11
2019-06-10 03:32,HGH,5735,737-800,28,5,28,4,4,28,,,,,0,0
2019-06-10 03:32,CKG,7377,737-800,25,6,32,6,6,32,,,,,7,7
2019-06-10 03:28,HHA,5337,737-800,26,6,35,5,5,35,,,,,9,9
2019-06-10 03:26,XIY ,1102,737-800,25,4,30,4,4,30,,,,,5,5
2019-06-10 03:25,XIY ,1162,737-800,25,3,30,3,3,28,,,,,5,3
2019-06-10 03:24,XIY ,1483,737-800,25,6,28,6,7,22,,,,,3,-3
2019-06-10 03:21,SYX,206F,737-800,29,3,32,4,3,30,,,,,3,1
2019-06-10 03:19,HAK,1793,737-800,29,6,36,6,5,35,,,,,7,6
2019-06-10 03:12,KMG,1209,737-800,25,3,30,4,4,28,,,,,5,3
2019-06-10 03:11,URC,6268,737-800,17,4,26,5,5,25,,,,,9,8
2019-06-10 03:09,PEK,6103,737-800,23,6,29,5,6,30,,,,,6,7
2019-06-10 03:09,URC,1995,737-800,16,5,27,5,5,28,,,,,11,12
2019-06-10 03:01,URC,206P,737-800,20,3,22,2,2,20,,,,,2,0
2019-06-10 02:59,CAN,6063,737-800,28,6,36,6,6,36,,,,,8,8
2019-06-10 02:56,KMG,1208,737-800,25,2,29,3,3,27,,,,,4,2
2019-06-10 02:55,CAN,1502,737-800,29,4,33,6,6,37,,,,,4,8
2019-06-10 02:54,CAN,1131,737-800,29,5,36,5,4,37,,,,,7,8
2019-06-10 02:49,108,5539,737-800,25,3,30,3,3,29,,,,,5,4
2019-06-10 02:47,PEK,5623,737-800,25,6,30,6,5,26,,,,,5,1
2019-06-10 02:47,SZX,5137,737-800,28,6,30,6,5,36,,,,,2,8
2019-06-10 02:47,PEK,5581,737-800,22,5,22,5,4,28,,,,,0,6
2019-06-10 02:46,XIY,7886,737-800,25,3,32,7,7,23,,,,,7,-2
2019-06-10 02:44,HGH,5855,737-800,28,5,28,5,5,28,,,,,0,0
2019-06-10 02:42,HHA,1346,737-800,23,6,33,5,5,32,,,,,10,9
2019-06-10 02:41,URC,7198,737-800,17,5,28,5,4,26,,,,,11,9
2019-06-10 02:39,SZX,6808,737-800,29,7,37,6,5,36,,,,,8,7
2019-06-10 02:37,CAN,1538,737-800,28,7,36,4,5,34,,,,,8,6
2019-06-10 02:26,XIY,1902,737-800,26,6,32,6,6,24,,,,,6,-2
2019-06-10 02:25,KMG,7991,737-800,20,6,30,6,6,28,,,,,10,8
2019-06-10 02:23,Ö£ÖÝ,6015,737-800,28,4,33,4,4,28,,,,,5,0
2019-06-10 02:23,SYX,7400,737-800,30,6,34,5,4,35,,,,,4,5
2019-06-10 02:22,XIY,5503,737-800,25,4,26,4,4,28,,,,,1,3
2019-06-10 02:20,PEK,1501,737-800,23,4,32,4,4,28,,,,,9,5
2019-06-10 02:20,CGO,7990,737-800,26,6,30,4,5,29,,,,,4,3
2019-06-10 02:19,TYN,7171,737-800,23,4,24,4,4,26,,,,,1,3
2019-06-10 02:19,HAK,7618,737-800,28,4,34,6,6,35,,,,,6,7
2019-06-10 02:19,HA?K,5429,737-800,30,4,36,6,6,36,,,,,6,6
2019-06-10 02:16,HHA,1496,737-800,27,6,30,6,6,30,,,,,3,3
2019-06-10 02:14,XIY,1482,737-800,30,5,30,6,5,28,,,,,0,-2
2019-06-10 02:12,URC,2159,737-800,18,4,28,2,2,28,,,,,10,10
2019-06-10 02:10,HAK,1373,737-800,30,4,34,4,1,34,,,,,4,4
2019-06-10 02:07,HGH,5662,737-800,25,3,28,5,3,28,,,,,3,3
2019-06-10 02:07,SYX ,5408,737-800,30,8,36,6,6,32,,,,,6,2
2019-06-10 02:00,XIY,1997,737-800,20,4,25,4,4,20,,,,,5,0
2019-06-10 01:59,URC,6995,737-800,25,6,28,6,6,26,,,,,3,1
2019-06-10 01:58,HGH,5735,737-800,28,5,28,4,4,28,,,,,0,0
2019-06-10 01:57,HAK,1490,737-800,29,5,37,6,5,36,,,,,8,7
2019-06-10 01:56,DLC,1996,737-800,16,5,24,4,5,28,,,,,8,12
2019-06-10 01:55,URC,5637,737-800,17,3,24,2,2,23,,,,,7,6
2019-06-10 01:51,HHA,1503,737-800,26,1,31,4,4,33,,,,,5,7
2019-06-10 01:46,ZGC,7173,737-800,20,3,25,5,5,20,,,,,5,0
2019-06-10 01:46,DLC,1795,737-800,20,4,29,4,5,26,,,,,9,6
2019-06-10 01:46,ÃàÑô,6016,737-800,25,7,36,4,4,34,1,,,1,11,9
2019-06-10 01:42,HAK,5712,737-800,29,3,35,5,3,33,,,,,6,4
2019-06-10 01:37,XIY,1481,737-800,25,6,31,6,6,31,,,,,6,6
2019-06-10 01:36,YIH,1351,737-800,27,6,30,6,7,29,,,,,3,2
2019-06-10 01:33,URC,7399,737-800,17,5,26,4,4,21,,,,,9,4
2019-06-10 01:32,HGH,5540,737-800,24,3,25,4,4,27,,,,,1,3
2019-06-10 01:31,FOC,1905,737-800,25,4,36,5,4,30,1,,,1,11,5
2019-06-10 01:30,DLC,1103,737-800,16,3,24,3,3,24,,,,,8,8
2019-06-10 01:29,HAK,5090,737-800,33,7,37,8,9,37,,,,,4,4
2019-06-10 01:26,CGO,1470,737-800,29,5,26,6,6,25,,,,,-3,-4
2019-06-10 01:25,CAN,1549,737-800,26,7,36,6,6,34,1,,,1,10,8
2019-06-10 01:24,URC,1928,737-800,19,4,20,4,4,20,,,,,1,1
2019-06-10 01:20,XIY,1350,737-800,25,2,22,4,4,22,,,,,-3,-3
2019-06-10 01:19,SZX,5373,737-800,29,8,34,8,8,36,,,,,5,7
2019-06-10 01:18,SYX,5416,737-800,30,9,37,9,8,37,,,,,7,7
2019-06-10 01:17,HHA,1495,737-800,27,8,37,4,4,36,1,,,1,10,9
2019-06-10 01:17,PEK,5580,737-800,23,4,28,5,4,30,,,,,5,7
2019-06-10 01:10,SYX,5709,737-800,30,6,34,6,6,32,,,,,4,2
2019-06-10 01:10,HGH,HGH,737-800,25,2,34,3,3,34,,,,,9,9
2019-06-10 01:08,URC,5797,737-800,17,5,20,5,4,12,,,,,3,-5
2019-06-10 01:05,TYN,1498,737-800,23,5,25,3,4,25,,,,,2,2
2019-06-10 01:00,XIY,5359,737-800,28,5,32,5,5,30,,,,,4,2
2019-06-10 01:00,HAK,5371,737-800,26,9,36,9,8,35,1,,,1,10,9
2019-06-10 00:58,110,5482,737-800,22,1,29,2,3,30,,,,,7,8
2019-06-10 00:57,´óÁ¬,1787,737-800,17,2,28,2,2,22,,,,,11,5
2019-06-10 00:55,HRB,1480,737-800,19,5,25,5,5,26,,,,,6,7
2019-06-10 00:55,URC,1548,737-800,24,4,25,5,4,20,,,,,1,-4
2019-06-10 00:55,MIG,5449,737-800,25,6,35,6,7,33,1,,,1,10,8
2019-06-10 00:54,SZX,5478,737-800,29,7,37,6,5,34,,,,,8,5
2019-06-10 00:54,SZX,5478,737-800,29,7,37,6,5,34,,,,,8,5
2019-06-10 00:52,URC,205V,737-800,20,5,25,2,4,24,,,,,5,4
2019-06-10 00:52,XIY,1215,737-800,25,4,30,5,5,30,,,,,5,5
2019-06-10 00:51,TYN,5083,737-800,20,2,20,2,2,22,,,,,0,2
2019-06-10 00:47,PEK,1542,737-800,23,3,20,5,5,19,,,,,-3,-4
2019-06-10 00:44,TYN,1728,737-800,25,4,25,6,5,24,,,,,0,-1
2019-06-10 00:43,KMG,7167,737-800,20,6,30,6,6,26,,,,,10,6
2019-06-10 00:41,HRB,7113,737-800,25,5,33,5,5,32,,,,,8,7
2019-06-10 00:40,XIY,1161,737-800,27,4,32,4,3,30,,,,,5,3
2019-06-10 00:38,PEK,1375,737-800,28,4,32,4,3,27,,,,,4,-1
2019-06-10 00:29,CKG,5480,737-800,23,4,31,3,5,30,,,,,8,7
2019-06-10 00:26,URC,5611,737-800,18,5,28,6,6,26,,,,,10,8
2019-06-10 00:25,HAK,5406,737-800,29,6,37,5,4,34,,,,,8,5
2019-06-10 00:24,HRB,1433,737-800,20,3,29,3,3,24,,,,,9,4
2019-06-10 00:22,YIH,1348,737-800,33,6,34,4,4,34,,,,,1,1
2019-06-10 00:15,URC,1568,737-800,20,5,24,6,6,22,,,,,4,2
2019-06-10 00:10,URC,1493,737-800,19,6,22,6,6,22,,,,,3,3
2019-06-10 00:10,PEK,1488,737-800,22,6,28,6,6,26,,,,,6,4
2019-06-10 00:06,SZX,5520,737-800,30,6,36,8,9,37,,,,,6,7
2019-06-10 00:00,XIY,1491,737-800,27,4,30,5,5,30,,,,,3,3
2019-06-09 23:59,CGO,6066,737-800,28,6,31,6,6,30,,,,,3,2
2019-06-09 23:54,SYX,5358,737-800,30,6,34,5,6,33,,,,,4,3
2019-06-09 23:46,CGO,1101,737-800,28,3,32,2,3,30,,,,,4,2
2019-06-09 23:42,HAK,1786,737-800,30,6,34,2,3,36,,,,,4,6
2019-06-09 23:38,CAN,1372,737-800,30,9,36,9,9,37,,,,,6,7
2019-06-09 23:36,URC,1325,737-800,25,6,26,6,6,24,,,,,1,-1
2019-06-09 23:35,PEK,5579,737-800,24,5,30,4,5,26,,,,,6,2
2019-06-09 23:24,DLC,5346,737-800,20,5,28,4,6,26,,,,,8,6
2019-06-09 23:20,XIY,1347,737-800,25,4,32,4,4,30,,,,,7,5
2019-06-09 23:16,CKG,5733,737-800,25,5,28,5,5,28,,,,,3,3
2019-06-09 23:13,DLC,1497,737-800,17,4,28,3,3,28,,,,,11,11
2019-06-09 23:07,HGH,6065,737-800,25,5,27,5,6,27,,,,,2,2
2019-06-09 23:01,HAK,5439,737-800,30,8,36,8,8,36,,,,,6,6
2019-06-09 23:01,CGO,5428,737-800,29,4,26,5,4,30,,,,,-3,1
2019-06-09 23:00,CAN,7616,737-800,30,4,34,5,4,35,,,,,4,5
2019-06-09 22:59,TYN,5418,737-800,25,4,20,4,4,25,,,,,-5,0
2019-06-09 22:58,ZGC,7619,737-800,20,4,22,4,5,20,,,,,2,0
2019-06-09 22:56,XIY,1489,737-800,28,4,29,4,4,30,,,,,1,2
2019-06-09 22:54,DLC,1505,737-800,22,4,22,4,4,24,,,,,0,2
2019-06-09 22:53,TYN,5372,737-800,26,6,25,6,6,24,,,,,-1,-2
2019-06-09 22:51,CTU,7992,737-800,28,7,34,7,7,34,,,,,6,6
2019-06-09 22:46,URC,1569,737-800,20,3,26,3,3,26,,,,,6,6
2019-06-09 22:45,Î÷Äþ,5116,737-800,20,4,20,5,5,20,,,,,0,0
2019-06-09 22:40,CGO,1586,737-800,29,5,29,5,4,28,,,,,0,-1
2019-06-09 22:38,HAK,5082,737-800,29,7,37,7,6,36,,,,,8,7
2019-06-09 22:34,URC,1323,737-800,19,1,32,4,4,24,1,,,1,13,5
2019-06-09 22:32,HAK,7989,737-800,30,8,37,8,8,37,,,,,7,7
2019-06-09 22:28,HAK,1929,737-800,30,5,35,5,4,32,,,,,5,2
2019-06-09 22:24,HAK,7378,737-800,30,6,34,6,5,34,,,,,4,4
2019-06-09 22:23,HAK,5405,737-800,31,8,37,6,5,36,,,,,6,5
2019-06-09 22:18,URC,1796,737-800,21,4,28,4,4,26,,,,,7,5
2019-06-09 22:13,SYX,1729,737-800,30,9,36,9,8,35,,,,,6,5
2019-06-09 22:08,HGH ,5375,737-800,25,2,30,3,3,28,,,,,5,3
2019-06-09 22:05,MIG,5732,737-800,25,4,29,4,5,30,,,,,4,5
2019-06-09 22:03,XIY,7172,737-800,30,4,32,4,5,30,,,,,2,0
2019-06-09 21:17,CGO,1798,737-800,30,5,30,6,6,27,,,,,0,-3
2019-06-09 20:00,HRB,1559,737-800,23,4,30,3,3,26,,,,,7,3
2019-06-09 19:52,FOC,5182,737-800,28,2,34,5,4,34,,,,,6,6
2019-06-09 19:46,URC,2157,737-800,20,4,23,6,3,24,,,,,3,4
2019-06-09 17:24,SZX,7175,737-800,33,5,30,5,5,34,,,,,-3,1
2019-06-09 17:08,ÐìÖÝ,7988,737-800,30,4,36,3,5,34,,,,,6,4
2019-06-09 13:49,HHA,1346,737-800,24,5,30,5,5,30,,,,,6,6
2019-06-09 13:16,SZX,5625,737-800,34,8,36,6,6,36,,,,,2,2
2019-06-09 11:16,XMN,5465,737-800,27,8,30,7,7,30,,,,,3,3
2019-06-09 11:14,XMN,1997,737-800,29,6,28,6,8,29,,,,,-1,0
2019-06-09 11:14,XMN,6103,737-800,27,6,29,6,7,29,,,,,2,2
2019-06-09 10:54,HAK,7105,737-800,36,7,37,5,4,34,,,,,1,-2
2019-06-09 09:41,HAK,206G,737-800,28,4,35,4,3,33,,,,,7,5
2019-06-09 09:17,KMG,7991,737-800,20,4,26,4,4,26,,,,,6,6
2019-06-09 08:53,HAK,1735,737-800,28,3,33,4,4,30,,,,,5,2
2019-06-09 08:52,HAK,7378,737-800,28,6,34,5,5,33,,,,,6,5
2019-06-09 08:49,KMF,1798,737-800,19,7,27,4,4,24,,,,,8,5
2019-06-09 08:01,CGO,6809,737-800,30,5,28,5,6,27,,,,,-2,-3
2019-06-09 07:59,CGO,6015,737-800,30,4,28,4,4,26,,,,,-2,-4
2019-06-09 07:58,PEK,1726,737-800,25,4,36,4,4,29,1,,,1,11,4
2019-06-09 07:29,HHA,5371,737-800,27,9,27,5,5,30,,,,,0,3
2019-06-09 06:40,HHA,5522,737-800,25,5,27,6,6,26,,,,,2,1
2019-06-09 06:39,HHA,5371,737-800,27,10,30,5,5,30,,,,,3,3
2019-06-09 05:35,XIY,5116,737-800,24,4,24,6,4,25,,,,,0,1
2019-06-09 05:24,HGH,5735,737-800,25,4,37,6,5,36,1,1,,11,12,11
2019-06-09 05:20,SZX,1541,737-800,29,7,36,7,8,35,,,,,7,6
2019-06-09 05:19,KMG,7167,737-800,20,6,26,5,5,24,,,,,6,4
2019-06-09 05:15,HHA,1131,737-800,25,4,34,4,4,34,,,,,9,9
2019-06-09 05:12,HGH,7619,737-800,25,6,29,6,5,30,,,,,4,5
2019-06-09 04:41,HAK,1495,737-800,28,8,35,7,5,33,,,,,7,5
2019-06-09 04:34,HAJ,1372,737-800,33,6,36,4,4,36,,,,,3,3
2019-06-09 04:30,CGO,5428,737-800,30,4,28,4,4,26,,,,,-2,-4
2019-06-09 04:30,FOC,5430,737-800,27,6,37,5,5,36,,,×óTCV¡¢×óSTCV,×óTCV¡¢×óSTCV,10,9
2019-06-09 04:20,DLC,5346,737-800,19,4,26,6,6,24,,,,,7,5
2019-06-09 04:18,URC,1493,737-800,24,7,25,6,6,23,,,,,1,-1
2019-06-09 04:11,CAN,5429,737-800,25,2,32,4,4,34,,,,,7,9
2019-06-09 04:10,DLC,5580,737-800,18,3,28,4,3,28,,,,,10,10
2019-06-09 04:09,CKG,5480,737-800,25,5,26,4,3,22,,,,,1,-3
2019-06-09 03:57,KMG,1209,737-800,20,4,30,4,4,31,,,,,10,11
2019-06-09 03:57,KMG,7989,737-800,21,6,30,4,4,32,,,,,9,11
2019-06-09 03:55,FOC,5182,737-800,26,3,30,4,3,32,,,,,4,6
2019-06-09 03:53,FOC,5182,737-800,28,6,37,7,7,36,,,,,9,8
2019-06-09 03:50,HGH,1783,737-800,25,4,32,4,5,32,,,,,7,7
2019-06-09 03:34,URC,5611,737-800,26,6,28,6,6,26,,,,,2,0
2019-06-09 03:33,URC,6995,737-800,25,4,27,6,4,22,,,,,2,-3
2019-06-09 03:33,DLC,7171,737-800,20,5,24,4,5,26,,,,,4,6
2019-06-09 03:32,XIY,1903,737-800,25,2,29,3,2,28,,,,,4,3
2019-06-09 03:32,URC,1995,737-800,24,4,26,6,6,27,,,,,2,3
2019-06-09 03:32,URC,1796,737-800,26,4,24,3,4,23,,,,,-2,-3
2019-06-09 03:30,DLC,5636,737-800,26,5,31,5,5,31,,,,,5,5
2019-06-09 03:29,URC,205V,737-800,25,4,28,3,5,26,,,,,3,1
2019-06-09 03:20,XIY,1481,737-800,25,6,30,6,6,31,,,,,5,6
2019-06-09 03:14,DLC,1795,737-800,19,4,28,4,4,28,,,,,9,9
2019-06-09 03:13,º¼ÖÝ,1929,737-800,25,3,28,2,3,27,,,,,3,2
2019-06-09 03:09,FOC,5483,737-800,27,5,35,5,4,34,,,,,8,7
2019-06-09 03:09,DLC,7171,737-800,20,5,24,4,5,26,,,,,4,6
2019-06-09 03:07,SZX,1491,737-800,25,6,36,6,7,36,,,×óÓÒÉ¢ÈÈÆ÷,×óÓÒÉ¢ÈÈÆ÷,11,11
2019-06-09 03:05,KMG,1587,737-800,21,6,32,5,3,30,,,,,11,9
2019-06-09 03:05,CAN,1549,737-800,29,6,36,5,6,33,,,,,7,4
2019-06-09 03:04,HAK,7616,737-800,26,5,34,2,4,35,,,,,8,9
2019-06-09 03:01,HAK,1793,737-800,30,7,37,5,6,34,,,,,7,4
2019-06-09 03:00,HAK,1786,737-800,29,4,32,4,6,32,,,,,3,3
2019-06-09 03:00,HAK,5540,737-800,29,7,36,6,6,30,,,,,7,1
2019-06-09 02:59,HAK,5855,737-800,29,7,36,6,6,30,,,,,7,1
2019-06-09 02:59,DLC,1386,737-800,19,4,26,5,4,24,,,,,7,5
2019-06-09 02:53,TYN,1498,737-800,21,4,26,4,4,25,,,,,5,4
2019-06-09 02:53,SYX,7400,737-800,30,7,36,6,6,36,,,,,6,6
2019-06-09 02:52,XIY,7172,737-800,26,4,28,5,4,30,,,,,2,4
2019-06-09 02:50,XIY,5503,737-800,26,3,28,3,3,26,,,,,2,0
2019-06-09 02:48,SZX,5625,737-800,30,8,36,6,6,36,,,,,6,6
2019-06-09 02:48,HGH,5418,737-800,25,6,28,4,4,30,,,,,3,5
2019-06-09 02:48,HAK,5082,737-800,30,8,36,6,6,34,,,,,6,4
2019-06-09 02:41,HAK ,5090,737-800,29,6,36,5,5,37,,,,,7,8
2019-06-09 02:39,HAK,1495,737-800,28,10,35,7,5,33,,,,,7,5
2019-06-09 02:38,DLC,1213,737-800,20,5,32,5,5,32,,,,,12,12
2019-06-09 02:35,PEK,5482,737-800,20,1,28,4,3,31,,,,,8,11
2019-06-09 02:35,HHA,5467,737-800,28,3,35,4,4,35,,,,,7,7
2019-06-09 02:34,ÃàÑô,5449,737-800,25,9,37,5,5,30,,,,,12,5
2019-06-09 02:33,SYX,5416,737-800,30,8,36,8,7,36,,,,,6,6
2019-06-09 02:26,SYX,5481,737-800,30,8,37,9,8,36,,,,,7,6
2019-06-09 02:25,XIY,5405,737-800,30,5,34,6,4,30,,,,,4,0
2019-06-09 02:24,ZGC,5141,737-800,20,4,21,4,3,23,,,,,1,3
2019-06-09 02:22,CAN,1502,737-800,29,4,34,4,4,34,,,,,5,5
2019-06-09 02:22,Ì«Ô­,1799,737-800,25,4,20,4,4,18,,,,,-5,-7
2019-06-09 02:20,CGO,6809,737-800,30,5,28,5,6,27,,,,,-2,-3
2019-06-09 02:19,CAN,7639,737-800,26,3,36,4,4,34,,,,,10,8
2019-06-09 02:18,URC,5798,737-800,20,2,22,3,2,22,,,,,2,2
2019-06-09 02:18,YIH,1351,737-800,25,4,28,5,6,32,,,,,3,7
2019-06-09 02:16,SYX,5709,737-800,30,8,37,8,6,36,,,,,7,6
2019-06-09 02:16,YIH,7395,737-800,27,6,30,5,4,29,,,,,3,2
2019-06-09 02:15,XIY,6066,737-800,30,2,26,6,6,30,,,,,-4,0
2019-06-09 02:15,HGH,1488,737-800,25,6,32,6,5,28,,,,,7,3
2019-06-09 02:14,URC,1568,737-800,25,4,23,6,7,26,,,,,-2,1
2019-06-09 02:14,ZGC ,7173,737-800,20,3,23,3,4,19,,,,,3,-1
2019-06-09 02:14,PEK ,1797,737-800,25,4,26,5,5,24,,,,,1,-1
2019-06-09 02:10,DLC,1497,737-800,21,3,28,3,3,26,,,,,7,5
2019-06-09 02:09,XIY,1163,737-800,26,2,36,3,2,32,1,,,1,10,6
2019-06-09 02:08,XIY,1350,737-800,25,4,30,3,4,28,,,,,5,3
2019-06-09 02:04,TYN,5083,737-800,15,3,20,4,4,24,,,,,5,9
2019-06-09 02:03,XIY,1130,737-800,25,2,34,2,2,32,,,,,9,7
2019-06-09 02:01,SZX,5520,737-800,29,5,36,7,7,36,,,,,7,7
2019-06-09 02:01,URC,206P,737-800,20,4,24,2,1,14,,,,,4,-6
2019-06-09 01:59,ZGC,5502,737-800,19,4,22,4,4,20,,,,,3,1
2019-06-09 01:58,CAN,5406,737-800,30,6,35,8,5,31,,,,,5,1
2019-06-09 01:57,SZX,1373,737-800,27,4,36,4,4,32,,,,,9,5
2019-06-09 01:55,HAK,6063,737-800,29,6,34,5,6,35,,,,,5,6
2019-06-09 01:55,URC,5798,737-800,24,2,22,3,2,22,,,,,-2,-2
2019-06-09 01:51,HHA,5375,737-800,25,2,30,6,6,30,,,,,5,5
2019-06-09 01:50,HAK,5521,737-800,28,6,33,7,7,35,,,,,5,7
2019-06-09 01:48,HGH,5713,737-800,26,7,33,7,7,29,,,,,7,3
2019-06-09 01:39,CGO,1586,737-800,29,4,32,4,3,34,,,,,3,5
2019-06-09 01:37,FOC,1906,737-800,25,6,35,7,6,31,,,×óTCV ¡¢×óSTCV,×óTCV ¡¢×óSTCV,10,6
2019-06-09 01:35,TYN,5136,737-800,25,4,22,5,5,28,,,,,-3,3
2019-06-09 01:34,FOC,1562,737-800,25,4,34,4,4,36,,,,,9,11
2019-06-09 01:30,HAK,1787,737-800,29,4,34,6,6,35,,,,,5,6
2019-06-09 01:28,SYX,206F,737-800,29,4,35,4,4,32,,,,,6,3
2019-06-09 01:23,MIG,5732,737-800,25,4,28,3,4,29,,,,,3,4
2019-06-09 01:22,HAK,1728,737-800,26,5,34,5,6,30,,,,,8,4
2019-06-09 01:18,CGO,7990,737-800,27,4,32,4,4,31,,,,,5,4
2019-06-09 01:16,º¼ÖÝ,5638,737-800,25,4,28,3,2,30,,,,,3,5
2019-06-09 01:16,HHA,1496,737-800,28,4,34,4,4,34,,,,,6,6
2019-06-09 01:14,KMG,1208,737-800,21,3,28,3,3,26,,,,,7,5
2019-06-09 01:11,XIY,1162,737-800,26,2,29,4,4,28,,,,,3,2
2019-06-09 01:10,CGO,5408,737-800,29,4,31,3,4,30,,,,,2,1
2019-06-09 01:10,SYX,1101,737-800,29,4,37,3,4,36,,,,,8,7
2019-06-09 01:08,PEK,1542,737-800,27,5,29,5,4,26,,,,,2,-1
2019-06-09 01:07,HRB,1559,737-800,20,3,31,2,3,24,,,,,11,4
2019-06-09 01:07,URC,1548,737-800,25,2,22,2,2,22,,,,,-3,-3
2019-06-09 01:06,URC,205T,737-800,30,2,22,2,2,22,,,,,-8,-8
2019-06-09 01:06,DLC,1347,737-800,21,4,30,4,4,30,,,,,9,9
2019-06-09 01:05,PEK,5372,737-800,25,8,28,8,8,28,,,,,3,3
2019-06-09 01:03,DLC,1547,737-800,21,6,30,6,6,30,,,,,9,9
2019-06-09 01:02,CAN,5852,737-800,26,4,36,4,5,35,1,,,1,10,9
2019-06-09 00:58,HAK,1372,737-800,34,6,36,4,4,36,,,,,2,2
2019-06-09 00:55,FOC,1435,737-800,26,6,36,6,6,32,,,,,10,6
2019-06-09 00:54,XIY,1483,737-800,23,6,28,6,6,28,,,,,5,5
2019-06-09 00:52,CKG,5733,737-800,25,6,30,7,6,30,,,,,5,5
2019-06-09 00:49,HAK,5439,737-800,29,8,36,8,8,36,,,,,7,7
2019-06-09 00:46,HRB,1480,737-800,18,4,24,4,4,26,,,,,6,8
2019-06-09 00:46,PEK,1996,737-800,23,3,18,3,4,20,,,,,-5,-3
2019-06-09 00:45,PEK ,5539,737-800,26,4,27,4,4,26,,,,,1,0
2019-06-09 00:44,HHA,1503,737-800,25,2,27,4,3,22,,,,,2,-3
2019-06-09 00:42,XIY,5359,737-800,27,4,30,4,4,30,,,,,3,3
2019-06-09 00:40,XIY,6808,737-800,25,3,34,4,4,30,,,,,9,5
2019-06-09 00:36,PEK,5482,737-800,20,1,28,4,3,31,,,,,8,11
2019-06-09 00:32,CAN,5479,737-800,30,8,36,7,8,36,,,,,6,6
2019-06-09 00:31,CGO,5408,737-800,29,31,4,30,3,4,,,,,-25,-25
2019-06-09 00:27,TYN,1103,737-800,20,4,28,4,4,28,,,,,8,8
2019-06-09 00:26,URC,1569,737-800,29,4,26,3,3,20,,,,,-3,-9
2019-06-09 00:26,PEK,5338,737-800,25,4,26,4,5,27,,,,,1,2
2019-06-09 00:06,URC,5637,737-800,25,2,24,3,2,22,,,,,-1,-3
2019-06-09 00:06,YIH,1348,737-800,30,6,35,5,4,30,,,,,5,0
2019-06-09 00:05,SZX,1490,737-800,29,3,34,5,6,34,,,,,5,5
2019-06-09 00:04,SZX,5712,737-800,29,3,36,3,2,34,,,,,7,5
2019-06-09 00:03,HAK,7175,737-800,28,5,28,6,5,32,,,,,0,4
2019-06-08 23:54,HRB,1433,737-800,18,3,26,4,3,25,,,,,8,7
2019-06-08 23:53,HRB,7113,737-800,20,4,28,6,5,29,,,,,8,9
2019-06-08 23:51,KMG,7988,737-800,23,3,28,5,4,28,,,,,5,5
2019-06-08 23:41,CGO,1570,737-800,30,4,28,4,4,26,,,,,-2,-4
2019-06-08 23:39,XIY,1489,737-800,27,4,28,4,4,29,,,,,1,2
2019-06-08 23:39,MIG,6016,737-800,25,6,35,5,6,34,,,,,10,9
2019-06-08 23:37,HGH,1102,737-800,26,3,36,4,4,35,1,,,1,10,9
2019-06-08 23:31,CTU,7992,737-800,26,6,30,7,7,31,,,,,4,5
2019-06-08 23:28,HAK,1785,737-800,29,2,36,7,6,36,,,,,7,7
2019-06-08 23:27,XIY,1215,737-800,28,2,26,4,4,28,,,,,-2,0
2019-06-08 23:27,HAK,1785,737-800,29,2,36,7,6,36,,,,,7,7
2019-06-08 23:25,CKG,7377,737-800,22,5,29,6,5,30,,,,,7,8
2019-06-08 23:24,TYN,5478,737-800,25,4,26,4,4,24,,,,,1,-1
2019-06-08 23:20,SYX,5358,737-800,31,8,36,6,6,34,,,,,5,3
2019-06-08 23:11,CAN,1538,737-800,30,4,36,2,2,34,,,,,6,4
2019-06-08 23:03,PEK,1505,737-800,24,4,22,4,4,26,,,,,-2,2
2019-06-08 22:52,URC,7399,737-800,27,4,26,4,5,25,,,,,-1,-2
2019-06-08 22:45,CAN,1927,737-800,30,7,31,8,3,30,,,,,1,0
2019-06-08 22:44,CAN,1501,737-800,26,4,35,4,4,36,,,,,9,10
2019-06-08 22:31,URC,205T,737-800,20,4,24,2,3,22,,,,,4,2
2019-06-08 22:27,ZGC,5417,737-800,20,3,21,5,4,23,,,,,1,3
2019-06-08 22:27,Ì«Ô­,1733,737-800,25,4,26,3,3,23,,,,,1,-2
2019-06-08 22:23,HAK,206H,737-800,30,4,36,3,3,34,,,,,6,4
2019-06-08 22:17,XNN,1545,737-800,21,5,27,5,5,28,,,,,6,7
2019-06-08 22:16,SYX,1729,737-800,30,8,37,6,6,36,,,,,7,6
2019-06-08 22:15,ÃàÑô,7993,737-800,26,6,32,6,6,30,,,,,6,4
2019-06-08 22:07,CAN,7618,737-800,30,4,34,7,6,35,,,,,4,5
2019-06-08 22:06,XUZ,6800,737-800,24,4,32,4,4,28,,,,,8,4
2019-06-08 21:56,HAK,5462,737-800,29,6,34,6,6,34,,,,,5,5
2019-06-08 21:50,Î÷Äþ,7398,737-800,21,5,26,4,3,28,,,,,5,7
2019-06-08 21:40,PEK,5579,737-800,28,6,28,6,6,28,,,,,0,0
2019-06-08 21:21,URC,2159,737-800,30,2,22,4,4,28,,,,,-8,-2
2019-06-08 21:20,XIY,5687,737-800,30,4,26,4,5,30,,,,,-4,0
2019-06-08 19:59,HAK,7886,737-800,31,4,37,4,4,37,,,,,6,6
2019-06-08 19:27,FOC,1905,737-800,26,4,32,4,4,30,,,,,6,4
2019-06-08 19:04,URC,205U,737-800,29,4,37,4,5,28,,,,,8,-1
2019-06-08 18:32,CGO,1141,737-800,35,5,32,6,6,31,,,,,-3,-4
2019-06-08 17:50,URC,1323,737-800,30,3,29,4,4,31,,,,,-1,1
2019-06-08 15:55,PEK,7379,737-800,35,4,28,6,6,26,,,,,-7,-9
2019-06-08 14:29,CTU,7992,737-800,26,7,34,7,7,34,,,,,8,8
2019-06-08 13:34,PEK,1725,737-800,35,8,36,4,5,32,,,,,1,-3
2019-06-08 11:59,CTU,7992,737-800,26,34,7,7,7,34,,,,,-19,8
2019-06-08 11:00,XMN,1375,737-800,28,8,36,5,4,32,,,,,8,4
2019-06-08 11:00,XMN,7173,737-800,25,2,25,6,4,30,,,,,0,5
2019-06-08 10:59,XMN,5338,737-800,25,6,28,4,6,28,,,,,3,3
2019-06-08 10:59,XMN,5686,737-800,25,6,35,4,2,35,,,,,10,10
2019-06-08 08:53,HAK,6060,737-800,28,5,36,4,6,34,,,,,8,6
2019-06-08 08:30,HAK,1728,737-800,29,4,34,4,4,30,,,,,5,1
2019-06-08 08:24,XIY,1489,737-800,25,4,29,4,3,29,,,,,4,4
2019-06-08 08:23,XIY,5116,737-800,27,4,26,3,4,28,,,,,-1,1
2019-06-08 08:20,HAK,5439,737-800,29,8,38,7,7,37,,,,,9,8
2019-06-08 07:40,FOC,5430,737-800,27,5,36,5,5,35,,,,,9,8
2019-06-08 07:24,SZX,1541,737-800,28,7,35,6,7,34,,,,,7,6
2019-06-08 07:13,DLC,1795,737-800,22,3,25,4,4,30,,,,,3,8
2019-06-08 07:12,DLC,1797,737-800,23,4,24,4,6,26,,,,,1,3
2019-06-08 07:09,DLC,5580,737-800,20,4,26,4,3,28,,,,,6,8
2019-06-08 07:04,DLC,1103,737-800,21,4,28,3,4,27,,,,,7,6
2019-06-08 06:58,DLC,5636,737-800,22,3,30,4,5,29,,,,,8,7
2019-06-08 06:40,XIY,1483,737-800,25,7,27,6,5,25,,,,,2,0
2019-06-08 06:29,PEK,5463,737-800,25,4,28,4,4,26,,,,,3,1
2019-06-08 06:28,HAK,5540,737-800,28,6,36,6,5,33,,,,,8,5
2019-06-08 06:25,XIY,1162,737-800,25,3,28,2,3,28,,,,,3,3
2019-06-08 06:24,PEK,1372,737-800,25,4,34,4,4,34,,,,,9,9
2019-06-08 06:22,KMG,7989,737-800,20,5,31,5,6,31,,,,,11,11
2019-06-08 05:55,CGO,6015,737-800,23,4,30,4,4,26,,,,,7,3
2019-06-08 05:54,CGO,1798,737-800,29,6,33,6,6,28,,,,,4,-1
2019-06-08 05:52,ZGC,5417,737-800,20,7,21,6,7,22,,,,,1,2
2019-06-08 05:51,URC,5797,737-800,20,6,19,6,6,0,,,,,-1,-20
2019-06-08 05:50,ZGC,5502,737-800,20,6,20,7,8,22,,,,,0,2
2019-06-08 05:45,ZGC,6103,737-800,17,7,25,6,8,24,,,,,8,7
2019-06-08 05:45,ZGC,6103,737-800,17,7,25,6,8,24,,,,,8,7
2019-06-08 05:45,ZGC,6103,737-800,17,7,25,6,8,24,,,,,8,7
2019-06-08 05:44,CAN,1101,737-800,26,2,37,2,2,37,1,1,,11,11,11
2019-06-08 05:41,ZGC,5709,737-800,20,6,22,7,8,20,,,,,2,0
2019-06-08 05:41,PEK,5539,737-800,22,5,32,5,6,36,,1,,1,10,14
2019-06-08 05:32,XIY,1130,737-800,20,2,30,2,2,28,,,,,10,8
2019-06-08 04:54,FOC,1562,737-800,25,10,36,8,8,32,1,1,,11,11,7
2019-06-08 04:51,PEK,5372,737-800,22,6,30,6,5,30,,,,,8,8
2019-06-08 04:42,HAK,1785,737-800,28,8,36,9,8,37,,,,,8,9
2019-06-08 04:39,HAK,5520,737-800,25,3,34,5,5,34,,,,,9,9
2019-06-08 04:38,HGH,1929,737-800,26,4,30,4,4,29,,,,,4,3
2019-06-08 04:33,CAN,5852,737-800,28,6,34,6,6,34,,,,,6,6
2019-06-08 04:33,PEK,5538,737-800,25,6,28,4,6,30,,,,,3,5
2019-06-08 04:29,KMG,1208,737-800,22,3,29,4,4,28,,,,,7,6
2019-06-08 04:28,KMG,1586,737-800,22,3,29,4,4,28,,,,,7,6
2019-06-08 04:01,URC,2159,737-800,20,2,20,2,2,26,,,,,0,6
2019-06-08 04:00,URC,1542,737-800,24,4,28,3,3,24,,,,,4,0
2019-06-08 03:59,XIY,5503,737-800,28,4,28,4,4,26,,,,,0,-2
2019-06-08 03:58,HAK,5136,737-800,30,6,32,6,5,30,,,,,2,0
2019-06-08 03:56,YIH,1348,737-800,30,4,32,5,6,32,,,,,2,2
2019-06-08 03:50,FOC,1131,737-800,25,5,35,5,4,37,1,1,,11,10,12
2019-06-08 03:49,FOC,1131,737-800,25,5,35,5,4,39,,,,,10,14
2019-06-08 03:44,YIH,1351,737-800,33,6,35,6,5,36,,,,,2,3
2019-06-08 03:39,HAK,5479,737-800,29,9,37,8,8,36,,,,,8,7
2019-06-08 03:38,DLC,1213,737-800,24,4,30,4,4,28,,,,,6,4
2019-06-08 03:35,DLC,5579,737-800,24,4,28,4,4,28,,,,,4,4
2019-06-08 03:33,HHA,1346,737-800,30,4,32,4,4,30,,,,,2,0
2019-06-08 03:28,TYN,5083,737-800,20,3,18,5,5,20,,,,,-2,0
2019-06-08 03:25,FOC,7105,737-800,25,3,35,3,3,34,,,,,10,9
2019-06-08 03:24,HGH,1733,737-800,24,4,30,3,3,26,,,,,6,2
2019-06-08 03:23,HGH,5418,737-800,30,4,28,4,4,26,,,,,-2,-4
2019-06-08 03:21,º£¿Ú,5638,737-800,28,4,34,5,5,37,,,,,6,9
2019-06-08 03:14,CKG,1783,737-800,30,3,32,4,4,34,,,,,2,4
2019-06-08 03:12,CAN,1502,737-800,28,3,35,4,4,34,,,,,7,6
2019-06-08 03:12,SYX,5406,737-800,29,6,36,8,6,33,,,,,7,4
2019-06-08 03:09,PEK,7398,737-800,22,4,29,6,7,27,,,,,7,5
2019-06-08 03:00,HHA,5625,737-800,26,6,36,4,5,33,1,,,1,10,7
2019-06-08 02:55,TYN ,5478,737-800,20,4,28,4,4,26,,,,,8,6
2019-06-08 02:51,HHA,1496,737-800,25,6,34,6,6,34,,,,,9,9
2019-06-08 02:51,HGH,7619,737-800,26,6,28,6,5,29,,,,,2,3
2019-06-08 02:47,HHA,1495,737-800,24,5,34,4,4,34,,,,,10,10
2019-06-08 02:45,CAN,5466,737-800,28,2,20,8,6,29,,,,,-8,1
2019-06-08 02:44,URC,205V,737-800,22,4,27,4,5,24,,,,,5,2
2019-06-08 02:41,HET,7171,737-800,16,4,22,4,4,23,,,,,6,7
2019-06-08 02:27,KMG,6800,737-800,20,3,24,5,4,24,,,,,4,4
2019-06-08 02:23,HGH,5141,737-800,30,5,30,7,7,31,,,,,0,1
2019-06-08 02:23,XIY,1902,737-800,23,5,31,5,5,22,,,,,8,-1
2019-06-08 02:17,SYX,1729,737-800,30,8,34,6,6,32,,,,,4,2
2019-06-08 02:16,XIY,7172,737-800,23,4,30,4,4,28,,,,,7,5
2019-06-08 02:15,URC,205T,737-800,21,2,29,3,2,29,,,,,8,8
2019-06-08 02:12,SYX,5416,737-800,29,8,36,8,7,35,,,,,7,6
2019-06-08 02:09,SZX,1786,737-800,29,4,34,4,4,32,,,,,5,3
2019-06-08 02:08,HGH,5713,737-800,25,4,34,5,5,34,,,,,9,9
2019-06-08 02:07,SZX,1493,737-800,30,6,32,7,6,30,,,,,2,0
2019-06-08 02:05,HAK,1347,737-800,30,6,36,4,4,36,,,,,6,6
2019-06-08 02:05,HHA,1996,737-800,27,5,28,5,5,30,,,,,1,3
2019-06-08 02:03,KMG,5409,737-800,19,4,24,4,4,26,,,,,5,7
2019-06-08 02:01,SYX,7377,737-800,30,7,35,7,6,34,,,,,5,4
2019-06-08 02:01,FOC,1905,737-800,26,4,31,4,4,28,,,,,5,2
2019-06-08 01:59,DLC,1386,737-800,22,3,28,4,3,30,,,,,6,8
2019-06-08 01:57,KMG,7167,737-800,20,5,30,6,5,26,,,,,10,6
2019-06-08 01:54,CGO,7990,737-800,28,3,28,3,3,24,,,,,0,-4
2019-06-08 01:51,KMG,7991,737-800,20,5,27,6,6,28,,,,,7,8
2019-06-08 01:49,XIY,1161,737-800,25,4,24,3,4,22,,,,,-1,-3
2019-06-08 01:47,XIY,1163,737-800,25,2,34,2,2,26,,,,,9,1
2019-06-08 01:44,URC,5798,737-800,20,2,26,2,2,23,,,,,6,3
2019-06-08 01:44,URC,5623,737-800,20,4,27,3,4,26,,,,,7,6
2019-06-08 01:42,HAK,1490,737-800,30,6,36,8,6,36,,,,,6,6
2019-06-08 01:39,MIG,7993,737-800,24,4,32,6,6,28,,,,,8,4
2019-06-08 01:38,XIY,1350,737-800,25,6,26,6,7,25,,,,,1,0
2019-06-08 01:32,SZX,1102,737-800,29,3,34,5,5,35,,,,,5,6
2019-06-08 01:28,HGH,7886,737-800,24,4,33,3,3,32,,,,,9,8
2019-06-08 01:25,PEK,1927,737-800,25,4,27,3,4,28,,,,,2,3
2019-06-08 01:19,CAN,6065,737-800,30,4,36,4,4,36,,,,,6,6
2019-06-08 01:09,HAK,5090,737-800,30,4,36,5,5,35,,,,,6,5
2019-06-08 01:09,HAK,1793,737-800,28,6,37,5,5,36,,,,,9,8
2019-06-08 01:09,URC,7399,737-800,23,4,27,4,3,26,,,,,4,3
2019-06-08 01:08,XIY,6808,737-800,28,5,30,6,6,27,,,,,2,-1
2019-06-08 01:06,SYX,5428,737-800,29,6,34,8,6,36,,,,,5,7
2019-06-08 01:04,CKG,1492,737-800,30,4,31,3,4,30,,,,,1,0
2019-06-08 01:03,HAK,7378,737-800,29,6,35,6,5,34,,,,,6,5
2019-06-08 01:02,MIG,1587,737-800,30,8,35,4,3,34,,,,,5,4
2019-06-08 01:02,HRB,7113,737-800,23,6,31,5,5,30,,,,,8,7
2019-06-08 00:56,HRB,1480,737-800,23,5,24,5,4,24,,,,,1,1
2019-06-08 00:46,FOC,1435,737-800,28,8,32,4,4,28,,,,,4,0
2019-06-08 00:43,HAK,6063,737-800,28,6,35,6,6,34,,,,,7,6
2019-06-08 00:42,TYN,1547,737-800,20,4,26,4,5,24,,,,,6,4
2019-06-08 00:41,PEK,1997,737-800,25,6,29,4,4,28,,,,,4,3
2019-06-08 00:40,SZX,5712,737-800,29,4,36,2,2,34,,,,,7,5
2019-06-08 00:38,HHA,5522,737-800,26,5,33,8,8,36,,1,,1,7,10
2019-06-08 00:38,CGO,205U,737-800,25,5,30,5,5,30,,,,,5,5
2019-06-08 00:37,YIH,7395,737-800,32,6,34,6,6,30,,,,,2,-2
2019-06-08 00:37,CAN,1787,737-800,30,2,34,6,6,36,,,,,4,6
2019-06-08 00:34,SYX,1488,737-800,29,6,34,6,6,30,,,,,5,1
2019-06-08 00:32,TYN,1799,737-800,22,5,29,6,5,29,,,,,7,7
2019-06-08 00:32,SZX,5687,737-800,30,6,35,5,4,35,,,,,5,5
2019-06-08 00:21,XIY,5359,737-800,25,4,28,5,5,30,,,,,3,5
2019-06-08 00:18,SYX,1498,737-800,29,4,35,4,4,33,,,,,6,4
2019-06-08 00:18,CGO,5481,737-800,27,4,30,4,5,30,,,,,3,3
2019-06-08 00:18,XIY,1497,737-800,27,4,30,2,2,30,,,,,3,3
2019-06-08 00:18,XIY,1497,737-800,27,4,30,2,2,30,,,,,3,3
2019-06-08 00:17,MIG,6016,737-800,28,8,34,4,4,34,,,,,6,6
2019-06-08 00:08,URC,1796,737-800,25,5,28,4,4,26,,,,,3,1
2019-06-08 00:02,HAK,206G,737-800,25,3,35,3,3,30,,,,,10,5
2019-06-08 00:02,XIY,5405,737-800,25,5,33,5,5,32,,,,,8,7
2019-06-07 23:58,CAN,1549,737-800,28,5,35,5,6,32,,,,,7,4
2019-06-07 23:57,HAK,1501,737-800,28,7,34,7,8,30,,,,,6,2
2019-06-07 23:57,URC,1570,737-800,22,5,25,5,5,24,,,,,3,2
2019-06-07 23:51,URC,5637,737-800,21,2,25,2,1,22,,,,,4,1
2019-06-07 23:35,HAK,5082,737-800,29,6,37,5,5,35,,,,,8,6
2019-06-07 23:34,HAK,5429,737-800,29,4,33,6,5,34,,,,,4,5
2019-06-07 23:34,CKG,5480,737-800,26,8,22,4,8,28,,,,,-4,2
2019-06-07 23:33,PEK,1995,737-800,26,5,31,6,5,32,,,,,5,6
2019-06-07 23:32,KMG,7988,737-800,22,5,28,6,5,27,,,,,6,5
2019-06-07 23:29,PEK,1215,737-800,25,4,32,4,4,32,,,,,7,7
2019-06-07 23:27,PEK,7379,737-800,26,4,30,4,4,32,,,,,4,6
2019-06-07 23:25,CGO,5408,737-800,30,3,27,4,5,27,,,,,-3,-3
2019-06-07 23:21,HHA,5371,737-800,25,8,30,6,6,32,,,,,5,7
2019-06-07 23:15,SYX,5358,737-800,30,6,34,4,3,30,,,,,4,0
2019-06-07 23:08,CGO,5481,737-800,27,4,30,4,5,30,,,,,3,3
2019-06-07 23:02,URC,5465,737-800,20,3,27,2,3,29,,,,,7,9
2019-06-07 22:59,SZX,1491,737-800,32,6,36,6,6,36,,,,,4,4
2019-06-07 22:49,HAK,206H,737-800,29,3,35,2,2,34,,,,,6,5
2019-06-07 22:48,CAN,1538,737-800,30,6,36,4,4,36,,,,,6,6
2019-06-07 22:41,CGO,6066,737-800,28,6,28,4,4,28,,,,,0,0
2019-06-07 22:33,Î÷Äþ,1505,737-800,21,4,20,4,4,22,,,,,-1,1
2019-06-07 22:32,TYN,5855,737-800,20,7,30,6,8,24,,,,,10,4
2019-06-07 22:29,CGO,6066,737-800,28,6,28,4,4,28,,,,,0,0
2019-06-07 22:27,URC,1325,737-800,22,3,21,2,3,22,,,,,-1,0
2019-06-07 22:24,HGH,5735,737-800,25,4,34,5,5,34,,,,,9,9
2019-06-07 22:22,XIY,5337,737-800,23,5,34,5,5,34,,,,,11,11
2019-06-07 22:18,URC,1548,737-800,20,3,24,4,4,24,,,,,4,4
2019-06-07 22:13,HGH,5611,737-800,30,6,32,6,6,30,,,,,2,0
2019-06-07 22:09,PEK,5662,737-800,27,3,30,4,7,29,,,,,3,2
2019-06-07 22:02,XIY,1735,737-800,28,6,30,5,6,27,,,,,2,-1
2019-06-07 22:00,HGH,5521,737-800,28,4,28,4,4,26,,,,,0,-2
2019-06-07 21:59,CGO,1928,737-800,29,4,24,5,5,26,,,,,-5,-3
2019-06-07 21:45,CAN,7639,737-800,31,6,36,7,6,34,,,,,5,3
2019-06-07 21:44,HAK,5462,737-800,28,4,33,2,3,35,,,,,5,7
2019-06-07 21:42,URC,1569,737-800,24,2,30,2,2,27,,,,,6,3
2019-06-07 21:41,Î÷Äþ,1545,737-800,21,5,28,6,6,26,,,,,7,5
2019-06-07 21:35,URC,1323,737-800,24,2,29,3,3,27,,,,,5,3
2019-06-07 21:31,CGO,6809,737-800,28,5,29,6,6,28,,,,,1,0
2019-06-07 21:26,TYN,5137,737-800,20,2,16,2,2,20,,,,,-4,0
2019-06-07 21:15,TYN,1487,737-800,20,2,28,2,4,28,,,,,8,8
2019-06-07 20:30,HRB,1559,737-800,25,3,32,2,3,28,,,,,7,3
2019-06-07 20:14,FOC,1906,737-800,29,7,36,7,7,35,,,,,7,6
2019-06-07 19:47,FOC,5430,737-800,28,5,40,5,4,38,,,,,12,10
2019-06-07 19:45,FOC,5182,737-800,28,7,37,6,6,36,,,,,9,8
2019-06-07 19:06,Î÷°²,5180,737-800,35,8,35,6,4,30,,,,,0,-5
2019-06-07 18:12,FOC,1905,737-800,28,5,36,5,4,35,,,,,8,7
2019-06-07 17:42,ÐìÖÝ,1209,737-800,30,3,36,3,4,37,,,,,6,7
2019-06-07 17:23,HAK,1322,737-800,35,9,39,6,5,34,,,,,4,-1
2019-06-07 16:50,CAN,7175,737-800,34,7,33,7,7,31,,,,,-1,-3
2019-06-07 16:12,CAN,7379,737-800,35,4,36,4,5,36,,,,,1,1
2019-06-07 15:57,Î÷°²,5115,737-800,32,3,22,6,6,8,,,,,-10,-24
2019-06-07 15:41,FOC,1906,737-800,28,10,40,11,11,44,1,1,,11,12,16
2019-06-07 12:10,URC,6268,737-800,23,4,30,4,4,28,,,,,7,5
2019-06-07 09:44,XMN,6103,737-800,24,5,35,6,7,36,1,1,,11,11,12
2019-06-07 09:44,XMN,7173,737-800,27,4,30,4,3,31,,,,,3,4
2019-06-07 09:44,XMN,5522,737-800,28,5,30,6,8,35,,,,,2,7
2019-06-07 09:43,XMN,1997,737-800,27,5,34,6,5,30,,,,,7,3
2019-06-07 09:10,XIY,1162,737-800,20,3,30,3,3,29,,,,,10,9
2019-06-07 08:50,CAN,1928,737-800,27,5,30,7,6,32,,,,,3,5
2019-06-07 08:49,CAN,1728,737-800,28,4,36,6,6,36,,,,,8,8
2019-06-07 08:36,PEK,7398,737-800,24,5,32,5,4,32,,,,,8,8
2019-06-07 08:05,CKG,5481,737-800,25,8,31,8,7,31,,,,,6,6
2019-06-07 07:29,TYN,1103,737-800,25,4,30,4,4,28,,,,,5,3
2019-06-07 07:26,CKG,5735,737-800,25,4,32,0,0,0,,,,,7,-25
2019-06-07 07:14,HAK,7988,737-800,28,4,32,4,5,35,,,,,4,7
2019-06-07 07:09,CAN,1488,737-800,27,4,32,4,4,33,,,,,5,6
2019-06-07 07:09,PEK,1372,737-800,21,4,28,6,4,26,,,,,7,5
2019-06-07 07:05,URC,206P,737-800,30,4,26,5,4,25,,,,,-4,-5
2019-06-07 06:47,CAN,5638,737-800,28,4,36,6,6,37,,,,,8,9
2019-06-07 06:43,KMG,6016,737-800,20,6,30,4,4,28,,,,,10,8
2019-06-07 06:43,FOC,1906,737-800,27,6,36,8,8,36,,,,,9,9
2019-06-07 06:18,HAK,1793,737-800,27,6,36,6,5,36,,,,,9,9
2019-06-07 05:58,KMG,7167,737-800,20,6,28,5,5,25,,,,,8,5
2019-06-07 05:57,KMG,7989,737-800,20,7,28,5,5,28,,,,,8,8
2019-06-07 05:48,XIY,1902,737-800,25,4,32,6,6,28,,,,,7,3
2019-06-07 05:47,XIY ,5135,737-800,25,3,26,4,5,24,,,,,1,-1
2019-06-07 05:46,PEK,5463,737-800,22,5,26,5,4,25,,,,,4,3
2019-06-07 05:24,FOC,1435,737-800,28,5,35,6,5,31,,,,,7,3
2019-06-07 05:20,CAN,6065,737-800,28,5,37,5,5,37,,,,,9,9
2019-06-07 05:19,HGH,5521,737-800,28,4,28,2,2,24,,,,,0,-4
2019-06-07 05:14,XIY,5503,737-800,19,4,28,4,4,26,,,,,9,7
2019-06-07 05:10,KMG,1586,737-800,20,3,28,4,3,22,,,,,8,2
2019-06-07 05:05,URC,5798,737-800,20,2,26,2,3,23,,,,,6,3
2019-06-07 04:58,HAK,1497,737-800,28,6,34,5,5,34,,,,,6,6
2019-06-07 04:45,HHA,5625,737-800,25,7,31,4,3,30,,,,,6,5
2019-06-07 04:39,HAK,5373,737-800,28,6,33,8,8,35,,,,,5,7
2019-06-07 04:35,FOC,1905,737-800,27,4,34,4,4,31,,,,,7,4
2019-06-07 04:23,PEK,1542,737-800,23,4,30,3,3,27,,,,,7,4
2019-06-07 04:17,URC,5797,737-800,23,4,20,6,4,26,,,,,-3,3
2019-06-07 04:08,DLC,1929,737-800,20,4,25,4,5,24,,,,,5,4
2019-06-07 04:07,DLC,5439,737-800,20,3,27,4,5,25,,,,,7,5
2019-06-07 04:04,HHA,6060,737-800,26,6,34,5,5,32,,,,,8,6
2019-06-07 03:56,HAK,5090,737-800,30,7,37,7,8,37,,,,,7,7
2019-06-07 03:55,HHA,1796,737-800,28,6,36,4,4,34,,,,,8,6
2019-06-07 03:52,HAK,1785,737-800,28,8,36,8,8,37,,,,,8,9
2019-06-07 03:49,URC,1323,737-800,24,3,32,3,4,27,,,,,8,3
2019-06-07 03:48,´óÁ¬,7172,737-800,20,4,28,4,4,26,,,,,8,6
2019-06-07 03:42,104,5346,737-800,22,4,30,4,3,28,,,,,8,6
2019-06-07 03:41,PEK,5539,737-800,22,8,35,5,5,30,1,,,1,13,8
2019-06-07 03:33,SZX,5712,737-800,29,4,36,2,2,31,,,,,7,2
2019-06-07 03:26,HAK,206G,737-800,29,3,35,4,4,35,,,,,6,6
2019-06-07 03:26,PEK,5337,737-800,21,4,28,4,4,28,,,,,7,7
2019-06-07 03:22,HAK,1490,737-800,30,5,34,6,5,36,,,,,4,6
2019-06-07 03:22,URC,7198,737-800,24,4,22,5,6,24,,,,,-2,0
2019-06-07 03:20,HAK,5141,737-800,31,7,36,8,9,36,,,,,5,5
2019-06-07 03:20,DLC,5580,737-800,16,3,27,3,3,28,,,,,11,12
2019-06-07 03:17,URC,5611,737-800,23,6,27,5,5,26,,,,,4,3
2019-06-07 03:14,XMN,1997,737-800,27,5,34,6,5,30,,,,,7,3
2019-06-07 03:13,XMN,6103,737-800,24,5,35,6,7,36,,,,,11,12
2019-06-07 03:11,HGH,5520,737-800,25,5,34,5,6,30,,,,,9,5
2019-06-07 03:09,SHA,5483,737-800,24,4,30,5,5,26,,,,,6,2
2019-06-07 03:07,PEK,1131,737-800,22,5,34,5,4,36,,1,,1,12,14
2019-06-07 03:07,FOC,1562,737-800,28,6,32,6,4,32,,,,,4,4
2019-06-07 03:07,ZGC,5709,737-800,20,6,20,7,6,22,,,,,0,2
2019-06-07 03:07,XMN,5522,737-800,28,5,30,6,8,35,,,,,2,7
2019-06-07 03:06,XMN,7173,737-800,29,4,30,4,3,31,,,,,1,2
2019-06-07 03:05,ZGC,5417,737-800,20,6,20,5,6,22,,,,,0,2
2019-06-07 03:04,FOC,5430,737-800,30,6,36,6,6,36,,,,,6,6
2019-06-07 03:03,FOC,5430,737-800,30,6,38,6,6,37,,,,,8,7
2019-06-07 02:58,CGO,7991,737-800,24,4,28,4,4,27,,,,,4,3
2019-06-07 02:58,ZGC,5686,737-800,12,6,20,5,6,22,,,,,8,10
2019-06-07 02:57,CGO,6809,737-800,26,3,28,6,6,29,,,,,2,3
2019-06-07 02:56,HHA,1375,737-800,25,5,34,3,4,32,,,,,9,7
2019-06-07 02:54,KMG,1209,737-800,20,4,34,3,3,32,,,,,14,12
2019-06-07 02:52,URC,2159,737-800,20,3,23,3,3,27,,,,,3,7
2019-06-07 02:51,MIG,7993,737-800,30,4,32,6,8,32,,,,,2,2
2019-06-07 02:48,URC,5465,737-800,23,3,28,8,9,24,,,,,5,1
2019-06-07 02:46,SZX,1493,737-800,28,6,33,7,6,31,,,,,5,3
2019-06-07 02:45,XIY,1482,737-800,20,2,26,2,4,28,,,,,6,8
2019-06-07 02:44,XUZ,6800,737-800,23,4,28,4,4,26,,,,,5,3
2019-06-07 02:43,SZX,1541,737-800,29,7,37,7,7,37,,,,,8,8
2019-06-07 02:43,HHA,1346,737-800,25,6,34,4,5,30,,,,,9,5
2019-06-07 02:42,XIY,1735,737-800,30,4,26,3,3,24,,,,,-4,-6
2019-06-07 02:39,SYX,1729,737-800,30,8,35,7,6,34,,,,,5,4
2019-06-07 02:38,SYX ,5358,737-800,30,6,36,5,5,36,,,,,6,6
2019-06-07 02:38,URC,1570,737-800,24,5,26,5,6,24,,,,,2,0
2019-06-07 02:37,CAN,7378,737-800,25,6,32,7,8,34,,,,,7,9
2019-06-07 02:32,HGH,5713,737-800,26,6,32,6,6,28,,,,,6,2
2019-06-07 02:26,24,7639,737-800,28,6,36,6,6,36,,,,,8,8
2019-06-07 02:20,SYX,5428,737-800,30,6,36,6,6,36,,,,,6,6
2019-06-07 02:20,URC,5637,737-800,20,2,28,2,2,26,,,,,8,6
2019-06-07 02:19,URC,6995,737-800,23,3,30,5,4,27,,,,,7,4
2019-06-07 02:19,HAK,5855,737-800,29,7,36,7,6,31,,,,,7,2
2019-06-07 02:10,URC,1322,737-800,23,4,30,4,4,27,,,,,7,4
2019-06-07 02:10,HAK,5466,737-800,28,4,20,3,3,20,,,,,-8,-8
2019-06-07 02:03,URC,7399,737-800,23,4,24,4,4,24,,,,,1,1
2019-06-07 02:02,XIY,5180,737-800,25,6,32,6,5,30,,,,,7,5
2019-06-07 01:59,SYX,7377,737-800,30,8,34,8,6,34,,,,,4,4
2019-06-07 01:57,KMG,1798,737-800,21,6,28,6,6,24,,,,,7,3
2019-06-07 01:56,´óÁ¬,7400,737-800,16,6,28,4,4,26,,,,,12,10
2019-06-07 01:56,´óÁ¬,7400,737-800,16,6,28,4,4,26,,,,,12,10
2019-06-07 01:52,HAK,1538,737-800,29,6,36,4,3,36,,,,,7,7
2019-06-07 01:42,SZX,5462,737-800,29,4,36,7,7,36,,,,,7,7
2019-06-07 01:41,HAK,5418,737-800,28,8,34,5,4,33,,,,,6,5
2019-06-07 01:37,URC,1796,737-800,20,6,26,4,4,26,,,,,6,6
2019-06-07 01:36,SZX,1102,737-800,29,3,33,5,5,36,,,,,4,7
2019-06-07 01:35,TYN,1795,737-800,20,4,28,4,4,27,,,,,8,7
2019-06-07 01:34,YIH,1348,737-800,28,3,32,4,3,29,,,,,4,1
2019-06-07 01:34,KMG,6015,737-800,21,3,30,3,4,24,,,,,9,3
2019-06-07 01:33,XIY,5115,737-800,20,4,22,5,5,24,,,,,2,4
2019-06-07 01:32,DLC,1213,737-800,21,6,28,5,6,28,,,,,7,7
2019-06-07 01:32,HHA,5467,737-800,25,4,28,5,4,29,,,,,3,4
2019-06-07 01:31,PEK,5540,737-800,22,5,34,5,5,31,,,,,12,9
2019-06-07 01:31,HHA,1496,737-800,25,7,34,6,6,28,,,,,9,3
2019-06-07 01:29,HAK,5429,737-800,28,6,34,4,6,34,,,,,6,6
2019-06-07 01:27,SYX,1786,737-800,26,6,35,4,4,33,,,,,9,7
2019-06-07 01:22,CAN,1549,737-800,25,5,36,5,5,32,,,,,11,7
2019-06-07 01:21,CAN,7175,737-800,28,6,34,4,5,32,,,,,6,4
2019-06-07 01:21,XIY,6808,737-800,22,4,32,4,4,27,,,,,10,5
2019-06-07 01:19,Ö£ÖÝ,1208,737-800,24,3,30,3,3,20,,,,,6,-4
2019-06-07 01:13,25,1373,737-800,28,4,34,4,4,31,,,,,6,3
2019-06-07 01:11,DLC,7171,737-800,16,4,26,3,3,27,,,,,10,11
2019-06-07 01:08,CGO,7619,737-800,24,4,28,5,4,27,,,,,4,3
2019-06-07 01:06,CKG,1492,737-800,25,4,32,2,3,30,,,,,7,5
2019-06-07 01:04,SZX,5687,737-800,29,4,30,4,4,31,,,,,1,2
2019-06-07 01:00,HAK,1489,737-800,28,4,30,4,3,34,,,,,2,6
2019-06-07 00:58,URC,5623,737-800,20,4,30,4,4,24,,,,,10,4
2019-06-07 00:56,SZX,1491,737-800,29,6,36,6,6,36,,,,,7,7
2019-06-07 00:54,Î÷°²,5405,737-800,21,4,21,5,4,28,,,,,0,7
2019-06-07 00:54,CGO,1783,737-800,25,4,30,4,3,30,,,,,5,5
2019-06-07 00:53,CGO,6066,737-800,28,5,30,4,4,28,,,,,2,0
2019-06-07 00:52,CAN,5852,737-800,26,4,36,6,6,36,1,1,,11,10,10
2019-06-07 00:52,DLC,5636,737-800,20,4,28,4,4,28,,,,,8,8
2019-06-07 00:49,103,5279,737-800,25,8,30,7,7,30,,,,,5,5
2019-06-07 00:49,HRB,1480,737-800,23,3,20,5,5,21,,,,,-3,-2
2019-06-07 00:47,PEK,1725,737-800,24,7,30,5,5,33,,,,,6,9
2019-06-07 00:47,CKG,5408,737-800,24,2,21,3,2,21,,,,,-3,-3
2019-06-07 00:47,XIY,1163,737-800,25,4,32,4,4,30,,,,,7,5
2019-06-07 00:47,MIG,1587,737-800,30,6,34,4,4,32,,,,,4,2
2019-06-07 00:47,SYX,5416,737-800,30,8,36,8,7,36,,,,,6,6
2019-06-07 00:43,CAN,6063,737-800,27,7,34,6,8,36,,,,,7,9
2019-06-07 00:42,URC,2157,737-800,29,4,26,8,4,24,,,,,-3,-5
2019-06-07 00:41,YIH,1351,737-800,28,7,32,5,4,30,,,,,4,2
2019-06-07 00:40,YIH,7395,737-800,29,6,28,7,6,30,,,,,-1,1
2019-06-07 00:36,HRB,7113,737-800,25,4,32,5,4,30,,,,,7,5
2019-06-07 00:36,HRB,1559,737-800,27,4,35,3,2,28,,,,,8,1
2019-06-07 00:34,HGH,1733,737-800,25,6,28,5,6,28,,,,,3,3
2019-06-07 00:31,TYN,1799,737-800,22,4,29,4,4,29,,,,,7,7
2019-06-07 00:29,CGO,7990,737-800,24,3,30,3,4,30,,,,,6,6
2019-06-07 00:26,XIY,5139,737-800,23,6,21,5,4,20,,,,,-2,-3
2019-06-07 00:17,SZX,1347,737-800,30,8,37,4,4,36,,,,,7,6
2019-06-07 00:06,MIG,5449,737-800,30,8,34,8,8,34,,,,,4,4
2019-06-06 23:57,SYX,5480,737-800,30,8,36,8,6,22,,,,,6,-8
2019-06-06 23:54,XIY,5478,737-800,21,4,28,4,4,26,,,,,7,5
2019-06-06 23:52,´óÁ¬,1547,737-800,16,6,26,6,6,24,,,,,10,8
2019-06-06 23:51,´óÁ¬,1547,737-800,16,6,26,6,6,24,,,,,10,8
2019-06-06 23:50,HAK,5359,737-800,29,9,37,4,4,32,,,,,8,3
2019-06-06 23:50,TYN,5662,737-800,20,5,23,4,5,22,,,,,3,2
2019-06-06 23:50,TYN,7886,737-800,20,2,24,2,2,22,,,,,4,2
2019-06-06 23:44,XIY,1386,737-800,31,3,28,3,3,30,,,,,-3,-1
2019-06-06 23:39,SYX,7618,737-800,26,5,36,8,6,35,1,,,1,10,9
2019-06-06 23:38,HAK,1503,737-800,30,4,32,4,4,30,,,,,2,0
2019-06-06 23:30,CTU,7992,737-800,30,7,33,8,7,33,,,,,3,3
2019-06-06 23:23,URC,205T,737-800,20,4,26,3,3,28,,,,,6,8
2019-06-06 23:22,HAK,5502,737-800,29,8,35,7,6,34,,,,,6,5
2019-06-06 23:20,HRB,7105,737-800,23,4,29,4,4,28,,,,,6,5
2019-06-06 23:16,HGH,1927,737-800,27,2,26,4,6,26,,,,,-1,-1
2019-06-06 23:08,CGO,205U,737-800,24,4,28,4,4,28,,,,,4,4
2019-06-06 23:04,Î÷Äþ,1545,737-800,23,6,27,6,6,26,,,,,4,3
2019-06-06 22:58,PEK,5482,737-800,25,2,28,4,4,34,,,,,3,9
2019-06-06 22:57,CAN,1502,737-800,28,4,24,5,5,34,,,,,-4,6
2019-06-06 22:54,XNN,5116,737-800,15,3,20,5,6,21,,,,,5,6
2019-06-06 22:51,URC,1548,737-800,27,4,28,5,5,26,,,,,1,-1
2019-06-06 22:45,URC,1569,737-800,30,2,30,2,2,28,,,,,0,-2
2019-06-06 22:42,URC,1995,737-800,29,5,28,6,6,30,,,,,-1,1
2019-06-06 22:30,Î÷Äþ,1505,737-800,23,4,20,4,4,22,,,,,-3,-1
2019-06-06 22:29,PEK,7616,737-800,22,4,26,4,4,26,,,,,4,4
2019-06-06 22:28,CAN,5136,737-800,27,5,33,5,5,36,,,,,6,9
2019-06-06 22:14,URC,1727,737-800,25,5,28,4,4,26,,,,,3,1
2019-06-06 22:06,TYN,1487,737-800,21,2,28,2,2,28,,,,,7,7
2019-06-06 22:04,´óÁ¬,1130,737-800,16,4,28,2,2,26,,,,,12,10
2019-06-06 21:45,FOC,5182,737-800,29,5,32,6,7,34,,,,,3,5
2019-06-06 21:36,URC,1568,737-800,31,4,26,6,5,28,,,,,-5,-3
2019-06-06 21:34,HGH,5479,737-800,28,8,35,6,5,35,,,,,7,7
2019-06-06 21:31,HAK,206F,737-800,31,2,36,4,4,32,,,,,5,1
2019-06-06 21:31,TYN,5083,737-800,20,2,26,2,2,24,,,,,6,4
2019-06-06 21:30,ZGC,1498,737-800,20,6,24,5,4,22,,,,,4,2
2019-06-06 21:30,HAK,206F,737-800,31,2,36,4,4,0,,,,,5,-31
2019-06-06 21:17,PEK,5338,737-800,23,3,26,4,4,30,,,,,3,7
2019-06-06 20:40,XIY,1996,737-800,29,5,31,5,6,30,,,,,2,1
2019-06-06 20:18,HAK,5082,737-800,30,7,37,7,6,35,,,,,7,5
2019-06-06 20:05,HAK,206H,737-800,31,2,36,3,3,34,,,,,5,3
2019-06-06 18:40,PEK,5538,737-800,24,8,32,2,4,30,,,,,8,6
2019-06-06 17:16,URC,1325,737-800,28,3,24,4,4,23,,,,,-4,-5
2019-06-06 17:04,PEK,5375,737-800,25,3,28,5,4,26,,,,,3,1
2019-06-06 16:14,PEK,5733,737-800,20,7,31,5,6,30,,,,,11,10
2019-06-06 15:39,URC,205V,737-800,32,2,29,5,2,27,,,,,-3,-5
2019-06-06 13:26,FOC,1435,737-800,33,6,36,6,6,32,,,,,3,-1
2019-06-06 13:25,¹ðÁÖ,5482,737-800,30,9,38,10,10,38,,,,,8,8
2019-06-06 13:25,FOC,1435,737-800,25,10,41,9,10,42,,,,,16,17
2019-06-06 12:32,ÃàÑô,7993,737-800,32,6,35,6,6,28,,,,,3,-4
2019-06-06 12:29,XIY,6065,737-800,27,4,31,4,6,30,,,,,4,3
2019-06-06 11:01,URC,206P,737-800,23,3,24,4,3,24,,,,,1,1
2019-06-06 09:05,HGH,5520,737-800,30,2,24,4,4,28,,,,,-6,-2
2019-06-06 08:56,PEK,7639,737-800,25,5,25,5,5,28,,,,,0,3
2019-06-06 08:51,FOC,5733,737-800,30,6,36,6,6,36,,,,,6,6
2019-06-06 08:35,CAN,1502,737-800,33,3,33,4,4,34,,,,,0,1
2019-06-06 08:31,XMN,5797,737-800,24,8,30,0,0,0,,,,,6,-24
2019-06-06 08:31,XMN,6103,737-800,25,8,36,9,9,36,,,,,11,11
2019-06-06 08:30,XMN,1997,737-800,28,5,32,6,6,30,,,,,4,2
2019-06-06 08:29,PEK,6808,737-800,24,4,22,3,3,28,,,,,-2,4
2019-06-06 08:29,XMN,5467,737-800,25,8,36,9,9,36,1,1,,11,11,11
2019-06-06 08:17,URC,7198,737-800,23,4,29,5,4,28,,,,,6,5
2019-06-06 08:11,SZX,5855,737-800,30,6,35,6,7,32,,,,,5,2
2019-06-06 08:10,SZC,1141,737-800,30,4,32,4,4,30,,,,,2,0
2019-06-06 08:07,CAN,1996,737-800,27,5,32,5,6,36,,,,,5,9
2019-06-06 07:57,CAN,5136,737-800,27,4,32,4,4,35,,,,,5,8
2019-06-06 07:32,PEK,1929,737-800,20,3,28,4,3,26,,,,,8,6
2019-06-06 07:24,CAN,1787,737-800,27,4,35,8,8,36,,,,,8,9
2019-06-06 07:18,XIY,1162,737-800,19,3,34,3,3,36,1,1,,11,15,17
2019-06-06 07:16,Ì«Ô­,5662,737-800,20,4,24,4,4,25,,,,,4,5
2019-06-06 07:03,KMG,7167,737-800,20,6,30,5,6,22,,,,,10,2
2019-06-06 07:01,HAK,5346,737-800,29,6,37,6,6,34,,,,,8,5
2019-06-06 06:36,XIY,1562,737-800,19,4,30,4,4,30,,,,,11,11
2019-06-06 06:23,PEK ,5416,737-800,23,7,27,6,6,27,,,,,4,4
2019-06-06 06:22,FOC,5182,737-800,27,12,43,11,11,40,,,,,16,13
2019-06-06 06:19,FOC,5733,737-800,26,8,36,6,6,36,,,,,10,10
2019-06-06 06:18,FOC,5182,737-800,27,4,35,5,6,34,,,,,8,7
2019-06-06 06:17,FOC,5430,737-800,28,6,37,6,6,36,,,,,9,8
2019-06-06 06:10,XIY,5503,737-800,20,0,20,4,4,22,,,,,0,2
2019-06-06 06:09,PEK,7379,737-800,23,4,30,4,4,32,,,,,7,9
2019-06-06 05:58,HAK,1549,737-800,28,6,36,6,6,33,,,,,8,5
2019-06-06 05:57,CAN,1787,737-800,27,4,35,8,8,36,,,,,8,9
2019-06-06 05:55,XIY,1482,737-800,19,6,30,6,6,23,,,,,11,4
2019-06-06 05:46,HAK,5418,737-800,30,6,30,4,4,32,,,,,0,2
2019-06-06 05:43,URC,5465,737-800,24,2,28,2,2,28,,,,,4,4
2019-06-06 05:38,URC,1322,737-800,26,4,28,4,4,26,,,,,2,0
2019-06-06 05:37,URC,7399,737-800,23,4,28,4,4,24,,,,,5,1
2019-06-06 05:37,URC,2159,737-800,24,1,24,1,1,26,,,,,0,2
2019-06-06 05:36,URC,1725,737-800,23,4,31,4,4,32,,,,,8,9
2019-06-06 05:34,URC,5611,737-800,22,5,28,5,6,24,,,,,6,2
2019-06-06 05:33,URC,6268,737-800,24,4,26,4,4,26,,,,,2,2
2019-06-06 05:25,KMG,1587,737-800,20,6,32,5,6,29,,,,,12,9
2019-06-06 05:21,HGH,5417,737-800,29,4,30,4,4,34,,,,,1,5
2019-06-06 05:17,HHA,5522,737-800,30,5,34,6,6,30,,,,,4,0
2019-06-06 05:17,KMG,6016,737-800,20,3,28,3,4,29,,,,,8,9
2019-06-06 05:09,DLC,1213,737-800,20,6,30,6,5,30,,,,,10,10
2019-06-06 05:02,FOC,1480,737-800,27,4,32,5,4,35,,,,,5,8
2019-06-06 05:01,PVG,7171,737-800,15,7,28,3,4,28,,,,,13,13
2019-06-06 04:57,XIY,5180,737-800,19,6,30,5,6,22,,,,,11,3
2019-06-06 04:54,CAN,1996,737-800,27,32,5,5,6,36,,,,,-22,9
2019-06-06 04:43,XIY,1163,737-800,20,2,32,2,2,30,,,,,12,10
2019-06-06 04:41,CAN,1728,737-800,26,6,34,5,5,29,,,,,8,3
2019-06-06 04:40,KMG,1208,737-800,19,2,28,3,3,26,,,,,9,7
2019-06-06 04:38,URC,5623,737-800,23,5,28,6,5,25,,,,,5,2
2019-06-06 04:35,SZX,1541,737-800,25,6,36,6,6,36,,,,,11,11
2019-06-06 04:31,XIY,5540,737-800,19,4,26,4,6,28,,,,,7,9
2019-06-06 04:31,CGO,7989,737-800,20,6,30,5,5,30,,,,,10,10
2019-06-06 04:25,XIY,7172,737-800,20,3,30,6,4,28,,,,,10,8
2019-06-06 04:20,SYX,1786,737-800,29,4,34,4,4,32,,,,,5,3
2019-06-06 04:20,SYX,1786,737-800,29,4,34,4,4,32,,,,,5,3
2019-06-06 04:16,HAK,5090,737-800,30,6,37,7,7,37,,,,,7,7
2019-06-06 04:15,SZX,5429,737-800,29,4,37,6,6,36,,,,,8,7
2019-06-06 04:14,XIY,1545,737-800,20,6,30,4,4,30,,,,,10,10
2019-06-06 04:13,HHA,7378,737-800,27,5,25,6,5,24,,,,,-2,-3
2019-06-06 04:12,DLC,7400,737-800,20,4,28,4,4,28,,,,,8,8
2019-06-06 04:07,HGH,5337,737-800,30,4,36,5,5,35,,,,,6,5
2019-06-06 04:06,SZX,206G,737-800,28,3,36,4,4,32,,,,,8,4
2019-06-06 04:04,HHA,5625,737-800,29,6,32,6,5,33,,,,,3,4
2019-06-06 04:02,DLC,1130,737-800,19,4,26,4,4,28,,,,,7,9
2019-06-06 03:54,HHA,1785,737-800,28,8,34,8,7,36,,,,,6,8
2019-06-06 03:51,XIY,1735,737-800,25,4,28,4,5,24,,,,,3,-1
2019-06-06 03:51,DLC,5579,737-800,18,6,26,6,6,28,,,,,8,10
2019-06-06 03:49,URC,1548,737-800,28,2,28,3,5,26,,,,,0,-2
2019-06-06 03:49,DLC,5529,737-800,18,6,26,6,6,28,,,,,8,10
2019-06-06 03:45,HAK,1505,737-800,30,4,30,4,3,28,,,,,0,-2
2019-06-06 03:37,CAN,1131,737-800,27,4,37,4,4,37,,,,,10,10
2019-06-06 03:37,CAN,5638,737-800,25,8,37,9,9,37,1,1,,11,12,12
2019-06-06 03:37,PEK ,5538,737-800,24,6,30,2,2,30,,,,,6,6
2019-06-06 03:36,HGH,1927,737-800,28,3,28,6,4,29,,,,,0,1
2019-06-06 03:36,DLC,5439,737-800,19,2,28,4,4,26,,,,,9,7
2019-06-06 03:32,HFE,6066,737-800,24,6,36,6,6,33,1,,,1,12,9
2019-06-06 03:30,DLC,1928,737-800,20,4,25,6,5,26,,,,,5,6
2019-06-06 03:29,CGO,1497,737-800,20,4,30,4,4,28,,,,,10,8
2019-06-06 03:28,CGO,5135,737-800,20,2,28,4,4,26,,,,,8,6
2019-06-06 03:25,TYN,5462,737-800,18,4,24,4,4,26,,,,,6,8
2019-06-06 03:25,KMG,5409,737-800,18,4,23,4,4,28,,,,,5,10
2019-06-06 03:21,PEK,5539,737-800,24,8,33,3,3,28,,,,,9,4
2019-06-06 03:20,HAK,1488,737-800,25,6,34,6,5,31,,,,,9,6
2019-06-06 03:20,URC,1568,737-800,20,5,27,7,8,24,,,,,7,4
2019-06-06 03:17,CGO,6809,737-800,30,4,26,4,6,26,,,,,-4,-4
2019-06-06 03:16,ZGC,7377,737-800,15,9,28,6,6,26,,,,,13,11
2019-06-06 03:15,ZGC,5405,737-800,16,5,27,6,5,25,,,,,11,9
2019-06-06 03:12,CGO,1729,737-800,20,3,24,3,4,24,,,,,4,4
2019-06-06 03:12,CAN,5480,737-800,27,7,36,6,4,27,,,,,9,0
2019-06-06 03:07,HAK,1503,737-800,29,3,36,4,4,37,,,,,7,8
2019-06-06 03:06,PEK,1372,737-800,24,5,34,5,4,36,,,,,10,12
2019-06-06 03:05,DLC,1799,737-800,20,4,24,5,4,24,,,,,4,4
2019-06-06 03:03,HAK,206H,737-800,30,4,35,3,3,33,,,,,5,3
2019-06-06 03:00,HHA,1375,737-800,29,3,35,4,4,30,,,,,6,1
2019-06-06 02:57,SYX,5359,737-800,29,8,35,6,5,34,,,,,6,5
2019-06-06 02:49,CAN,1131,737-800,25,4,37,4,4,37,,,,,12,12
2019-06-06 02:48,XIY,1351,737-800,18,4,32,5,5,29,,,,,14,11
2019-06-06 02:48,ZGC,1498,737-800,15,4,24,4,4,22,,,,,9,7
2019-06-06 02:47,SZX,1491,737-800,25,5,36,6,6,36,,,,,11,11
2019-06-06 02:47,XIY,1481,737-800,18,6,32,6,6,30,1,,,1,14,12
2019-06-06 02:47,DLC,5580,737-800,20,2,26,3,4,28,,,,,6,8
2019-06-06 02:43,KMG,6800,737-800,20,4,25,5,4,24,,,,,5,4
2019-06-06 02:40,YIH,7395,737-800,26,6,32,5,6,30,,,,,6,4
2019-06-06 02:39,YIH,1905,737-800,24,4,30,4,4,28,,,,,6,4
2019-06-06 02:38,KMG,1798,737-800,21,6,29,5,5,24,,,,,8,3
2019-06-06 02:37,KMG,7991,737-800,20,6,26,7,6,28,,,,,6,8
2019-06-06 02:32,HRB,1559,737-800,18,2,30,3,3,26,,,,,12,8
2019-06-06 02:32,HHA,6060,737-800,28,4,32,4,4,30,,,,,4,2
2019-06-06 02:32,XIY,1783,737-800,24,4,29,4,4,30,,,,,5,6
2019-06-06 02:32,HRB,1906,737-800,18,8,30,7,6,30,,,,,12,12
2019-06-06 02:31,HAK,1101,737-800,29,3,36,4,3,36,,,,,7,7
2019-06-06 02:27,HAK,206F,737-800,28,3,32,3,3,32,,,,,4,4
2019-06-06 02:24,HAK,5687,737-800,28,7,36,5,5,35,,,,,8,7
2019-06-06 02:13,HGH,1489,737-800,29,4,33,4,4,32,,,,,4,3
2019-06-06 02:11,SYX,1496,737-800,30,3,33,3,4,34,,,,,3,4
2019-06-06 02:10,PEK,1372,737-800,24,5,34,5,4,36,,,,,10,12
2019-06-06 02:09,SYX,5852,737-800,30,7,36,7,6,36,,,,,6,6
2019-06-06 02:05,XIY,5709,737-800,25,7,32,6,8,32,,,,,7,7
2019-06-06 02:01,SZX,1493,737-800,26,4,33,4,5,31,,,,,7,5
2019-06-06 01:59,HAK,1501,737-800,28,4,37,4,4,34,,,,,9,6
2019-06-06 01:51,HAK,7175,737-800,28,5,35,5,5,33,,,,,7,5
2019-06-06 01:49,HGH,5713,737-800,29,6,34,6,6,30,,,,,5,1
2019-06-06 01:47,URC,5798,737-800,24,2,23,3,3,20,,,,,-1,-4
2019-06-06 01:38,SYX,5406,737-800,30,5,37,8,5,33,,,,,7,3
2019-06-06 01:34,¹ãÖÝ,1502,737-800,33,3,33,4,4,34,,,,,0,1
2019-06-06 01:33,MIG,5449,737-800,28,8,32,6,6,29,,,,,4,1
2019-06-06 01:33,HAK,1503,737-800,29,3,34,4,4,37,,,,,5,8
2019-06-06 01:32,PEK,5482,737-800,26,2,32,8,6,42,,,,,6,16
2019-06-06 01:29,HRB,7105,737-800,17,3,27,4,4,26,,,,,10,9
2019-06-06 01:27,PEK,5466,737-800,24,3,23,8,4,23,,,,,-1,-1
2019-06-06 01:26,XIY,1386,737-800,20,4,30,4,4,32,,,,,10,12
2019-06-06 01:20,HGH,5479,737-800,30,8,35,6,6,34,,,,,5,4
2019-06-06 01:20,TYN,1103,737-800,17,4,28,4,4,28,,,,,11,11
2019-06-06 01:19,XIY,1161,737-800,21,3,34,3,3,31,,,,,13,10
2019-06-06 01:10,PEK,1215,737-800,24,3,33,4,3,33,,,,,9,9
2019-06-06 01:09,SYX,5428,737-800,30,7,35,8,4,37,,,,,5,7
2019-06-06 01:07,MIG,1586,737-800,30,4,30,4,4,30,,,,,0,0
2019-06-06 01:07,SYX,7619,737-800,29,6,34,6,5,32,,,,,5,3
2019-06-06 01:02,HGH,5735,737-800,25,6,28,6,5,34,,,,,3,9
2019-06-06 01:00,CAN,5373,737-800,25,7,34,9,9,36,,,,,9,11
2019-06-06 00:56,XIY,1495,737-800,20,2,26,4,4,28,,,,,6,8
2019-06-06 00:50,CAN,5372,737-800,27,8,36,8,8,34,,,,,9,7
2019-06-06 00:48,URC,5637,737-800,24,2,27,2,2,26,,,,,3,2
2019-06-06 00:47,URC,5637,737-800,24,2,27,2,2,28,,,,,3,4
2019-06-06 00:39,HAK,1490,737-800,29,5,34,6,6,33,,,,,5,4
2019-06-06 00:38,SZX,1487,737-800,29,4,36,4,3,36,,,,,7,7
2019-06-06 00:37,HGH,1995,737-800,30,6,33,6,6,34,,,,,3,4
2019-06-06 00:37,KWE,7171,737-800,15,7,28,3,4,28,,,,,13,13
2019-06-06 00:34,CKG,5481,737-800,25,4,28,6,5,25,,,,,3,0
2019-06-06 00:33,HAK,5636,737-800,28,8,36,8,8,36,,,,,8,8
2019-06-06 00:31,TYN,1547,737-800,18,5,30,6,6,30,,,,,12,12
2019-06-06 00:27,SHE,5358,737-800,20,5,28,6,4,24,,,,,8,4
2019-06-06 00:26,HA?K,6015,737-800,29,6,36,4,4,32,,,,,7,3
2019-06-06 00:21,XIY,1903,737-800,20,2,28,2,2,28,,,,,8,8
2019-06-06 00:11,SYX,7618,737-800,30,6,36,6,5,36,,,,,6,6
2019-06-06 00:08,CAN,5141,737-800,25,4,32,5,5,34,,,,,7,9
2019-06-05 23:49,HAK,1793,737-800,30,6,36,5,5,34,,,,,6,4
2019-06-05 23:42,HAK,5082,737-800,30,6,36,6,5,34,,,,,6,4
2019-06-05 23:37,HHA,7616,737-800,28,3,30,4,4,31,,,,,2,3
2019-06-05 23:23,URC,205T,737-800,25,3,27,3,3,28,,,,,2,3
2019-06-05 23:15,XNN,5502,737-800,16,5,22,6,5,23,,,,,6,7
2019-06-05 23:13,CGO,205U,737-800,20,4,28,4,4,30,,,,,8,10
2019-06-05 23:11,HAK,5463,737-800,30,6,33,7,7,33,,,,,3,3
2019-06-05 23:08,HAK,206H,737-800,30,4,35,3,3,33,,,,,5,3
2019-06-05 22:56,HRB,1433,737-800,17,3,26,3,4,25,,,,,9,8
2019-06-05 22:45,URC,1796,737-800,26,6,28,5,5,28,,,,,2,2
2019-06-05 22:44,XNN,5116,737-800,12,4,17,5,5,19,,,,,5,7
2019-06-05 22:35,PEK,5375,737-800,25,2,26,4,4,26,,,,,1,1
2019-06-05 22:29,CGO,1209,737-800,30,3,32,2,3,32,,,,,2,2
2019-06-05 22:24,CGO,7990,737-800,21,2,26,3,3,27,,,,,5,6
2019-06-05 22:21,TYN,1498,737-800,18,4,25,4,4,24,,,,,7,6
2019-06-05 22:13,URC,7173,737-800,28,2,28,2,3,26,,,,,0,-2
2019-06-05 22:12,URC,1569,737-800,29,4,29,3,3,27,,,,,0,-2
2019-06-05 21:57,XNN,5338,737-800,16,4,21,4,4,26,,,,,5,10
2019-06-05 21:52,HAK,2157,737-800,27,6,32,6,6,32,,,,,5,5
2019-06-05 21:48,HRB,7113,737-800,20,4,29,4,5,29,,,,,9,9
2019-06-05 21:46,URC,1323,737-800,28,2,30,2,2,30,,,,,2,2
2019-06-05 21:43,HAK,5139,737-800,29,8,33,8,7,36,,,,,4,7
2019-06-05 21:28,URC,1325,737-800,30,6,23,5,4,22,,,,,-7,-8
2019-06-05 21:25,HHA,1346,737-800,30,8,36,6,7,32,,,,,6,2
2019-06-05 21:24,HHA,1346,737-800,30,8,36,6,7,32,,,,,6,2
2019-06-05 21:23,URC,6995,737-800,30,4,32,6,4,26,,,,,2,-4
2019-06-05 21:18,PEK,1538,737-800,28,3,32,4,3,31,,,,,4,3
2019-06-05 21:01,ZGC,5686,737-800,15,4,24,4,5,22,,,,,9,7
2019-06-05 19:47,HAK,1347,737-800,30,8,37,4,4,36,,,,,7,6
2019-06-05 19:35,YIH,1348,737-800,23,3,30,3,3,32,,,,,7,9
2019-06-05 19:16,HGH,5483,737-800,32,6,36,4,4,36,,,,,4,4
2019-06-05 18:23,ÐìÖÝ,7988,737-800,20,6,37,7,4,36,1,1,,11,17,16
2019-06-05 18:04,HAK,1373,737-800,33,3,36,4,4,34,,,,,3,1
2019-06-05 17:20,CKG,1492,737-800,30,3,28,3,3,28,,,,,-2,-2
2019-06-05 15:22,TYN,5662,737-800,18,2,25,4,6,28,,,,,7,10
2019-06-05 14:35,PEK,5733,737-800,30,6,34,6,6,32,,,,,4,2
2019-06-05 14:20,,1929,737-800,30,3,24,5,5,26,,,,,-6,-4
2019-06-05 13:45,XIY,5115,737-800,19,3,20,4,4,23,,,,,1,4
2019-06-05 11:43,URC,6268,737-800,27,4,28,4,4,28,,,,,1,1
2019-06-05 11:13,HAK,1141,737-800,34,5,37,6,6,33,,,,,3,-1
2019-06-05 11:00,FOC,5430,737-800,27,6,37,7,6,37,1,1,ÓÒTCV,11ÓÒTCV,10,10
2019-06-05 10:07,FOC,1435,737-800,26,8,37,6,7,36,,,,,11,10
2019-06-05 09:53,CTU,7992,737-800,26,7,32,7,6,32,,,,,6,6
2019-06-05 09:21,PEK,5466,737-800,25,6,32,5,5,30,,,,,7,5
2019-06-05 09:20,PEK,5687,737-800,25,5,28,5,4,28,,,,,3,3
2019-06-05 09:16,HRB,7113,737-800,21,5,29,4,5,30,,,,,8,9
2019-06-05 09:15,HRB,7113,737-800,21,6,32,5,5,31,,,,,11,10
2019-06-05 09:02,SYX,5358,737-800,30,6,34,6,6,34,,,,,4,4
2019-06-05 08:40,XMN,5405,737-800,25,5,34,4,5,30,,,,,9,5
2019-06-05 08:39,XMN,5625,737-800,25,6,34,5,5,32,,,,,9,7
2019-06-05 08:39,XMN,5467,737-800,28,7,32,7,5,34,,,,,4,6
2019-06-05 08:14,PEK,6808,737-800,25,4,32,4,4,28,,,,,7,3
2019-06-05 07:54,PEK,1785,737-800,22,4,26,4,5,28,,,,,4,6
2019-06-05 07:43,HAK,5373,737-800,27,6,32,9,8,35,,,,,5,8
2019-06-05 07:42,HAK,5463,737-800,28,4,32,6,5,31,,,,,4,3
2019-06-05 07:35,XIY,5180,737-800,20,6,35,6,6,32,1,,,1,15,12
2019-06-05 07:15,CAN,1131,737-800,26,4,37,4,4,37,1,1,,11,11,11
2019-06-05 07:05,CGO,1547,737-800,27,5,35,5,5,35,,,,,8,8
2019-06-05 07:03,HGH,5540,737-800,24,5,32,5,4,32,,,,,8,8
2019-06-05 06:57,XIY,7172,737-800,22,4,30,4,4,29,,,,,8,7
2019-06-05 06:47,ZGC,5686,737-800,10,4,22,3,4,21,,,,,12,11
2019-06-05 06:46,ZGC,7619,737-800,15,4,24,5,4,22,,,,,9,7
2019-06-05 06:45,ZGC,1795,737-800,10,4,28,4,4,26,,,,,18,16
2019-06-05 06:44,ZGC,6103,737-800,12,6,24,6,7,22,,,,,12,10
2019-06-05 06:38,HRB,7395,737-800,21,5,26,6,6,26,,,,,5,5
2019-06-05 06:36,XIY,1482,737-800,20,4,28,4,4,28,,,,,8,8
2019-06-05 06:08,XIY,5346,737-800,20,6,30,5,5,27,,,,,10,7
2019-06-05 06:01,XIY,6065,737-800,20,4,32,5,5,32,,,,,12,12
2019-06-05 05:47,URC,5520,737-800,20,6,28,5,6,20,,,,,8,0
2019-06-05 05:40,CAN,1787,737-800,26,2,34,9,9,36,,1,,1,8,10
2019-06-05 05:40,URC,1796,737-800,20,4,28,4,4,28,,,,,8,8
2019-06-05 05:38,TYN,5462,737-800,25,4,26,6,5,26,,,,,1,1
2019-06-05 05:30,PEK,5539,737-800,25,7,28,6,5,26,,,,,3,1
2019-06-05 05:30,URC,1725,737-800,25,4,29,5,5,28,,,,,4,3
2019-06-05 05:26,HAK,5090,737-800,28,2,34,3,4,34,,,,,6,6
2019-06-05 05:08,KMG,6016,737-800,20,5,36,4,4,31,,,,,16,11
2019-06-05 05:05,FOC,1435,737-800,26,8,32,6,7,36,,,,,6,10
2019-06-05 04:58,HAK,5371,737-800,29,8,34,7,7,35,,,,,5,6
2019-06-05 04:56,URC,5637,737-800,20,3,26,3,3,24,,,,,6,4
2019-06-05 04:56,HGH,5735,737-800,21,6,28,4,5,28,,,,,7,7
2019-06-05 04:53,HAK,5416,737-800,28,7,35,7,6,34,,,,,7,6
2019-06-05 04:51,URC,205V,737-800,22,4,28,2,5,27,,,,,6,5
2019-06-05 04:46,SYX,5428,737-800,30,6,33,7,6,36,,,,,3,6
2019-06-05 04:40,DLC,5465,737-800,20,3,27,4,4,28,,,,,7,8
2019-06-05 04:40,URC,206P,737-800,24,4,27,4,4,25,,,,,3,1
2019-06-05 04:37,SYX,5418,737-800,38,8,32,4,4,32,,,,,-6,-6
2019-06-05 04:37,SYX,5418,737-800,28,7,32,4,4,32,,,,,4,4
2019-06-05 04:35,XIY,5115,737-800,20,2,22,2,2,20,,,,,2,0
2019-06-05 04:34,HAK,5139,737-800,29,7,34,6,7,32,,,,,5,3
2019-06-05 04:31,FOC,1350,737-800,25,4,34,4,4,32,,,,,9,7
2019-06-05 04:22,URC,5798,737-800,20,4,24,4,3,22,,,,,4,2
2019-06-05 04:18,CAN,1101,737-800,26,3,32,3,2,36,,1,,1,6,10
2019-06-05 04:16,DLC,1488,737-800,17,5,28,5,5,26,,,,,11,9
2019-06-05 04:14,HAK,1347,737-800,28,7,34,7,6,32,,,,,6,4
2019-06-05 04:09,HGH,5483,737-800,28,3,26,4,4,31,,,,,-2,3
2019-06-05 04:08,FOC,1562,737-800,22,7,37,5,5,36,,,,,15,14
2019-06-05 04:04,HGH,1927,737-800,26,4,29,8,4,28,,,,,3,2
2019-06-05 04:04,SYX,1213,737-800,29,6,36,6,6,37,,,,,7,8
2019-06-05 04:04,SYX,5713,737-800,29,5,35,4,5,34,,,,,6,5
2019-06-05 04:03,PEK,5482,737-800,25,2,30,6,6,32,,,,,5,7
2019-06-05 04:00,CAN,1549,737-800,27,6,36,6,5,30,,,,,9,3
2019-06-05 03:57,KMG ,1209,737-800,17,4,28,3,3,28,,,,,11,11
2019-06-05 03:56,URC,6995,737-800,23,4,28,4,3,25,,,,,5,2
2019-06-05 03:56,CKG,1492,737-800,25,5,32,4,4,30,,,,,7,5
2019-06-05 03:55,DLC,5439,737-800,18,3,26,3,4,23,,,,,8,5
2019-06-05 03:53,FOC,1906,737-800,27,7,36,7,7,36,,,,,9,9
2019-06-05 03:53,TYN,5359,737-800,20,6,20,6,6,24,,,,,0,4
2019-06-05 03:52,DLC,7400,737-800,18,4,26,4,4,26,,,,,8,8
2019-06-05 03:52,HAK,5480,737-800,30,6,34,5,5,32,,,,,4,2
2019-06-05 03:50,KMG,1208,737-800,20,2,26,3,3,25,,,,,6,5
2019-06-05 03:47,DLC,1799,737-800,25,4,28,2,2,26,,,,,3,1
2019-06-05 03:47,SZX,206G,737-800,28,4,36,4,4,34,,,,,8,6
2019-06-05 03:45,DLC,7171,737-800,20,2,24,2,2,24,,,,,4,4
2019-06-05 03:43,URC,1995,737-800,25,5,30,5,5,29,,,,,5,4
2019-06-05 03:33,URC,1538,737-800,22,3,28,3,3,28,,,,,6,6
2019-06-05 03:31,DLC,1386,737-800,19,4,28,3,2,28,,,,,9,9
2019-06-05 03:27,PEK,1373,737-800,25,4,31,3,3,26,,,,,6,1
2019-06-05 03:26,SZX,206F,737-800,28,4,34,2,2,32,,,,,6,4
2019-06-05 03:25,CKG,5481,737-800,25,6,33,8,6,34,,,,,8,9
2019-06-05 03:21,XIY,5182,737-800,21,2,32,3,4,26,,,,,11,5
2019-06-05 03:20,URC,5623,737-800,20,6,24,5,5,23,,,,,4,3
2019-06-05 03:18,HGH,5337,737-800,24,4,28,4,4,30,,,,,4,6
2019-06-05 03:18,T?Y?N,7886,737-800,25,4,28,4,4,28,,,,,3,3
2019-06-05 03:08,PEK,5539,737-800,25,8,38,4,5,25,,,,,13,0
2019-06-05 03:07,PEK,1372,737-800,20,4,30,4,6,32,,,,,10,12
2019-06-05 03:07,SZX,1491,737-800,26,5,35,5,6,35,,,,,9,9
2019-06-05 03:04,HRB,1433,737-800,22,3,30,2,2,23,,,,,8,1
2019-06-05 03:01,XIY,5712,737-800,22,1,26,1,2,24,,,,,4,2
2019-06-05 03:00,HRB,7105,737-800,20,4,27,4,4,26,,,,,7,6
2019-06-05 02:59,DLC,1497,737-800,19,4,27,2,3,27,,,,,8,8
2019-06-05 02:59,XIY,1481,737-800,20,6,28,4,4,28,,,,,8,8
2019-06-05 02:57,PEK,1726,737-800,23,4,30,4,4,28,,,,,7,5
2019-06-05 02:55,HAK,1489,737-800,29,5,33,6,6,36,,,,,4,7
2019-06-05 02:54,CGO,7989,737-800,28,6,30,6,6,30,,,,,2,2
2019-06-05 02:47,SZX,7175,737-800,28,5,34,6,5,32,,,,,6,4
2019-06-05 02:45,HAK,1505,737-800,25,5,31,5,4,31,,,,,6,6
2019-06-05 02:45,XIY,1351,737-800,20,5,35,4,4,30,1,,,1,15,10
2019-06-05 02:44,SZX,5855,737-800,29,8,32,7,7,30,,,,,3,1
2019-06-05 02:39,KMG,5825,737-800,20,7,0,8,0,0,,,,,-20,-20
2019-06-05 02:36,SZX,206H,737-800,27,2,34,3,3,33,,,,,7,6
2019-06-05 02:33,URC,1796,737-800,24,4,28,4,4,28,,,,,4,4
2019-06-05 02:32,URC,7379,737-800,24,3,24,4,3,25,,,,,0,1
2019-06-05 02:31,XIY,1162,737-800,20,3,32,3,3,33,,,,,12,13
2019-06-05 02:30,XIY,1103,737-800,22,3,22,4,2,28,,,,,0,6
2019-06-05 02:29,HAK,5522,737-800,28,8,36,8,8,35,,,,,8,7
2019-06-05 02:26,HHA,1346,737-800,28,4,29,6,6,30,,,,,1,2
2019-06-05 02:26,YIH,1348,737-800,33,5,32,3,4,30,,,,,-1,-3
2019-06-05 02:25,YIH,1905,737-800,33,4,29,5,4,28,,,,,-4,-5
2019-06-05 02:23,CGO,205U,737-800,28,4,29,5,5,29,,,,,1,1
2019-06-05 02:22,PEK,7639,737-800,25,6,32,4,4,30,,,,,7,5
2019-06-05 02:22,XIY,1783,737-800,22,6,30,4,4,30,,,,,8,8
2019-06-05 02:17,XIY,1483,737-800,21,6,28,7,6,26,,,,,7,5
2019-06-05 02:03,XIY,5116,737-800,22,3,24,4,4,24,,,,,2,2
2019-06-05 02:03,CAN,5141,737-800,26,4,30,6,6,30,,,,,4,4
2019-06-05 02:03,FOC,1480,737-800,26,5,29,5,5,29,,,,,3,3
2019-06-05 02:02,PEK,1502,737-800,23,4,30,4,4,28,,,,,7,5
2019-06-05 01:59,SYX,7618,737-800,29,6,36,6,7,34,,,,,7,5
2019-06-05 01:55,HAK,5417,737-800,30,6,35,7,8,35,,,,,5,5
2019-06-05 01:48,SZX,1487,737-800,28,3,35,3,3,33,,,,,7,5
2019-06-05 01:46,KMG,5449,737-800,20,5,28,6,5,28,,,,,8,8
2019-06-05 01:45,CAN,1728,737-800,27,4,30,5,5,28,,,,,3,1
2019-06-05 01:43,XIY,1163,737-800,16,2,22,3,2,21,,,,,6,5
2019-06-05 01:41,HRB,1559,737-800,24,4,28,4,4,32,,,,,4,8
2019-06-05 01:40,HAK,5479,737-800,29,7,36,6,7,36,,,,,7,7
2019-06-05 01:40,CAN,5372,737-800,28,7,34,8,8,32,,,,,6,4
2019-06-05 01:38,CGO,1587,737-800,30,4,31,4,5,30,,,,,1,0
2019-06-05 01:38,HHA,1542,737-800,28,5,32,5,4,30,,,,,4,2
2019-06-05 01:32,PEK,1997,737-800,24,6,28,4,4,26,,,,,4,2
2019-06-05 01:29,TYN,1501,737-800,25,4,25,4,5,24,,,,,0,-1
2019-06-05 01:26,CGO,7990,737-800,28,2,28,4,4,27,,,,,0,-1
2019-06-05 01:25,MIG,5732,737-800,20,4,29,4,4,29,,,,,9,9
2019-06-05 01:24,HGH,1733,737-800,28,2,31,2,2,26,,,,,3,-2
2019-06-05 01:21,MIG,1586,737-800,20,4,30,4,4,30,,,,,10,10
2019-06-05 01:15,HAK,1102,737-800,30,4,35,4,4,36,,,,,5,6
2019-06-05 01:12,CAN,5638,737-800,26,5,35,5,5,36,,1,,1,9,10
2019-06-05 01:11,XIY,5375,737-800,23,2,22,4,4,26,,,,,-1,3
2019-06-05 01:09,PEK,7639,737-800,25,6,32,4,4,30,,,,,7,5
2019-06-05 01:07,SZX,1493,737-800,28,6,23,6,6,30,,,,,-5,2
2019-06-05 01:06,PEK,5538,737-800,24,8,34,4,3,35,1,1,,11,10,11
2019-06-05 01:06,Î÷Äþ,5338,737-800,17,3,19,3,4,20,,,,,2,3
2019-06-05 00:58,URC,1322,737-800,20,3,28,4,4,26,,,,,8,6
2019-06-05 00:57,HAK,1541,737-800,28,6,35,8,7,36,,,,,7,8
2019-06-05 00:57,HAK,5580,737-800,28,6,34,8,9,35,,,,,6,7
2019-06-05 00:53,URC,5611,737-800,24,4,26,6,6,18,,,,,2,-6
2019-06-05 00:50,SYX,5418,737-800,30,10,32,4,4,32,,,,,2,2
2019-06-05 00:44,FOC,5503,737-800,27,3,30,3,3,30,,,,,3,3
2019-06-05 00:42,HAK,1793,737-800,25,6,36,7,7,35,,,,,11,10
2019-06-05 00:38,PEK,1215,737-800,23,4,22,3,2,20,,,,,-1,-3
2019-06-05 00:32,CAN,1545,737-800,27,5,36,6,5,36,,,,,9,9
2019-06-05 00:29,HAK,6809,737-800,30,4,32,5,4,34,,,,,2,4
2019-06-05 00:28,HGH,1996,737-800,27,4,28,4,4,28,,,,,1,1
2019-06-05 00:22,SYX,5135,737-800,30,8,37,6,6,36,,,,,7,6
2019-06-05 00:16,HAK,1490,737-800,27,6,36,5,5,33,,,,,9,6
2019-06-05 00:12,PEK,7399,737-800,24,4,24,6,6,24,,,,,0,0
2019-06-05 00:08,CGO,1496,737-800,28,6,30,6,6,30,,,,,2,2
2019-06-05 00:03,XIY,5709,737-800,22,5,28,4,4,27,,,,,6,5
2019-06-05 00:01,URC,1548,737-800,20,4,23,3,4,22,,,,,3,2
2019-06-04 23:49,DLC,1130,737-800,18,4,28,2,3,29,,,,,10,11
2019-06-04 23:48,KMG,7167,737-800,20,6,29,6,6,25,,,,,9,5
2019-06-04 23:41,URC,1727,737-800,25,6,30,6,6,25,,,,,5,0
2019-06-04 23:38,MIG,5409,737-800,22,4,26,5,4,22,,,,,4,0
2019-06-04 23:37,SYX,5852,737-800,30,7,37,8,8,36,,,,,7,6
2019-06-04 23:29,KMG,6015,737-800,22,4,28,4,4,24,,,,,6,2
2019-06-04 23:27,,5521,737-800,28,5,34,6,6,34,,,,,6,6
2019-06-04 23:26,CAN,5136,737-800,25,4,32,4,4,34,,,,,7,9
2019-06-04 23:15,URC,2159,737-800,27,2,20,2,2,26,,,,,-7,-1
2019-06-04 23:15,HGH,7377,737-800,30,6,30,6,6,29,,,,,0,-1
2019-06-04 23:13,TYN,5083,737-800,25,2,26,6,6,26,,,,,1,1
2019-06-04 23:09,HAK,5082,737-800,28,7,36,6,7,36,,,,,8,8
2019-06-04 23:07,URC,205T,737-800,28,2,30,2,2,32,,,,,2,4
2019-06-04 22:53,CKG,1492,737-800,30,4,34,3,3,30,,,,,4,0
2019-06-04 22:41,FOC,1480,737-800,26,5,30,5,5,31,,,,,4,5
2019-06-04 22:17,URC,1568,737-800,28,5,30,6,6,28,,,,,2,0
2019-06-04 22:15,URC,1323,737-800,26,4,28,2,2,29,,,,,2,3
2019-06-04 22:04,HHA,5636,737-800,30,6,34,6,6,33,,,,,4,3
2019-06-04 21:56,XNN,5502,737-800,19,5,21,6,5,22,,,,,2,3
2019-06-04 21:49,URC,1569,737-800,25,3,23,4,3,24,,,,,-2,-1
2019-06-04 21:44,HHA,1375,737-800,26,4,36,4,4,32,1,,,1,10,6
2019-06-04 21:17,MIG,7993,737-800,29,6,29,6,6,29,,,,,0,0
2019-06-04 21:13,XUZ,6800,737-800,31,4,32,4,4,30,,,,,1,-1
2019-06-04 21:11,FOC,1928,737-800,27,6,27,7,7,32,,,,,0,5
2019-06-04 21:11,TYN,1498,737-800,20,4,28,4,4,24,,,,,8,4
2019-06-04 20:14,HAK,5853,737-800,25,8,34,6,6,28,,,,,9,3
2019-06-04 19:11,XIY,1903,737-800,30,2,32,4,4,36,,,,,2,6
2019-06-04 18:50,URC ,1570,737-800,30,4,23,5,4,25,,,,,-7,-5
2019-06-04 18:48,KMG,1798,737-800,25,6,30,30,32,24,,,,,5,-1
2019-06-04 18:41,URC,1325,737-800,30,4,22,5,5,23,,,,,-8,-7
2019-06-04 18:27,HAK,5082,737-800,28,8,32,4,5,33,,,,,4,5
2019-06-04 17:31,CGO,6066,737-800,38,5,30,6,6,28,,,,,-8,-10
2019-06-04 16:40,HAK,5082,737-800,25,4,34,4,4,33,,,,,9,8
2019-06-04 16:36,HAK,5082,737-800,25,4,34,4,4,33,,,,,9,8
2019-06-04 13:56,PEK,5482,737-800,25,2,30,6,6,35,,,,,5,10
2019-06-04 13:18,XIY,1162,737-800,33,3,34,3,3,34,,,,,1,1
2019-06-04 12:09,,206Q,737-800,28,4,20,4,4,4,,,,,-8,-24
2019-06-04 09:54,CAN,5478,737-800,27,4,32,4,5,31,,,,,5,4
2019-06-04 09:52,CAN,5466,737-800,27,3,28,7,7,30,,,,,1,3
2019-06-04 09:49,CAN,5579,737-800,28,6,34,6,6,32,,,,,6,4
2019-06-04 09:42,CAN,1549,737-800,27,4,32,6,5,34,,,,,5,7
2019-06-04 09:40,CAN,5638,737-800,27,6,36,6,6,36,,,,,9,9
2019-06-04 09:38,CAN,5136,737-800,25,5,31,5,5,35,,,,,6,10
2019-06-04 09:37,CAN,1783,737-800,27,4,34,5,5,36,,,,,7,9
2019-06-04 09:36,CAN,5372,737-800,27,8,32,8,8,33,,,,,5,6
2019-06-04 09:35,CAN,1141,737-800,27,6,37,6,6,32,,,,,10,5
2019-06-04 09:34,CAN,1490,737-800,28,6,35,6,7,33,,,,,7,5
2019-06-04 09:13,SYX,5358,737-800,31,0,0,6,6,34,,,,,-31,3
2019-06-04 08:36,CGO,1496,737-800,30,5,28,5,5,28,,,,,-2,-2
2019-06-04 08:28,PEK,5687,737-800,24,4,28,4,4,28,,,,,4,4
2019-06-04 08:22,SZX,1487,737-800,27,4,34,4,5,32,,,,,7,5
2019-06-04 08:18,XIY,1103,737-800,28,4,30,5,4,28,,,,,2,0
2019-06-04 08:18,CTU,7992,737-800,30,7,32,8,7,32,,,,,2,2
2019-06-04 08:18,XIY,1103,737-800,28,4,30,5,4,28,,,,,2,0
2019-06-04 08:16,XIY ,1902,737-800,21,6,31,6,7,28,,,,,10,7
2019-06-04 08:09,FOC,6065,737-800,24,5,32,6,5,35,,,,,8,11
2019-06-04 07:55,HAK,6061,737-800,30,6,36,6,5,36,,,,,6,6
2019-06-04 07:42,URC,1995,737-800,21,5,28,5,5,28,,,,,7,7
2019-06-04 07:37,FOC,1348,737-800,24,3,31,4,4,29,,,,,7,5
2019-06-04 07:30,FOC,5503,737-800,24,4,27,6,6,24,,,,,3,0
2019-06-04 07:21,FOC,1906,737-800,30,6,33,6,6,34,,,,,3,4
2019-06-04 07:19,FOC,1906,737-800,29,6,34,7,6,36,,,,,5,7
2019-06-04 06:55,HAK,1793,737-800,28,6,36,5,5,36,,,,,8,8
2019-06-04 06:55,HAK,5153,737-800,30,6,37,4,4,32,,,,,7,2
2019-06-04 06:30,KMG,5449,737-800,20,7,25,6,7,26,,,,,5,6
2019-06-04 06:14,HAK,5853,737-800,28,6,33,5,5,29,,,,,5,1
2019-06-04 06:09,URC,1548,737-800,23,4,26,4,4,26,,,,,3,3
2019-06-04 06:02,HAK,5661,737-800,28,6,36,6,6,37,,,,,8,9
2019-06-04 06:00,PEK,6808,737-800,25,4,30,4,4,30,,,,,5,5
2019-06-04 05:40,FOC,1350,737-800,26,4,36,4,4,32,,,,,10,6
2019-06-04 05:33,PEK,5467,737-800,23,0,30,0,0,34,,,,,7,11
2019-06-04 05:32,HGH,1541,737-800,25,4,32,5,4,34,,,,,7,9
2019-06-04 05:31,CKG,5481,737-800,28,5,31,5,5,31,,,,,3,3
2019-06-04 05:30,CKG,5135,737-800,29,3,28,3,3,28,,,,,-1,-1
2019-06-04 05:26,HAK,5373,737-800,28,8,35,9,8,33,,,,,7,5
2019-06-04 05:03,´óÁ¬,1497,737-800,22,2,28,4,4,28,,,,,6,6
2019-06-04 05:03,DLC,5439,737-800,19,4,28,2,2,26,,,,,9,7
2019-06-04 04:58,KMG,6809,737-800,20,5,24,5,5,26,,,,,4,6
2019-06-04 04:40,SYX,1492,737-800,25,6,36,4,4,32,1,,,1,11,7
2019-06-04 04:39,FOC,1351,737-800,25,4,36,5,4,34,,,,,11,9
2019-06-04 04:25,HHA,7398,737-800,25,5,30,4,4,32,,,,,5,7
2019-06-04 04:14,XIY,1163,737-800,21,2,28,2,2,17,,,,,7,-4
2019-06-04 04:03,HGH,1795,737-800,25,3,27,3,4,26,,,,,2,1
2019-06-04 04:03,HAK,7400,737-800,28,4,32,5,5,34,,,,,4,6
2019-06-04 03:54,XIY,5115,737-800,19,2,19,3,3,21,,,,,0,2
2019-06-04 03:53,SYX,5662,737-800,30,8,36,4,5,34,,,,,6,4
2019-06-04 03:49,FOC,5430,737-800,25,5,27,5,5,30,,,,,2,5
2019-06-04 03:41,SYX,5852,737-800,30,9,37,8,9,37,,,,,7,7
2019-06-04 03:40,SZX,1102,737-800,28,4,36,4,4,36,,,,,8,8
2019-06-04 03:39,CGO,205U,737-800,26,4,28,4,4,30,,,,,2,4
2019-06-04 03:36,URC,5520,737-800,25,6,28,6,6,28,,,,,3,3
2019-06-04 03:36,KMG,6015,737-800,19,6,26,4,4,24,,,,,7,5
2019-06-04 03:35,XIY,6346,737-800,23,5,25,6,5,25,,,,,2,2
2019-06-04 03:31,XIY,6066,737-800,25,2,28,4,2,26,,,,,3,1
2019-06-04 03:26,PEK,5733,737-800,22,6,22,4,4,24,,,,,0,2
2019-06-04 03:24,KMG,7991,737-800,19,7,30,7,6,29,,,,,11,10
2019-06-04 03:23,PEK,5713,737-800,22,6,22,6,6,24,,,,,0,2
2019-06-04 03:23,HGH,1785,737-800,28,4,26,6,6,26,,,,,-2,-2
2019-06-04 03:21,PEK,5538,737-800,22,1,30,3,3,37,,,,,8,15
2019-06-04 03:19,HGH,5337,737-800,28,3,30,4,4,28,,,,,2,0
2019-06-04 03:18,XIY,5182,737-800,25,2,24,2,2,22,,,,,-1,-3
2019-06-04 03:15,URC,205V,737-800,22,2,22,4,2,27,,,,,0,5
2019-06-04 03:13,URC,1568,737-800,23,4,29,4,5,24,,,,,6,1
2019-06-04 03:13,CAN,1505,737-800,27,4,27,4,4,30,,,,,0,3
2019-06-04 03:11,XIY,5375,737-800,25,0,19,3,3,22,,,,,-6,-3
2019-06-04 03:06,PEK,5479,737-800,25,5,29,5,4,29,,,,,4,4
2019-06-04 03:05,HRB,1562,737-800,21,5,30,4,4,28,,,,,9,7
2019-06-04 03:05,ZGC,5406,737-800,20,4,24,4,6,22,,,,,4,2
2019-06-04 03:05,URC,5798,737-800,23,3,25,3,3,23,,,,,2,0
2019-06-04 03:05,HRB,1562,737-800,21,5,28,4,4,26,,,,,7,5
2019-06-04 03:04,CAN,1505,737-800,27,4,27,4,4,30,,,,,0,3
2019-06-04 03:03,CAN,1505,737-800,27,0,0,0,0,0,,,,,-27,-27
2019-06-04 03:03,MIG,7993,737-800,28,6,31,7,6,29,,,,,3,1
2019-06-04 02:58,URC,5637,737-800,15,3,24,2,3,25,,,,,9,10
2019-06-04 02:55,PEK,1347,737-800,22,4,28,6,4,29,,,,,6,7
2019-06-04 02:55,URC,6995,737-800,20,4,28,4,4,24,,,,,8,4
2019-06-04 02:52,HAK,1489,737-800,29,4,36,6,5,37,,,,,7,8
2019-06-04 02:49,ZGC,6103,737-800,15,6,24,6,6,27,,,,,9,12
2019-06-04 02:43,PEK,5539,737-800,23,8,26,6,6,26,,,,,3,3
2019-06-04 02:43,URC,7198,737-800,23,2,23,3,2,20,,,,,0,-3
2019-06-04 02:38,HHA,1375,737-800,25,4,30,5,4,28,,,,,5,3
2019-06-04 02:37,CAN,5372,737-800,27,8,32,8,8,33,,,,,5,6
2019-06-04 02:30,URC,5611,737-800,22,6,28,7,6,26,,,,,6,4
2019-06-04 02:30,PEK,5538,737-800,23,3,27,2,2,36,,,,,4,13
2019-06-04 02:26,SYX,5418,737-800,30,7,34,6,5,34,,,,,4,4
2019-06-04 02:25,HAK,1502,737-800,30,2,36,4,4,34,,,,,6,4
2019-06-04 02:22,CAN,5136,737-800,25,5,31,5,5,35,,,,,6,10
2019-06-04 02:16,PEK,1131,737-800,25,5,22,4,4,33,,,,,-3,8
2019-06-04 02:14,HHA,1542,737-800,25,5,30,5,4,29,,,,,5,4
2019-06-04 02:11,SYX,1213,737-800,30,6,36,6,6,36,,,,,6,6
2019-06-04 02:11,SYX,1213,737-800,30,6,36,6,6,36,,,,,6,6
2019-06-04 02:11,HRB,7395,737-800,21,3,25,5,5,21,,,,,4,0
2019-06-04 02:10,TYN,5462,737-800,20,2,24,2,2,22,,,,,4,2
2019-06-04 02:06,HAK,1503,737-800,28,3,32,4,4,34,,,,,4,6
2019-06-04 02:05,ÃàÑô,1798,737-800,27,7,34,7,7,25,,,,,7,-2
2019-06-04 02:05,HHA,5429,737-800,25,4,27,4,4,28,,,,,2,3
2019-06-04 02:04,URC,1323,737-800,24,4,30,3,4,30,,,,,6,6
2019-06-04 02:00,XIY,5116,737-800,30,4,22,4,4,22,,,,,-8,-8
2019-06-04 01:59,HRB,1559,737-800,20,3,19,3,3,22,,,,,-1,2
2019-06-04 01:59,XIY,5712,737-800,20,2,26,3,2,27,,,,,6,7
2019-06-04 01:58,HRB,1559,737-800,20,3,20,3,3,26,,,,,0,6
2019-06-04 01:56,HGH,1491,737-800,28,5,32,5,5,30,,,,,4,2
2019-06-04 01:55,URC,7379,737-800,23,4,28,4,4,28,,,,,5,5
2019-06-04 01:54,TYN,1927,737-800,25,3,22,8,4,25,,,,,-3,0
2019-06-04 01:54,HAK,5855,737-800,30,6,35,5,5,30,,,,,5,0
2019-06-04 01:49,YIH,1435,737-800,28,6,35,6,7,36,,,,,7,8
2019-06-04 01:48,MIG,5409,737-800,25,4,26,4,3,25,,,,,1,0
2019-06-04 01:45,DLC,1101,737-800,18,4,32,2,2,28,,,,,14,10
2019-06-04 01:38,SYX,1733,737-800,30,4,35,5,5,32,,,,,5,2
2019-06-04 01:36,CGO,7989,737-800,25,5,26,5,5,32,,,,,1,7
2019-06-04 01:35,CGO,6016,737-800,30,5,32,5,5,32,,,,,2,2
2019-06-04 01:29,DLC,1928,737-800,20,5,26,4,4,24,,,,,6,4
2019-06-04 01:25,TYN,1545,737-800,23,6,25,5,5,24,,,,,2,1
2019-06-04 01:23,SZX,7175,737-800,28,5,35,6,5,33,,,,,7,5
2019-06-04 01:22,URC,1725,737-800,26,4,32,4,4,34,,,,,6,8
2019-06-04 01:20,CGO,7172,737-800,29,4,29,5,4,28,,,,,0,-1
2019-06-04 01:18,KMG,7988,737-800,19,5,31,5,6,30,,,,,12,11
2019-06-04 01:18,HHA,5625,737-800,25,5,29,5,5,28,,,,,4,3
2019-06-04 01:18,´óÁ¬,7171,737-800,16,6,26,3,4,24,,,,,10,8
2019-06-04 01:16,XIY,5709,737-800,25,6,31,8,7,30,,,,,6,5
2019-06-04 01:15,HGH,5483,737-800,25,4,32,5,4,30,,,,,7,5
2019-06-04 01:12,URC,1570,737-800,15,5,26,6,6,22,,,,,11,7
2019-06-04 01:10,SYX,1538,737-800,30,7,37,5,4,37,,,,,7,7
2019-06-04 01:08,DLC,5465,737-800,19,2,24,2,2,28,,,,,5,9
2019-06-04 01:06,HAK,6060,737-800,28,5,37,4,4,37,,,,,9,9
2019-06-04 01:02,XIY,5180,737-800,21,6,26,5,5,26,,,,,5,5
2019-06-04 01:00,URC,5636,737-800,24,8,28,6,6,26,,,,,4,2
2019-06-04 01:00,TYN,1493,737-800,23,6,26,6,6,24,,,,,3,1
2019-06-04 00:52,URC,5540,737-800,25,6,30,5,5,28,,,,,5,3
2019-06-04 00:51,HGH,5797,737-800,38,4,24,4,6,24,,,,,-14,-14
2019-06-04 00:46,HAK,5090,737-800,25,8,37,6,6,36,1,1,,11,12,11
2019-06-04 00:41,KMG,7990,737-800,20,3,28,3,3,28,,,,,8,8
2019-06-04 00:38,HGH,1996,737-800,25,5,26,5,5,32,,,,,1,7
2019-06-04 00:32,URC,1325,737-800,23,8,26,7,8,20,,,,,3,-3
2019-06-04 00:28,URC,1322,737-800,25,3,27,4,5,26,,,,,2,1
2019-06-04 00:26,CGO,1209,737-800,29,4,32,3,3,30,,,,,3,1
2019-06-04 00:25,HHA,7377,737-800,25,6,28,6,6,28,,,,,3,3
2019-06-04 00:24,SZX,1727,737-800,28,4,36,6,6,33,,,,,8,5
2019-06-04 00:17,SZX,206G,737-800,27,3,34,5,5,34,,,,,7,7
2019-06-04 00:10,PEK,1386,737-800,26,3,30,4,3,32,,,,,4,6
2019-06-03 23:55,XIY,5522,737-800,30,6,30,5,6,28,,,,,0,-2
2019-06-03 23:54,HAK,7167,737-800,29,8,37,5,4,34,,,,,8,5
2019-06-03 23:51,ZGC,5686,737-800,20,5,24,5,5,20,,,,,4,0
2019-06-03 23:50,ZGC,5405,737-800,24,4,26,5,6,23,,,,,2,-1
2019-06-03 23:46,XIY ,1346,737-800,30,6,28,6,5,26,,,,,-2,-4
2019-06-03 23:35,URC,1569,737-800,24,2,26,3,3,26,,,,,2,2
2019-06-03 23:35,TYN,1498,737-800,28,4,26,5,6,22,,,,,-2,-6
2019-06-03 23:33,CAN,5579,737-800,27,6,34,6,6,32,,,,,7,5
2019-06-03 23:32,CAN,1490,737-800,28,6,35,6,7,33,,,,,7,5
2019-06-03 23:29,XIY,5580,737-800,30,6,26,6,6,29,,,,,-4,-1
2019-06-03 23:24,URC,5623,737-800,26,6,24,6,5,26,,,,,-2,0
2019-06-03 23:23,DLC,1130,737-800,18,5,28,5,4,28,,,,,10,10
2019-06-03 23:23,HAK,7639,737-800,28,6,36,8,7,34,,,,,8,6
2019-06-03 23:20,DLC,1488,737-800,16,5,28,5,5,28,,,,,12,12
2019-06-03 23:20,HHA,7616,737-800,28,3,27,2,3,28,,,,,-1,0
2019-06-03 23:16,TYN,1929,737-800,26,4,26,5,4,25,,,,,0,-1
2019-06-03 23:16,URC,205T,737-800,25,3,28,2,3,29,,,,,3,4
2019-06-03 23:16,SZX,206F,737-800,28,3,34,3,3,34,,,,,6,6
2019-06-03 23:16,URC,5417,737-800,25,4,20,4,4,27,,,,,-5,2
2019-06-03 23:06,´óÁ¬,1372,737-800,16,6,26,4,4,22,,,,,10,6
2019-06-03 23:05,HRB,1433,737-800,20,3,28,2,3,23,,,,,8,3
2019-06-03 23:02,HAK,5089,737-800,28,6,26,1,1,35,,,,,-2,7
2019-06-03 23:01,Î÷°²,1735,737-800,30,4,25,5,5,24,,,,,-5,-6
2019-06-03 23:00,PEK,7399,737-800,26,2,30,2,2,21,,,,,4,-5
2019-06-03 22:56,DLC,1799,737-800,20,4,28,5,5,28,,,,,8,8
2019-06-03 22:53,XIY,1161,737-800,28,4,28,4,4,28,,,,,0,0
2019-06-03 22:47,SZX,206H,737-800,28,3,34,2,3,32,,,,,6,4
2019-06-03 22:31,KMG,1586,737-800,20,4,32,4,4,30,,,,,12,10
2019-06-03 22:27,º£¿Ú,1501,737-800,33,4,36,4,4,34,,,,,3,1
2019-06-03 22:19,HAK,5463,737-800,28,5,30,6,6,32,,,,,2,4
2019-06-03 22:18,URC,206P,737-800,25,2,24,5,5,24,,,,,-1,-1
2019-06-03 22:05,HAK,5735,737-800,30,6,36,6,6,35,,,,,6,5
2019-06-03 21:51,Î÷Äþ,5502,737-800,24,5,22,7,5,23,,,,,-2,-1
2019-06-03 21:46,ÃàÑô,5732,737-800,30,2,26,3,3,30,,,,,-4,0
2019-06-03 21:40,HAK,5735,737-800,29,6,36,6,6,35,,,,,7,6
2019-06-03 21:00,PEK,1796,737-800,30,4,31,5,4,29,,,,,1,-1
2019-06-03 20:47,CGO,1587,737-800,30,4,30,5,3,30,,,,,0,0
2019-06-03 20:41,KMG,6800,737-800,20,4,25,4,4,24,,,,,5,4
2019-06-03 20:22,XIY,1903,737-800,35,1,26,3,2,28,,,,,-9,-7
2019-06-03 20:21,PEK,1495,737-800,31,4,30,4,5,29,,,,,-1,-2
2019-06-03 19:49,HRB,7105,737-800,22,4,27,6,5,26,,,,,5,4
2019-06-03 18:28,HHA,1997,737-800,35,6,34,6,6,32,,,,,-1,-3
2019-06-03 18:05,CGO,1547,737-800,35,4,26,4,4,25,,,,,-9,-10
2019-06-03 17:21,HAK,1728,737-800,25,5,34,5,5,30,,,,,9,5
2019-06-03 17:01,ÐìÖÝ,1208,737-800,30,3,33,3,3,30,,,,,3,0
2019-06-03 16:20,HAK,5371,737-800,35,8,32,8,8,36,,,,,-3,1
2019-06-03 15:19,PE?K,1215,737-800,33,4,30,4,4,30,,,,,-3,-3
2019-06-03 14:54,CAN,1505,737-800,35,4,29,4,4,30,,,,,-6,-5
2019-06-03 13:44,YIH,1905,737-800,36,4,30,5,4,29,,,,,-6,-7
2019-06-03 08:37,HAK,5620,737-800,33,3,34,3,3,33,,,,,1,0
2019-06-03 08:19,±±¾©,7171,737-800,30,4,26,4,4,28,,,,,-4,-2
2019-06-03 08:05,SZX,1487,737-800,27,2,34,2,2,34,,,,,7,7
2019-06-03 07:49,PEK,6065,737-800,25,3,26,2,3,27,,,,,1,2
2019-06-03 07:17,PEK,5687,737-800,25,2,24,1,1,24,,,,,-1,-1
2019-06-03 07:10,SYX,5358,737-800,30,7,36,6,6,34,,,,,6,4
2019-06-03 07:03,HGH,5462,737-800,30,6,28,4,4,24,,,,,-2,-6
2019-06-03 06:50,XIY,1482,737-800,21,6,30,6,6,32,,,,,9,11
2019-06-03 06:30,HHA,1547,737-800,23,5,34,5,5,37,,1,,1,11,14
2019-06-03 06:11,FOC,1351,737-800,23,4,32,4,4,32,,,,,9,9
2019-06-03 06:01,FOC,5503,737-800,23,3,27,4,3,27,,,,,4,4
2019-06-03 05:47,URC,5637,737-800,25,2,26,2,2,24,,,,,1,-1
2019-06-03 05:46,URC,1995,737-800,24,4,26,4,4,24,,,,,2,0
2019-06-03 05:35,PEK,1729,737-800,29,4,24,5,4,24,,,,,-5,-5
2019-06-03 05:31,TYN,1928,737-800,15,4,21,5,5,22,,,,,6,7
2019-06-03 05:15,FOC,1347,737-800,24,2,32,3,2,30,,,,,8,6
2019-06-03 05:09,HAK,6061,737-800,27,4,35,6,5,36,,,,,8,9
2019-06-03 05:02,PEK,1131,737-800,26,5,30,4,4,32,,,,,4,6
2019-06-03 05:00,22,5733,737-800,27,6,34,7,7,36,,,,,7,9
2019-06-03 04:51,KMG,7167,737-800,19,4,28,6,6,24,,,,,9,5
2019-06-03 04:48,CAN,5580,737-800,28,7,36,8,6,37,,,,,8,9
2019-06-03 04:45,XIY,5115,737-800,20,4,19,5,5,23,,,,,-1,3
2019-06-03 04:32,KMG,7989,737-800,18,4,27,5,4,28,,,,,9,10
2019-06-03 04:30,HHA,7398,737-800,22,4,30,4,4,32,,,,,8,10
2019-06-03 04:27,HHA,5141,737-800,23,5,26,5,5,28,,,,,3,5
2019-06-03 04:26,URC,1322,737-800,24,2,25,2,2,25,,,,,1,1
2019-06-03 04:24,HGH,1728,737-800,30,4,30,2,2,26,,,,,0,-4
2019-06-03 04:22,HGH,1542,737-800,23,4,30,4,4,28,,,,,7,5
2019-06-03 04:11,ÃàÑô,5449,737-800,28,8,36,5,5,32,,,,,8,4
2019-06-03 03:54,XIY,5430,737-800,22,6,30,6,6,30,,,,,8,8
2019-06-03 03:54,URC,5798,737-800,20,4,20,2,4,22,,,,,0,2
2019-06-03 03:53,URC,1996,737-800,25,3,20,4,2,24,,,,,-5,-1
2019-06-03 03:50,HAK,5638,737-800,30,7,37,8,7,36,,,,,7,6
2019-06-03 03:45,DLC,1213,737-800,20,5,27,5,6,26,,,,,7,6
2019-06-03 03:44,CGO,1209,737-800,28,4,30,4,4,30,,,,,2,2
2019-06-03 03:43,TYN,5465,737-800,25,2,24,4,4,26,,,,,-1,1
2019-06-03 03:42,HRB,1348,737-800,16,5,23,4,4,25,,,,,7,9
2019-06-03 03:40,XIY,1346,737-800,23,2,24,4,6,26,,,,,1,3
2019-06-03 03:36,XIY,5709,737-800,21,6,30,6,6,30,,,,,9,9
2019-06-03 03:34,DLC,1372,737-800,19,5,29,5,5,29,,,,,10,10
2019-06-03 03:34,URC,1386,737-800,25,3,28,4,4,26,,,,,3,1
2019-06-03 03:33,CAN,5478,737-800,28,7,36,7,6,37,,,,,8,9
2019-06-03 03:27,SZX,206H,737-800,25,4,34,3,3,32,,,,,9,7
2019-06-03 03:27,SZX,206H,737-800,25,4,34,3,3,32,,,,,9,7
2019-06-03 03:26,XIY,7113,737-800,20,5,20,5,5,28,,,,,0,8
2019-06-03 03:25,HGH,1491,737-800,22,5,32,5,5,32,,,,,10,10
2019-06-03 03:21,XIY,5346,737-800,22,4,24,5,4,26,,,,,2,4
2019-06-03 03:19,SZX,1727,737-800,27,4,36,5,5,33,,,,,9,6
2019-06-03 03:18,FOC,1562,737-800,23,5,27,5,4,27,,,,,4,4
2019-06-03 03:16,URC,5611,737-800,25,6,29,6,6,26,,,,,4,1
2019-06-03 03:16,URC,5611,737-800,25,6,29,6,6,26,,,,,4,1
2019-06-03 03:16,URC,2159,737-800,25,1,27,2,2,27,,,,,2,2
2019-06-03 03:15,URC,1323,737-800,26,2,26,2,2,26,,,,,0,0
2019-06-03 03:15,URC,1569,737-800,26,2,27,3,2,26,,,,,1,0
2019-06-03 03:12,URC,205V,737-800,25,1,27,5,1,26,,,,,2,1
2019-06-03 03:07,DLC,1929,737-800,20,4,26,4,4,24,,,,,6,4
2019-06-03 03:06,XMN,5406,737-800,20,7,25,4,5,27,,,,,5,7
2019-06-03 03:06,KMG,7993,737-800,20,5,26,7,6,23,,,,,6,3
2019-06-03 03:06,XMN,7618,737-800,23,6,34,7,6,32,,,,,11,9
2019-06-03 03:05,XMN,1373,737-800,20,7,27,5,8,29,,,,,7,9
2019-06-03 03:04,XMN,5713,737-800,27,4,31,4,4,30,,,,,4,3
2019-06-03 03:03,CAN,5373,737-800,24,4,36,6,6,36,,1,,1,12,12
2019-06-03 03:01,PEK,5482,737-800,20,1,29,4,4,34,,,,,9,14
2019-06-03 02:56,SYX,1733,737-800,29,4,32,3,4,30,,,,,3,1
2019-06-03 02:51,HAK,1102,737-800,27,4,36,4,4,37,,,,,9,10
2019-06-03 02:50,XIY,1903,737-800,21,2,23,3,2,28,,,,,2,7
2019-06-03 02:49,HAK,1501,737-800,26,4,37,4,4,34,,,,,11,8
2019-06-03 02:46,KMG,6800,737-800,19,4,24,4,5,22,,,,,5,3
2019-06-03 02:46,HHA,7377,737-800,23,6,34,6,6,28,,,,,11,5
2019-06-03 02:46,HAK,6808,737-800,25,4,36,3,3,32,1,,,1,11,7
2019-06-03 02:43,SYX,1541,737-800,29,7,36,6,7,35,,,,,7,6
2019-06-03 02:42,HAK,5090,737-800,27,4,36,3,4,36,,,,,9,9
2019-06-03 02:40,DLC,1488,737-800,21,6,28,6,6,26,,,,,7,5
2019-06-03 02:39,HAK,5735,737-800,25,12,42,6,7,36,,,×óÉ¢ÈÈÆ÷À©É¢¹Ü,×óÉ¢ÈÈÆ÷À©É¢¹Ü,17,11
2019-06-03 02:37,DLC,1372,737-800,19,5,29,5,5,29,,,,,10,10
2019-06-03 02:35,KMG,1208,737-800,20,3,26,3,3,24,,,,,6,4
2019-06-03 02:32,TYN,5686,737-800,20,4,24,4,4,22,,,,,4,2
2019-06-03 02:31,URC,5540,737-800,28,4,26,4,6,26,,,,,-2,-2
2019-06-03 02:29,SYX,5418,737-800,29,7,32,5,5,32,,,,,3,3
2019-06-03 02:27,SYX,5539,737-800,28,3,34,3,3,34,,,,,6,6
2019-06-03 02:26,DLC,1101,737-800,21,3,30,3,2,30,,,,,9,9
2019-06-03 02:25,CAN,1141,737-800,25,7,37,5,5,36,1,1,,11,12,11
2019-06-03 02:23,ZGC,7173,737-800,18,3,26,4,4,22,,,,,8,4
2019-06-03 02:23,URC,5417,737-800,24,2,22,3,2,25,,,,,-2,1
2019-06-03 02:22,ZGC,5405,737-800,20,4,26,6,4,24,,,,,6,4
2019-06-03 02:21,SZX,5855,737-800,25,8,36,6,6,32,,,,,11,7
2019-06-03 02:20,KMG,1586,737-800,17,4,27,4,4,28,,,,,10,11
2019-06-03 02:20,DLC,1130,737-800,20,5,26,4,4,24,,,,,6,4
2019-06-03 02:19,HHA,5625,737-800,28,4,30,5,4,27,,,,,2,-1
2019-06-03 02:17,DLC,5439,737-800,21,4,24,5,5,26,,,,,3,5
2019-06-03 02:13,XIY,1483,737-800,20,6,26,6,6,26,,,,,6,6
2019-06-03 02:13,DLC,1493,737-800,25,5,25,6,6,24,,,,,0,-1
2019-06-03 02:11,XIY,6066,737-800,23,4,28,3,3,24,,,,,5,1
2019-06-03 02:10,DLC,5712,737-800,18,4,26,5,5,24,,,,,8,6
2019-06-03 02:06,URC,6995,737-800,25,4,27,4,4,25,,,,,2,0
2019-06-03 02:05,XIY,5375,737-800,22,4,28,4,6,28,,,,,6,6
2019-06-03 02:04,SYX,206F,737-800,28,4,34,4,4,32,,,,,6,4
2019-06-03 02:03,TYN,1927,737-800,26,4,20,6,4,24,,,,,-6,-2
2019-06-03 02:03,YIH,1435,737-800,30,6,29,6,5,28,,,,,-1,-2
2019-06-03 02:01,CAN,7399,737-800,25,5,34,5,6,30,,,,,9,5
2019-06-03 01:54,URC,1725,737-800,26,4,30,4,4,32,,,,,4,6
2019-06-03 01:53,PEK ,1726,737-800,23,3,29,3,3,27,,,,,6,4
2019-06-03 01:51,KMG,6016,737-800,19,5,30,4,4,28,,,,,11,9
2019-06-03 01:43,SYX,5428,737-800,29,6,36,7,6,36,,,,,7,7
2019-06-03 01:42,21,1103,737-800,27,5,37,5,5,36,1,,,1,10,9
2019-06-03 01:41,XIY ,1735,737-800,25,4,28,6,6,24,,,,,3,-1
2019-06-03 01:36,ÃàÑô,1798,737-800,25,6,30,7,6,26,,,,,5,1
2019-06-03 01:36,URC,7379,737-800,25,4,26,4,5,26,,,,,1,1
2019-06-03 01:33,DLC,1497,737-800,20,4,28,2,4,26,,,,,8,6
2019-06-03 01:32,HAK,1496,737-800,27,6,36,6,6,34,,,,,9,7
2019-06-03 01:27,HAK,1997,737-800,29,5,35,4,3,32,,,,,6,3
2019-06-03 01:25,XIY,1902,737-800,25,6,28,8,8,29,,,,,3,4
2019-06-03 01:15,PEK,5853,737-800,20,6,35,5,5,26,1,,,1,15,6
2019-06-03 01:05,XIY,5116,737-800,23,3,22,4,4,22,,,,,-1,-1
2019-06-03 01:01,TYN,5502,737-800,30,4,24,6,6,25,,,,,-6,-5
2019-06-03 01:01,CAN,1140,737-800,27,6,34,6,6,32,,,,,7,5
2019-06-03 01:00,CAN,7639,737-800,29,6,35,7,6,33,,,,,6,4
2019-06-03 00:58,CKG,1492,737-800,28,4,28,4,4,28,,,,,0,0
2019-06-03 00:56,URC,1548,737-800,25,3,26,4,4,24,,,,,1,-1
2019-06-03 00:55,CAN,1538,737-800,26,2,36,2,3,35,1,,,1,10,9
2019-06-03 00:53,HGH,5479,737-800,22,6,30,6,6,31,,,,,8,9
2019-06-03 00:44,HRB,1559,737-800,18,3,23,3,3,27,,,,,5,9
2019-06-03 00:41,CGO,7991,737-800,30,2,24,5,6,23,,,,,-6,-7
2019-06-03 00:37,FOC,1906,737-800,24,7,35,7,6,36,1,1,,11,11,12
2019-06-03 00:35,HHA,7616,737-800,25,4,26,4,3,29,,,,,1,4
2019-06-03 00:29,SZX,1489,737-800,27,4,32,4,4,33,,,,,5,6
2019-06-03 00:29,XIY,1346,737-800,23,2,24,4,6,26,,,,,1,3
2019-06-03 00:28,HAK,6809,737-800,27,5,31,3,2,31,,,,,4,4
2019-06-03 00:23,PEK,1796,737-800,25,4,28,4,4,26,,,,,3,1
2019-06-03 00:16,SZX,206G,737-800,27,3,35,4,4,33,,,,,8,6
2019-06-03 00:14,HGH,5797,737-800,22,4,22,4,6,24,,,,,0,2
2019-06-03 00:13,,1545,737-800,26,5,24,5,6,24,,,,,-2,-2
2019-06-03 00:12,XIY,5522,737-800,23,6,28,8,8,26,,,,,5,3
2019-06-03 00:09,MIG,5732,737-800,27,4,27,4,3,28,,,,,0,1
2019-06-03 00:04,HAK,5083,737-800,28,6,35,6,6,36,,,,,7,8
2019-06-03 00:04,HGH,7619,737-800,22,4,28,5,5,28,,,,,6,6
2019-06-03 00:01,HAK,1502,737-800,27,3,35,2,2,26,,,,,8,-1
2019-06-02 23:57,CGO,6015,737-800,31,4,30,5,5,26,,,,,-1,-5
2019-06-02 23:47,CGO,5852,737-800,38,4,24,4,4,24,,,,,-14,-14
2019-06-02 23:46,HAK,1799,737-800,27,3,32,3,4,28,,,,,5,1
2019-06-02 23:37,TYN,1795,737-800,20,4,26,4,4,26,,,,,6,6
2019-06-02 23:29,CAN,1783,737-800,25,4,34,6,6,36,,1,,1,9,11
2019-06-02 23:27,HRB,1433,737-800,20,4,29,3,4,28,,,,,9,8
2019-06-02 23:27,URC,1325,737-800,26,3,22,3,4,23,,,,,-4,-3
2019-06-02 23:27,URC,1325,737-800,26,3,22,3,4,23,,,,,-4,-3
2019-06-02 23:26,HHA,1786,737-800,28,4,32,3,3,26,,,,,4,-2
2019-06-02 23:22,HAK,5481,737-800,25,7,34,8,7,37,,,,,9,12
2019-06-02 23:20,HAK,5089,737-800,29,5,24,1,2,33,,,,,-5,4
2019-06-02 23:14,CGO,205U,737-800,32,4,28,4,4,30,,,,,-4,-2
2019-06-02 23:11,XIY,1375,737-800,25,4,28,5,4,26,,,,,3,1
2019-06-02 23:08,HGH,1498,737-800,23,4,32,4,4,30,,,,,9,7
2019-06-02 23:04,CKG,5371,737-800,28,7,27,6,7,28,,,,,-1,0
2019-06-02 23:04,HAK,1797,737-800,27,3,35,8,8,36,,,,,8,9
2019-06-02 23:03,SYX,5136,737-800,28,5,33,6,5,37,,,,,5,9
2019-06-02 22:59,CGO,7378,737-800,32,6,28,6,6,30,,,,,-4,-2
2019-06-02 22:49,ZGC,6103,737-800,15,6,22,6,6,24,,,,,7,9
2019-06-02 22:44,CGO,5153,737-800,35,2,26,3,3,26,,,,,-9,-9
2019-06-02 22:37,URC,205T,737-800,25,3,21,4,3,23,,,,,-4,-2
2019-06-02 22:34,301,5661,737-800,27,4,36,5,5,36,,,,,9,9
2019-06-02 22:33,HAK,5463,737-800,28,5,30,4,4,30,,,,,2,2
2019-06-02 22:27,HAK,5579,737-800,32,3,30,3,5,32,,,,,-2,0
2019-06-02 22:25,URC,206P,737-800,24,4,24,3,3,23,,,,,0,-1
2019-06-02 22:24,HAK,5521,737-800,27,3,30,7,4,32,,,,,3,5
2019-06-02 22:22,URC,1570,737-800,28,4,26,6,4,24,,,,,-2,-4
2019-06-02 22:22,CTU,7992,737-800,30,7,32,7,7,32,,,,,2,2
2019-06-02 22:21,CGO,1587,737-800,32,3,27,3,5,28,,,,,-5,-4
2019-06-02 22:17,ÃàÑô,5409,737-800,28,4,27,5,4,29,,,,,-1,1
2019-06-02 22:12,CAN,1549,737-800,25,7,35,6,6,36,1,1,,11,10,11
2019-06-02 22:08,XNN,7400,737-800,18,4,22,5,5,22,,,,,4,4
2019-06-02 22:04,SYX,7172,737-800,28,3,35,3,3,34,,,,,7,6
2019-06-02 22:00,CAN,5139,737-800,25,8,30,4,4,30,,,,,5,5
2019-06-02 21:44,HAK,1495,737-800,28,4,34,4,4,34,,,,,6,6
2019-06-02 21:43,SYX,5135,737-800,28,7,36,6,4,34,,,,,8,6
2019-06-02 21:03,HAK,1503,737-800,27,6,36,4,4,34,,,,,9,7
2019-06-02 21:02,URC,6268,737-800,27,4,28,5,6,26,,,,,1,-1
2019-06-02 19:56,HRB,7105,737-800,18,4,25,4,4,26,,,,,7,8
2019-06-02 19:41,FOC,1906,737-800,24,3,37,3,3,27,,,,,13,3
2019-06-02 19:28,XIY,1793,737-800,37,5,31,5,5,28,,,,,-6,-9
2019-06-02 19:27,XIY,1162,737-800,37,3,31,3,3,32,,,,,-6,-5
2019-06-02 19:22,CAN,7639,737-800,26,5,34,5,6,36,,,,,8,10
2019-06-02 19:13,HGH,5337,737-800,28,5,33,6,5,33,,,,,5,5
2019-06-02 18:57,HHA,5429,737-800,32,3,29,3,3,29,,,,,-3,-3
2019-06-02 18:57,XIY,5462,737-800,32,4,26,4,4,28,,,,,-6,-4
2019-06-02 18:48,HAK,5408,737-800,31,7,36,4,4,32,,,,,5,1
2019-06-02 16:37,ÐìÖÝ,7988,737-800,30,4,35,6,4,33,,,,,5,3
2019-06-02 13:47,YIH,1905,737-800,34,8,29,7,8,29,,,,,-5,-5
2019-06-02 11:53,XIY,1161,737-800,25,4,30,4,6,30,,,,,5,5
2019-06-02 11:22,URC,6268,737-800,27,4,28,5,6,26,,,,,1,-1
2019-06-02 10:08,XIY,1903,737-800,22,1,26,1,2,28,,,,,4,6
2019-06-02 09:01,FOC,1351,737-800,24,5,35,4,5,30,,,,,11,6
2019-06-02 08:44,HAK,5467,737-800,26,8,37,3,2,33,1,,,1,11,7
2019-06-02 08:21,FOC,5687,737-800,23,5,29,5,4,30,,,,,6,7
2019-06-02 08:20,FOC,1562,737-800,23,5,31,4,4,32,,,,,8,9
2019-06-02 08:02,PEK,7171,737-800,25,4,26,4,4,28,,,,,1,3
2019-06-02 07:48,HAK,5089,737-800,29,5,24,4,4,34,,,,,-5,5
2019-06-02 07:47,XIY,1482,737-800,25,4,28,3,4,28,,,,,3,3
2019-06-02 07:47,XIY,1375,737-800,25,4,28,4,4,28,,,,,3,3
2019-06-02 06:55,PEK,1346,737-800,22,4,34,4,4,29,,,,,12,7
2019-06-02 06:50,CAN,1141,737-800,26,8,37,6,6,36,1,1,,11,11,10
2019-06-02 06:42,KMG,7990,737-800,20,2,24,4,3,23,,,,,4,3
2019-06-02 06:36,ZGC,7173,737-800,16,6,24,6,5,30,,,,,8,14
2019-06-02 06:25,FOC,1906,737-800,24,7,32,6,6,33,,,,,8,9
2019-06-02 06:00,FOC,5182,737-800,24,3,33,4,4,31,,,,,9,7
2019-06-02 05:56,XMN,1729,737-800,25,8,32,6,5,32,,,,,7,7
2019-06-02 05:55,XMN,5636,737-800,27,8,32,6,6,30,,,,,5,3
2019-06-02 05:54,XMN,1786,737-800,27,2,33,3,3,30,,,,,6,3
2019-06-02 05:54,XMN,5662,737-800,20,4,33,2,6,22,,,,,13,2
2019-06-02 05:53,SZX,5735,737-800,26,8,36,6,6,36,,,,,10,10
2019-06-02 05:38,XIY,5139,737-800,20,3,28,4,4,30,,,,,8,10
2019-06-02 05:30,XIY,5346,737-800,23,6,26,6,6,26,,,,,3,3
2019-06-02 05:07,CAN,5090,737-800,25,2,35,4,4,35,,,,,10,10
2019-06-02 05:06,XIY,1483,737-800,25,4,26,5,4,26,,,,,1,1
2019-06-02 05:05,CAN,1490,737-800,26,4,33,5,5,30,,,,,7,4
2019-06-02 05:04,PEK,5520,737-800,24,4,26,4,5,24,,,,,2,0
2019-06-02 05:00,HAK,1545,737-800,27,6,37,6,5,37,1,1,,11,10,10
2019-06-02 04:54,HAK,1787,737-800,26,2,34,8,8,36,,,,,8,10
2019-06-02 04:39,SZX,1487,737-800,26,2,34,2,2,32,,,,,8,6
2019-06-02 04:30,SYX,5418,737-800,29,9,36,6,6,35,,,,,7,6
2019-06-02 04:25,SYX,5136,737-800,28,4,32,6,5,36,,,,,4,8
2019-06-02 04:23,PEK,5638,737-800,22,4,28,4,4,29,,,,,6,7
2019-06-02 04:17,HGH,1103,737-800,21,4,35,4,5,30,,,,,14,9
2019-06-02 04:13,HHA,1215,737-800,22,4,30,4,4,31,,,,,8,9
2019-06-02 04:10,HGH,1491,737-800,22,4,29,5,4,30,,,,,7,8
2019-06-02 04:08,º£¿Ú,1503,737-800,27,2,32,5,4,34,,,,,5,7
2019-06-02 04:01,KMG,7988,737-800,17,5,28,6,4,26,,,,,11,9
2019-06-02 03:54,KMG,6016,737-800,20,4,30,4,4,30,,,,,10,10
2019-06-02 03:54,SHA,1548,737-800,21,4,28,3,3,26,,,,,7,5
2019-06-02 03:50,DLC,1213,737-800,22,4,26,4,4,26,,,,,4,4
2019-06-02 03:50,CAN,5466,737-800,25,0,20,6,0,20,,,,,-5,-5
2019-06-02 03:42,KMG,7989,737-800,20,5,22,6,6,26,,,,,2,6
2019-06-02 03:42,KMG,7989,737-800,20,5,22,6,6,26,,,,,2,6
2019-06-02 03:36,SZX,5735,737-800,27,8,36,6,6,36,,,,,9,9
2019-06-02 03:34,HAK,1547,737-800,25,8,36,8,6,36,1,1,,11,11,11
2019-06-02 03:34,HRB,1350,737-800,20,3,28,4,4,25,,,,,8,5
2019-06-02 03:33,HRB,1433,737-800,20,2,27,3,2,26,,,,,7,6
2019-06-02 03:31,HRB,7105,737-800,20,2,28,3,2,25,,,,,8,5
2019-06-02 03:29,CAN,5580,737-800,24,6,33,7,6,36,,1,,1,9,12
2019-06-02 03:28,HAK,1502,737-800,26,2,22,4,4,22,,,,,-4,-4
2019-06-02 03:27,SYX,7172,737-800,29,6,36,6,5,34,,,,,7,5
2019-06-02 03:25,HAK,5358,737-800,25,8,35,4,4,33,1,,,1,10,8
2019-06-02 03:22,ZGC,6061,737-800,15,3,22,4,4,24,,,,,7,9
2019-06-02 03:21,HAK,1997,737-800,25,6,34,3,3,30,,,,,9,5
2019-06-02 03:20,TYN,206G,737-800,20,4,27,4,4,24,,,,,7,4
2019-06-02 03:18,URC,5417,737-800,25,4,22,4,4,25,,,,,-3,0
2019-06-02 03:18,KMG,1587,737-800,16,3,26,4,2,25,,,,,10,9
2019-06-02 03:16,CAN,5522,737-800,26,6,34,8,9,32,,,,,8,6
2019-06-02 03:15,MIG,5449,737-800,22,4,28,6,6,30,,,,,6,8
2019-06-02 03:15,CGO,7991,737-800,26,6,30,6,6,30,,,,,4,4
2019-06-02 03:12,SYX,206F,737-800,29,3,34,4,4,32,,,,,5,3
2019-06-02 03:10,URC,5853,737-800,20,5,28,5,5,26,,,,,8,6
2019-06-02 03:07,HAK,5429,737-800,26,4,31,4,4,32,,,,,5,6
2019-06-02 03:04,SHA,6065,737-800,21,6,33,5,5,32,,,,,12,11
2019-06-02 03:01,URC,5637,737-800,23,2,28,2,2,25,,,,,5,2
2019-06-02 03:01,FOC,1559,737-800,24,2,33,2,2,32,,,,,9,8
2019-06-02 03:00,URC,6995,737-800,20,4,25,5,5,23,,,,,5,3
2019-06-02 02:59,PEK,5141,737-800,22,4,25,4,4,25,,,,,3,3
2019-06-02 02:59,URC,5797,737-800,22,5,20,6,6,27,,,,,-2,5
2019-06-02 02:58,PEK,1793,737-800,25,5,30,5,5,28,,,,,5,3
2019-06-02 02:55,XMN,1786,737-800,27,2,33,3,3,30,,,,,6,3
2019-06-02 02:54,XMN,5662,737-800,20,4,33,4,6,22,,,,,13,2
2019-06-02 02:52,XMN,1729,737-800,20,8,32,6,5,32,,,,,12,12
2019-06-02 02:46,HAK,1542,737-800,26,4,34,4,4,31,,,,,8,5
2019-06-02 02:46,XMN,5636,737-800,27,8,32,6,6,30,,,,,5,3
2019-06-02 02:44,CAN,5483,737-800,27,8,34,8,6,34,,,,,7,7
2019-06-02 02:43,SZX,1496,737-800,26,4,36,6,6,34,,,,,10,8
2019-06-02 02:42,,5483,737-800,27,8,34,8,6,34,,,,,7,7
2019-06-02 02:38,XIY,7113,737-800,25,4,28,4,5,27,,,,,3,2
2019-06-02 02:35,CAN,5416,737-800,26,6,32,6,7,35,,,,,6,9
2019-06-02 02:31,DLC,1101,737-800,20,3,32,2,2,30,,,,,12,10
2019-06-02 02:31,URC,5611,737-800,24,5,29,4,5,25,,,,,5,1
2019-06-02 02:29,XIY,5709,737-800,22,7,30,7,6,30,,,,,8,8
2019-06-02 02:25,XIY,5430,737-800,25,6,32,5,5,31,,,,,7,6
2019-06-02 02:24,HGH,5479,737-800,24,4,28,5,5,30,,,,,4,6
2019-06-02 02:23,URC,7198,737-800,20,4,24,4,4,23,,,,,4,3
2019-06-02 02:18,HGH,5359,737-800,23,4,28,4,4,20,,,,,5,-3
2019-06-02 02:15,XIY,1162,737-800,25,3,28,3,2,29,,,,,3,4
2019-06-02 02:13,SYX,1733,737-800,30,3,33,4,4,30,,,,,3,0
2019-06-02 02:13,CAN,6103,737-800,26,6,34,8,8,37,,1,,1,8,11
2019-06-02 02:13,CGO,7619,737-800,27,5,26,6,5,26,,,,,-1,-1
2019-06-02 02:10,HGH,7618,737-800,21,6,29,6,4,28,,,,,8,7
2019-06-02 02:08,KMG,5732,737-800,20,2,22,3,3,23,,,,,2,3
2019-06-02 02:06,PEK,5538,737-800,23,4,34,3,2,34,,,,,11,11
2019-06-02 02:04,DLC,5465,737-800,24,2,28,3,3,30,,,,,4,6
2019-06-02 02:02,HHA,7377,737-800,23,5,32,6,5,31,,,,,9,8
2019-06-02 01:58,YIH,1905,737-800,28,4,30,4,4,28,,,,,2,0
2019-06-02 01:56,CGO,1586,737-800,26,4,27,4,4,27,,,,,1,1
2019-06-02 01:56,HAK,5372,737-800,26,8,32,9,8,32,,,,,6,6
2019-06-02 01:51,XIY,7175,737-800,25,6,24,4,4,24,,,,,-1,-1
2019-06-02 01:49,SYX,1541,737-800,28,4,34,6,5,35,,,,,6,7
2019-06-02 01:46,URC,205T,737-800,25,2,26,6,6,22,,,,,1,-3
2019-06-02 01:45,URC,1996,737-800,20,4,24,4,3,23,,,,,4,3
2019-06-02 01:43,URC,1569,737-800,25,2,26,2,3,26,,,,,1,1
2019-06-02 01:38,URC,5798,737-800,22,2,22,2,2,22,,,,,0,0
2019-06-02 01:32,ZGC,5405,737-800,20,4,26,6,5,24,,,,,6,4
2019-06-02 01:32,HAK,5373,737-800,27,6,32,8,8,35,,,,,5,8
2019-06-02 01:32,FOC,1351,737-800,24,6,37,6,6,31,,,,,13,7
2019-06-02 01:31,XIY,5115,737-800,25,3,19,4,4,24,,,,,-6,-1
2019-06-02 01:27,CGO,205U,737-800,28,4,28,4,4,28,,,,,0,0
2019-06-02 01:27,MIG,7993,737-800,24,5,29,6,5,27,,,,,5,3
2019-06-02 01:27,HHA,5625,737-800,23,4,30,4,4,28,,,,,7,5
2019-06-02 01:25,HHA,1373,737-800,21,4,29,4,4,26,,,,,8,5
2019-06-02 01:23,CGO,1209,737-800,27,4,30,4,4,30,,,,,3,3
2019-06-02 01:23,SZX,206H,737-800,26,3,34,3,3,32,,,,,8,6
2019-06-02 01:22,SZX,1386,737-800,25,4,34,3,4,33,,,,,9,8
2019-06-02 01:17,SYX,7378,737-800,28,6,35,7,6,36,,,,,7,8
2019-06-02 01:17,SYX,5408,737-800,29,10,38,6,6,31,,,,,9,2
2019-06-02 01:13,DLC,1493,737-800,23,4,24,4,4,24,,,,,1,1
2019-06-02 01:10,DLC,1372,737-800,21,4,28,4,4,28,,,,,7,7
2019-06-02 01:08,DLC,1795,737-800,20,4,26,3,4,28,,,,,6,8
2019-06-02 01:08,CAN,5481,737-800,25,5,32,5,5,32,,,,,7,7
2019-06-02 01:06,DLC,1497,737-800,22,5,28,2,2,26,,,,,6,4
2019-06-02 01:06,DLC,1497,737-800,22,5,28,2,2,26,,,,,6,4
2019-06-02 00:51,HGH,1498,737-800,22,4,30,4,4,28,,,,,8,6
2019-06-02 00:42,CGO,6015,737-800,27,4,32,4,4,27,,,,,5,0
2019-06-02 00:41,PEK,1796,737-800,25,5,25,5,6,26,,,,,0,1
2019-06-02 00:40,TYN,1927,737-800,22,4,22,8,4,24,,,,,0,2
2019-06-02 00:39,CKG,5371,737-800,25,10,26,6,6,29,,,,,1,4
2019-06-02 00:38,TYN,5686,737-800,21,5,22,6,6,22,,,,,1,1
2019-06-02 00:36,YIH,1435,737-800,32,6,32,7,7,33,,,,,0,1
2019-06-02 00:35,URC,5623,737-800,24,6,29,6,6,26,,,,,5,2
2019-06-02 00:35,5375,XIY,737-800,25,2,22,3,4,24,,,,,-3,-1
2019-06-02 00:33,URC,1725,737-800,20,4,22,4,5,24,,,,,2,4
2019-06-02 00:29,DLC,1347,737-800,20,4,30,3,4,26,,,,,10,6
2019-06-02 00:19,HAK,6060,737-800,25,6,35,5,4,32,,,,,10,7
2019-06-02 00:18,DLC,5439,737-800,21,4,28,3,3,26,,,,,7,5
2019-06-02 00:16,HGH,5406,737-800,23,4,32,6,4,24,,,,,9,1
2019-06-02 00:16,URC,1995,737-800,25,5,28,4,5,27,,,,,3,2
2019-06-02 00:16,PEK,5540,737-800,20,6,32,5,5,30,,,,,12,10
2019-06-02 00:13,HRB,7395,737-800,20,4,27,5,5,25,,,,,7,5
2019-06-02 00:12,HGH,5661,737-800,22,4,28,5,4,32,,,,,6,10
2019-06-02 00:12,SZX,1102,737-800,27,2,36,4,4,36,,,,,9,9
2019-06-02 00:12,KHG,1570,737-800,20,3,23,3,4,23,,,,,3,3
2019-06-02 00:09,Î÷Äþ,1728,737-800,20,5,20,4,5,20,,,,,0,0
2019-06-02 00:08,SYX,5408,737-800,30,7,36,6,6,31,,,,,6,1
2019-06-02 00:07,URC,7379,737-800,24,4,30,5,4,31,,,,,6,7
2019-06-02 00:02,SYX,5135,737-800,29,8,36,6,5,35,,,,,7,6
2019-06-01 23:59,PEK,1538,737-800,28,3,30,2,2,30,,,,,2,2
2019-06-01 23:57,XIY,1735,737-800,27,4,30,4,4,24,,,,,3,-3
2019-06-01 23:50,CTU,7992,737-800,25,8,32,7,6,30,,,,,7,5
2019-06-01 23:47,TYN,5502,737-800,22,7,20,4,4,19,,,,,-2,-3
2019-06-01 23:47,DLC,1488,737-800,21,6,28,6,6,26,,,,,7,5
2019-06-01 23:44,HRB,7395,737-800,20,5,28,5,6,25,,,,,8,5
2019-06-01 23:32,FOC,5503,737-800,21,4,28,4,4,27,,,,,7,6
2019-06-01 23:27,URC,1996,737-800,25,5,28,4,5,27,,,,,3,2
2019-06-01 23:25,MIG,5409,737-800,25,4,26,4,4,30,,,,,1,5
2019-06-01 23:19,PEK,5521,737-800,25,5,26,2,2,24,,,,,1,-1
2019-06-01 23:18,HAK,1928,737-800,26,6,28,7,7,32,,,,,2,6
2019-06-01 23:16,HGH,1131,737-800,23,4,24,4,4,23,,,,,1,0
2019-06-01 23:13,HAK,5579,737-800,25,6,36,6,7,32,,,,,11,7
2019-06-01 23:09,PEK,5712,737-800,25,2,28,8,2,26,,,,,3,1
2019-06-01 23:08,URC,205V,737-800,25,6,28,5,2,26,,,,,3,1
2019-06-01 23:08,HRB,1348,737-800,21,4,26,4,5,27,,,,,5,6
2019-06-01 23:03,Î÷Äþ,5338,737-800,20,2,19,4,4,24,,,,,-1,4
2019-06-01 23:02,CGO,205U,737-800,28,4,28,4,4,28,,,,,0,0
2019-06-01 22:59,CGO,1495,737-800,28,4,30,4,4,27,,,,,2,-1
2019-06-01 22:52,HAK,1505,737-800,25,3,28,5,5,30,,,,,3,5
2019-06-01 22:52,TYN,1130,737-800,23,2,26,2,2,24,,,,,3,1
2019-06-01 22:48,CKG,1492,737-800,25,4,31,3,3,29,,,,,6,4
2019-06-01 22:48,HAK,6808,737-800,26,4,36,4,4,32,,,,,10,6
2019-06-01 22:34,MIG,1798,737-800,21,6,32,4,4,28,,,,,11,7
2019-06-01 22:20,TYN,1929,737-800,25,3,21,3,3,22,,,,,-4,-3
2019-06-01 22:18,URC,1568,737-800,28,6,28,7,7,29,,,,,0,1
2019-06-01 22:16,HGH,5337,737-800,23,4,22,4,4,20,,,,,-1,-3
2019-06-01 22:15,ZGC,5428,737-800,15,6,23,5,8,26,,,,,8,11
2019-06-01 22:11,HAK,1505,737-800,25,3,28,30,5,5,,,,,3,-20
2019-06-01 22:09,URC,1322,737-800,25,4,27,5,5,27,,,,,2,2
2019-06-01 20:53,ÐìÖÝ,7167,737-800,20,5,21,5,4,28,,,,,1,8
2019-06-01 19:58,HAK,5463,737-800,25,4,29,5,4,29,,,,,4,4
2019-06-01 19:56,HHA,5478,737-800,22,4,32,4,5,30,,,,,10,8
2019-06-01 19:56,XIY,5180,737-800,33,9,36,7,6,28,,,,,3,-5
2019-06-01 19:51,CGO,5153,737-800,33,3,30,4,3,29,,,,,-3,-4
2019-06-01 19:36,URC,1323,737-800,34,3,30,4,4,30,,,,,-4,-4
2019-06-01 19:31,HAK,7400,737-800,27,6,35,5,5,32,,,,,8,5
2019-06-01 18:44,PEK ,5482,737-800,29,2,30,4,4,32,,,,,1,3
2019-06-01 17:54,URC,206P,737-800,30,4,24,4,5,24,,,,,-6,-6
2019-06-01 16:49,XIY,5116,737-800,30,4,26,4,5,25,,,,,-4,-5
2019-06-01 16:37,URC,1325,737-800,30,4,20,4,4,20,,,,,-10,-10
2019-06-01 15:46,HAK,5855,737-800,25,4,30,6,6,28,,,,,5,3
2019-06-01 11:49,URC,5735,737-800,26,2,24,3,2,25,,,,,-2,-1
2019-06-01 11:13,CTU,7992,737-800,30,7,31,8,7,31,,,,,1,1
2019-06-01 10:42,XMN,6065,737-800,26,5,32,4,4,32,,,,,6,6
2019-06-01 10:42,XMN,5520,737-800,27,5,30,6,6,30,,,,,3,3
2019-06-01 10:41,XMN,6061,737-800,26,4,30,4,4,32,,,,,4,6
2019-06-01 10:40,XMN,7616,737-800,27,4,32,4,4,32,,,,,5,5
2019-06-01 09:41,CAN,1929,737-800,26,4,34,4,4,31,,,,,8,5
2019-06-01 09:41,CAN,5709,737-800,26,6,38,6,6,35,,,,,12,9
2019-06-01 09:40,CAN,5429,737-800,25,3,30,4,4,30,,,,,5,5
2019-06-01 09:39,CAN,1490,737-800,26,5,34,6,6,32,,,,,8,6
2019-06-01 08:37,ZUH,1927,737-800,28,4,30,7,5,30,,,,,2,2
2019-06-01 08:32,PEK,7171,737-800,23,5,26,6,6,28,,,,,3,5
2019-06-01 07:59,HAK,1103,737-800,30,4,35,5,5,30,,,,,5,0
2019-06-01 07:54,HAK,7619,737-800,25,5,30,5,5,30,,,,,5,5
2019-06-01 07:45,MIG,5449,737-800,30,5,33,5,6,30,,,,,3,0
2019-06-01 07:35,HAK,5712,737-800,34,3,30,3,4,30,,,,,-4,-4
2019-06-01 07:13,PEK,1548,737-800,25,5,25,4,4,19,,,,,0,-6
2019-06-01 06:26,HGH,5337,737-800,23,4,28,4,4,28,,,,,5,5
2019-06-01 06:19,KMG,1208,737-800,16,3,26,3,3,24,,,,,10,8
2019-06-01 05:48,CGO,5462,737-800,30,4,28,4,4,27,,,,,-2,-3
2019-06-01 05:42,HRB,1562,737-800,15,4,29,4,4,26,,,,,14,11
2019-06-01 05:12,HGH,1786,737-800,23,4,28,4,4,28,,,,,5,5
2019-06-01 05:04,FOC,1435,737-800,25,6,36,6,5,34,,,,,11,9
2019-06-01 05:03,159,7993,737-800,20,6,28,5,6,24,,,,,8,4
2019-06-01 05:01,PEK,5141,737-800,23,4,26,5,4,28,,,,,3,5
2019-06-01 04:56,URC,5735,737-800,26,24,2,3,2,25,,,,,-24,-1
2019-06-01 04:51,PEK,5713,737-800,25,3,20,4,5,16,,,,,-5,-9
2019-06-01 04:49,HGH,1785,737-800,21,6,28,5,6,28,,,,,7,7
2019-06-01 04:47,FOC,1541,737-800,22,4,32,5,4,24,,,,,10,2
2019-06-01 04:44,XIY ,5153,737-800,21,3,26,6,7,26,,,,,5,5
2019-06-01 04:43,XIY,1163,737-800,20,2,28,3,2,25,,,,,8,5
2019-06-01 04:40,FOC,1541,737-800,22,4,36,6,5,24,,,,,14,2
2019-06-01 04:40,URC,1793,737-800,22,5,21,6,5,26,,,,,-1,4
2019-06-01 04:33,HHA,5466,737-800,23,3,25,5,3,23,,,,,2,0
2019-06-01 04:21,KMG ,7991,737-800,18,6,25,6,6,26,,,,,7,8
2019-06-01 04:12,KMG,5732,737-800,20,3,24,3,3,24,,,,,4,4
2019-06-01 04:09,XIY,5115,737-800,15,4,18,4,5,20,,,,,3,5
2019-06-01 04:07,XIY,1215,737-800,20,6,26,6,6,26,,,,,6,6
2019-06-01 03:59,SZX,1487,737-800,25,3,36,3,3,34,,,,,11,9
2019-06-01 03:55,SZX,1102,737-800,25,3,36,4,4,36,,,,,11,11
2019-06-01 03:50,SZX,1787,737-800,27,7,37,8,8,37,1,1,,11,10,10
2019-06-01 03:48,SYX,5408,737-800,25,8,36,6,4,30,1,,,1,11,5
2019-06-01 03:47,TYN,5418,737-800,22,4,20,5,5,24,,,,,-2,2
2019-06-01 03:44,URC,7379,737-800,15,4,26,4,4,26,,,,,11,11
2019-06-01 03:37,PEK,5539,737-800,24,5,30,6,5,24,,,,,6,0
2019-06-01 03:32,URC,7198,737-800,23,4,28,6,5,27,,,,,5,4
2019-06-01 03:24,MIG,1798,737-800,21,6,32,8,8,28,,,,,11,7
2019-06-01 03:24,URC,1570,737-800,20,5,24,6,7,23,,,,,4,3
2019-06-01 03:22,URC,1725,737-800,25,6,28,6,6,28,,,,,3,3
2019-06-01 03:21,HGH,1130,737-800,22,5,24,4,3,26,,,,,2,4
2019-06-01 03:20,FOC,7105,737-800,22,4,31,3,3,31,,,,,9,9
2019-06-01 03:20,HHA,5478,737-800,22,2,28,3,2,29,,,,,6,7
2019-06-01 03:11,URC,205T,737-800,20,4,26,4,4,26,,,,,6,6
2019-06-01 03:10,SYX,1492,737-800,31,4,34,3,3,32,,,,,3,1
2019-06-01 03:09,CAN,1783,737-800,26,4,34,5,4,36,,,,,8,10
2019-06-01 03:08,CAN,5359,737-800,26,9,36,5,5,34,,,,,10,8
2019-06-01 03:07,PEK ,5482,737-800,27,0,24,6,8,30,,,,,-3,3
2019-06-01 03:04,HAK,5540,737-800,28,5,35,4,4,34,,,,,7,6
2019-06-01 03:04,DLC,5687,737-800,22,4,26,4,4,26,,,,,4,4
2019-06-01 02:54,KMG,1586,737-800,15,4,29,4,4,29,,,,,14,14
2019-06-01 02:53,HGH,1491,737-800,26,6,24,4,6,26,,,,,-2,0
2019-06-01 02:52,SYX,7172,737-800,28,5,36,6,4,35,,,,,8,7
2019-06-01 02:49,HRB,7395,737-800,22,6,28,6,6,26,,,,,6,4
2019-06-01 02:45,HAK,7175,737-800,26,6,33,6,5,31,,,,,7,5
2019-06-01 02:43,XIY,1483,737-800,20,5,24,5,6,25,,,,,4,5
2019-06-01 02:39,FOC,1906,737-800,27,7,34,7,7,34,,,,,7,7
2019-06-01 02:37,PEK,1796,737-800,28,4,26,6,4,24,,,,,-2,-4
2019-06-01 02:35,XIY,5375,737-800,21,4,24,4,4,24,,,,,3,3
2019-06-01 02:31,URC,5611,737-800,24,5,24,5,6,25,,,,,0,1
2019-06-01 02:31,KMG,5407,737-800,15,3,24,4,3,22,,,,,9,7
2019-06-01 02:30,KMG,6800,737-800,17,4,24,4,4,22,,,,,7,5
2019-06-01 02:27,SZX,1727,737-800,25,5,35,5,5,39,,,,,10,14
2019-06-01 02:27,XIY,1481,737-800,23,6,24,6,6,24,,,,,1,1
2019-06-01 02:24,KMG ,7167,737-800,18,6,23,5,7,25,,,,,5,7
2019-06-01 02:24,TYN,206G,737-800,25,4,28,4,4,27,,,,,3,2
2019-06-01 02:20,ÈýÑÇ,5136,737-800,25,2,36,4,4,32,1,,,1,11,7
2019-06-01 02:20,ÈýÑÇ,5463,737-800,25,6,34,6,6,30,,,,,9,5
2019-06-01 02:18,HAK,5372,737-800,29,6,30,6,7,32,,,,,1,3
2019-06-01 02:15,HAK,5733,737-800,25,6,36,7,6,36,1,1,,11,11,11
2019-06-01 02:15,PEK,1538,737-800,24,3,27,4,3,26,,,,,3,2
2019-06-01 02:12,XIY,5346,737-800,23,7,28,6,6,26,,,,,5,3
2019-06-01 02:10,HHA,1373,737-800,24,4,33,4,4,27,,,,,9,3
2019-06-01 02:10,DLC,1213,737-800,23,5,27,5,5,26,,,,,4,3
2019-06-01 02:10,SYX,5686,737-800,28,5,34,5,5,34,,,,,6,6
2019-06-01 02:09,103,5538,737-800,25,2,31,2,2,31,,,,,6,6
2019-06-01 02:07,FOC,5182,737-800,22,2,31,4,3,26,,,,,9,4
2019-06-01 02:07,HHA,7886,737-800,25,4,30,4,4,30,,,,,5,5
2019-06-01 02:04,URC,6268,737-800,25,4,30,2,2,26,,,,,5,1
2019-06-01 02:02,XIY,1161,737-800,23,4,30,3,3,30,,,,,7,7
2019-06-01 02:00,URC,1996,737-800,23,3,18,5,5,26,,,,,-5,3
2019-06-01 01:58,104,1488,737-800,24,7,29,5,5,32,,,,,5,8
2019-06-01 01:54,HAK,5522,737-800,25,6,34,8,8,35,,1,,1,9,10
2019-06-01 01:53,YIH,1351,737-800,23,5,32,4,5,29,,,,,9,6
2019-06-01 01:50,URC,5797,737-800,24,4,20,3,4,26,,,,,-4,2
2019-06-01 01:50,ZGC,5405,737-800,15,4,24,4,4,20,,,,,9,5
2019-06-01 01:50,SYX,1733,737-800,25,2,32,2,2,29,,,,,7,4
2019-06-01 01:47,HAK,1545,737-800,27,4,36,6,5,37,,1,,1,9,10
2019-06-01 01:47,PEK,1497,737-800,27,4,27,4,4,26,,,,,0,-1
2019-06-01 01:42,XIY,5116,737-800,22,6,24,6,6,22,,,,,2,0
2019-06-01 01:40,URC,5798,737-800,25,2,22,3,2,22,,,,,-3,-3
2019-06-01 01:39,HHA,1729,737-800,27,4,25,5,3,28,,,,,-2,1
2019-06-01 01:33,KMG,6016,737-800,20,5,33,5,5,29,,,,,13,9
2019-06-01 01:31,MIG,5409,737-800,21,4,28,2,3,26,,,,,7,5
2019-06-01 01:29,DLC,1347,737-800,21,4,26,3,3,24,,,,,5,3
2019-06-01 01:28,ZGC,1542,737-800,12,4,26,5,4,22,,,,,14,10
2019-06-01 01:27,SZX,1496,737-800,27,4,32,6,6,34,,,,,5,7
2019-06-01 01:26,URC,1568,737-800,25,8,27,7,6,26,,,,,2,1
2019-06-01 01:25,CAN,1502,737-800,25,4,34,4,4,34,,,,,9,9
2019-06-01 01:22,CAN,5521,737-800,27,6,30,6,5,31,,,,,3,4
2019-06-01 01:21,CAN,5481,737-800,26,6,35,6,5,34,,,,,9,8
2019-06-01 01:20,HAK,1141,737-800,25,8,36,5,5,35,,,,,11,10
2019-06-01 01:19,,5481,737-800,26,6,35,6,5,34,,,,,9,8
2019-06-01 01:19,TYN,5502,737-800,25,5,25,5,5,24,,,,,0,-1
2019-06-01 01:10,SZX,1386,737-800,26,4,35,3,4,34,,,,,9,8
2019-06-01 01:09,HHA,7398,737-800,24,4,28,4,4,29,,,,,4,5
2019-06-01 01:06,CGO,5479,737-800,25,5,28,5,5,28,,,,,3,3
2019-06-01 01:04,PEK,6103,737-800,25,5,28,5,5,32,,,,,3,7
2019-06-01 01:03,HAK,7399,737-800,26,4,34,4,4,30,,,,,8,4
2019-06-01 00:59,SZX,5620,737-800,28,6,36,5,6,34,,,,,8,6
2019-06-01 00:58,TYN,5090,737-800,20,2,22,2,2,24,,,,,2,4
2019-06-01 00:57,PEK,1735,737-800,25,4,26,6,4,22,,,,,1,-3
2019-06-01 00:55,CGO,1209,737-800,24,3,33,4,4,32,,,,,9,8
2019-06-01 00:54,Ö£ÖÝ,7988,737-800,25,5,30,5,4,30,,,,,5,5
2019-06-01 00:52,URC,5637,737-800,20,2,26,2,2,23,,,,,6,3
2019-06-01 00:50,HGH,5661,737-800,23,3,24,4,4,25,,,,,1,2
2019-06-01 00:49,URC,1569,737-800,27,3,26,3,4,28,,,,,-1,1
2019-06-01 00:45,HGH,1131,737-800,28,4,30,4,4,28,,,,,2,0
2019-06-01 00:43,HAK,1503,737-800,27,3,36,4,3,32,,,,,9,5
2019-06-01 00:40,HGH,5417,737-800,24,4,26,4,4,28,,,,,2,4
2019-06-01 00:39,HAK,5358,737-800,26,6,34,5,6,32,,,,,8,6
2019-06-01 00:30,KHG,206P,737-800,20,3,23,2,3,22,,,,,3,2
2019-06-01 00:29,HAK,1997,737-800,28,5,35,2,3,35,,,,,7,7
2019-06-01 00:29,XIY,5483,737-800,25,4,28,5,5,28,,,,,3,3
2019-06-01 00:27,CGO,1587,737-800,25,3,32,4,3,28,,,,,7,3
2019-06-01 00:21,HAK,7173,737-800,25,4,36,4,4,36,1,1,,11,11,11
2019-06-01 00:21,DLC,5465,737-800,21,5,25,5,5,25,,,,,4,4
2019-06-01 00:21,PEK,5636,737-800,27,4,29,6,4,28,,,,,2,1
2019-06-01 00:21,CAN,5521,737-800,27,6,30,6,5,31,,,,,3,4
2019-06-01 00:19,URC,5638,737-800,25,4,26,4,4,28,,,,,1,3
2019-06-01 00:16,CKG,7400,737-800,24,5,24,4,5,24,,,,,0,0
2019-06-01 00:11,TYN,1728,737-800,23,4,26,4,4,22,,,,,3,-1
2019-06-01 00:08,CKG,5371,737-800,23,7,27,7,7,27,,,,,4,4
2019-06-01 00:08,FOC,1559,737-800,24,3,28,3,2,32,,,,,4,8
2019-06-01 00:07,HHA,5467,737-800,25,1,30,1,2,27,,,,,5,2
2019-06-01 00:07,CKG,1498,737-800,23,4,30,4,4,30,,,,,7,7
2019-05-31 23:55,URC,5853,737-800,25,5,32,5,5,27,,,,,7,2
2019-05-31 23:55,URC,1995,737-800,25,6,27,6,6,28,,,,,2,3
2019-05-31 23:53,XIY,1489,737-800,25,4,30,5,4,26,,,,,5,1
2019-05-31 23:51,HAK,7990,737-800,26,3,32,3,4,33,,,,,6,7
2019-05-31 23:50,´óÁ¬,1372,737-800,21,6,26,4,4,24,,,,,5,3
2019-05-31 23:47,URC,1322,737-800,25,2,26,4,4,26,,,,,1,1
2019-05-31 23:33,Ö£ÖÝ,1323,737-800,25,4,30,3,3,28,,,,,5,3
2019-05-31 23:29,URC,5662,737-800,27,3,23,4,7,26,,,,,-4,-1
2019-05-31 23:22,CAN,5580,737-800,27,8,35,8,7,37,,,,,8,10
2019-05-31 23:21,HHA,7377,737-800,24,5,29,5,5,28,,,,,5,4
2019-05-31 23:11,DLC,1493,737-800,22,6,23,6,6,24,,,,,1,2
2019-05-31 23:06,CAN,1502,737-800,25,4,34,4,4,34,,,,,9,9
2019-05-31 23:05,HAK ,1799,737-800,25,3,34,6,6,32,,,,,9,7
2019-05-31 23:02,HAK,1726,737-800,28,7,36,5,5,32,,,,,8,4
2019-05-31 22:58,SYX,5135,737-800,28,2,37,6,4,34,,,,,9,6
2019-05-31 22:58,URC,2159,737-800,15,6,23,4,4,26,,,,,8,11
2019-05-31 22:57,Î÷Äþ,5139,737-800,16,6,23,7,4,25,,,,,7,9
2019-05-31 22:54,HAK,206H,737-800,26,2,25,2,2,25,,,,,-1,-1
2019-05-31 22:50,HGH,5625,737-800,23,4,26,3,5,25,,,,,3,2
2019-05-31 22:46,HRB,1350,737-800,15,4,29,4,4,25,,,,,14,10
2019-05-31 22:31,HGH,5337,737-800,23,4,28,4,4,28,,,,,5,5
2019-05-31 22:25,XIY,1549,737-800,24,6,30,5,5,30,,,,,6,6
2019-05-31 22:22,SYX,206F,737-800,25,2,35,2,2,30,1,,,1,10,5
2019-05-31 22:18,ZGC,5428,737-800,15,6,22,4,8,26,,,,,7,11
2019-05-31 22:13,HAK,2157,737-800,27,6,32,6,6,32,,,,,5,5
2019-05-31 22:11,Ö£ÖÝ,1588,737-800,27,4,30,5,5,30,,,,,3,3
2019-05-31 22:06,URC,5623,737-800,25,6,30,6,6,26,,,,,5,1
2019-05-31 22:00,XIY,1346,737-800,20,6,28,6,6,26,,,,,8,6
2019-05-31 22:00,Î÷Äþ,5338,737-800,20,2,20,5,4,26,,,,,0,6
2019-05-31 22:00,HAK,5083,737-800,28,5,28,6,6,35,,,,,0,7
2019-05-31 21:51,HAK,5082,737-800,25,3,33,5,5,32,,,,,8,7
2019-05-31 21:51,URC,205U,737-800,25,5,26,5,5,27,,,,,1,2
2019-05-31 21:49,HAK,5089,737-800,27,5,30,1,1,34,,,,,3,7
2019-05-31 21:37,HAK,6060,737-800,27,5,33,5,5,32,,,,,6,5
2019-05-31 21:31,FOC,5503,737-800,22,2,28,3,3,26,,,,,6,4
2019-05-31 21:31,DLC,1795,737-800,22,4,24,4,4,26,,,,,2,4
2019-05-31 21:20,ZGC,7478,737-800,15,6,22,6,6,25,,,,,7,10
2019-05-31 21:12,HAK,1547,737-800,30,6,36,6,6,37,,,,,6,7
2019-05-31 21:10,CGO,1495,737-800,27,4,28,4,4,27,,,,,1,0
2019-05-31 21:01,HAK,5416,737-800,32,7,36,8,8,36,,,,,4,4
2019-05-31 20:51,´óÁ¬,5855,737-800,20,6,26,6,6,22,,,,,6,2
2019-05-31 20:42,DLC,1928,737-800,21,5,22,4,5,22,,,,,1,1
2019-05-31 20:42,CGO,6015,737-800,27,4,29,4,4,26,,,,,2,-1
2019-05-31 20:29,TYN,5439,737-800,26,5,20,5,6,21,,,,,-6,-5
2019-05-31 19:23,HRB,1433,737-800,18,3,28,3,3,21,,,,,10,3
2019-05-31 19:13,URC,205V,737-800,30,4,30,4,4,28,,,,,0,-2
2019-05-31 18:05,XUZ,7989,737-800,26,6,36,4,4,36,1,1,,11,10,10
2019-05-31 16:05,URC,1322,737-800,25,4,23,5,4,21,,,,,-2,-4
2019-05-31 15:38,HRB,1348,737-800,22,1,30,6,7,28,,,,,8,6
2019-05-31 13:36,YIH,1905,737-800,25,4,29,4,3,26,,,,,4,1
2019-05-31 13:21,URC,6268,737-800,30,3,27,4,4,26,,,,,-3,-4
2019-05-31 13:18,ÃàÑô,5407,737-800,29,4,28,6,4,28,,,,,-1,-1
2019-05-31 09:35,XMN,5502,737-800,26,4,30,6,4,30,,,,,4,4
2019-05-31 09:34,XMN,5406,737-800,27,4,32,6,3,28,,,,,5,1
2019-05-31 09:34,XMN,6103,737-800,25,2,25,3,4,30,,,,,0,5
2019-05-31 09:04,XIY,1163,737-800,20,2,32,2,2,25,,,,,12,5
2019-05-31 08:46,HAK,1545,737-800,26,6,37,5,5,37,,,,,11,11
2019-05-31 08:42,PEK ,5661,737-800,25,4,20,6,4,26,,,,,-5,1
2019-05-31 08:28,HAK,6062,737-800,25,3,38,6,6,18,,,,,13,-7
2019-05-31 07:41,KMG,5732,737-800,15,2,23,3,2,23,,,,,8,8
2019-05-31 07:03,PEK,5482,737-800,25,1,26,7,7,29,,,,,1,4
2019-05-31 06:56,ZGC,1542,737-800,20,8,20,9,7,22,,,,,0,2
2019-05-31 06:55,ZGC,5463,737-800,20,7,20,6,8,21,,,,,0,1
2019-05-31 06:49,PEK,5373,737-800,25,28,6,8,8,26,,,,,-19,1
2019-05-31 06:46,PEK,1498,737-800,20,24,4,4,4,22,,,,,-16,2
2019-05-31 06:20,XIY,5115,737-800,22,4,20,6,6,28,,,,,-2,6
2019-05-31 06:11,HAK,1541,737-800,27,9,37,6,8,36,1,,,1,10,9
2019-05-31 06:09,HAK,1787,737-800,27,8,36,6,6,34,,,,,9,7
2019-05-31 05:45,FOC,7105,737-800,23,3,32,3,4,30,,,,,9,7
2019-05-31 05:34,CTU,7990,737-800,20,3,29,3,4,29,,,,,9,9
2019-05-31 05:28,XIY,1902,737-800,19,5,30,5,5,29,,,,,11,10
2019-05-31 05:21,URC,2157,737-800,22,4,24,4,4,24,,,,,2,2
2019-05-31 05:15,FOC,1906,737-800,23,5,32,6,6,33,,,,,9,10
2019-05-31 05:09,HGH,5467,737-800,22,1,31,2,1,25,,,,,9,3
2019-05-31 05:09,FOC,5182,737-800,23,3,30,3,3,29,,,,,7,6
2019-05-31 05:02,HGH,7378,737-800,20,6,32,6,6,30,,,,,12,10
2019-05-31 05:01,KMG,1208,737-800,13,4,25,4,4,22,,,,,12,9
2019-05-31 04:58,HHA,6065,737-800,22,4,32,4,4,34,,,,,10,12
2019-05-31 04:45,TYN,206G,737-800,15,3,22,4,4,24,,,,,7,9
2019-05-31 04:39,XIY,1163,737-800,21,3,36,3,2,31,,,,,15,10
2019-05-31 04:33,KMG,7989,737-800,15,6,26,6,5,26,,,,,11,11
2019-05-31 04:33,KMG,1588,737-800,14,4,25,4,4,26,,,,,11,12
2019-05-31 04:29,º£¿Ú,7175,737-800,25,4,30,4,4,30,,,,,5,5
2019-05-31 04:25,SYX,5135,737-800,31,5,33,4,2,33,,,,,2,2
2019-05-31 04:23,CKG,7618,737-800,20,4,24,5,5,25,,,,,4,5
2019-05-31 04:22,CAN,5429,737-800,25,4,34,4,5,35,1,1,,11,9,10
2019-05-31 04:22,HAK,5338,737-800,28,2,28,4,4,33,,,,,0,5
2019-05-31 04:18,SYX,5136,737-800,26,5,32,5,5,34,,,,,6,8
2019-05-31 04:09,SYX,5135,737-800,31,5,33,4,2,33,,,,,2,2
2019-05-31 04:07,HGH,1728,737-800,21,4,29,4,4,21,,,,,8,0
2019-05-31 04:05,PEK,5408,737-800,22,4,24,4,2,21,,,,,2,-1
2019-05-31 04:03,KMG,1588,737-800,14,25,4,4,4,26,,,,,-10,12
2019-05-31 04:02,HAK,1783,737-800,24,4,22,5,4,35,,1,,1,-2,11
2019-05-31 04:00,URC,205T,737-800,23,2,26,2,3,26,,,,,3,3
2019-05-31 04:00,URC,7198,737-800,22,4,26,5,5,26,,,,,4,4
2019-05-31 03:59,URC,5853,737-800,23,5,27,4,4,24,,,,,4,1
2019-05-31 03:59,URC,5735,737-800,22,2,27,2,2,22,,,,,5,0
2019-05-31 03:58,URC,5798,737-800,22,2,22,2,3,21,,,,,0,-1
2019-05-31 03:56,MIG,5449,737-800,23,5,29,5,5,29,,,,,6,6
2019-05-31 03:55,FOC,5182,737-800,25,4,33,3,3,31,,,,,8,6
2019-05-31 03:53,URC,1996,737-800,22,2,20,4,4,24,,,,,-2,2
2019-05-31 03:50,XIY,1482,737-800,25,6,28,6,7,24,,,,,3,-1
2019-05-31 03:49,URC,5625,737-800,21,4,24,4,4,25,,,,,3,4
2019-05-31 03:44,PEK ,7616,737-800,20,4,27,5,5,23,,,,,7,3
2019-05-31 03:43,KMG,1586,737-800,16,4,28,3,3,29,,,,,12,13
2019-05-31 03:34,PEK,5539,737-800,21,5,29,5,5,22,,,,,8,1
2019-05-31 03:33,HHA,5439,737-800,24,3,29,3,3,27,,,,,5,3
2019-05-31 03:25,URC,5638,737-800,22,4,26,4,4,26,,,,,4,4
2019-05-31 03:24,CAN,7173,737-800,26,4,35,6,5,30,,,,,9,4
2019-05-31 03:24,PEK,5538,737-800,20,2,30,4,4,30,,,,,10,10
2019-05-31 03:23,CAN,1490,737-800,25,5,35,5,5,30,,,,,10,5
2019-05-31 03:21,FOC,1549,737-800,24,5,29,6,5,29,,,,,5,5
2019-05-31 03:18,SYX,7172,737-800,26,3,31,3,3,32,,,,,5,6
2019-05-31 03:16,PEK,1488,737-800,23,6,26,6,6,24,,,,,3,1
2019-05-31 03:14,HHA,1729,737-800,21,4,25,4,4,24,,,,,4,3
2019-05-31 03:13,HHA,1373,737-800,25,4,30,4,3,26,,,,,5,1
2019-05-31 03:08,º£¿Ú,1346,737-800,25,4,34,4,8,30,,,,,9,5
2019-05-31 03:05,SZX,1102,737-800,26,4,36,4,4,34,,,,,10,8
2019-05-31 02:59,HHA,5405,737-800,20,4,30,4,4,30,,,,,10,10
2019-05-31 02:58,XIY,6066,737-800,23,4,30,2,2,28,,,,,7,5
2019-05-31 02:56,XIY,7113,737-800,25,4,28,4,4,28,,,,,3,3
2019-05-31 02:55,XIY,1161,737-800,23,4,30,4,3,28,,,,,7,5
2019-05-31 02:54,TYN,5090,737-800,20,2,22,2,2,23,,,,,2,3
2019-05-31 02:50,DLC,5465,737-800,20,4,24,4,5,27,,,,,4,7
2019-05-31 02:49,KMG,7988,737-800,15,5,27,6,4,26,,,,,12,11
2019-05-31 02:48,DLC,1928,737-800,20,4,26,6,6,24,,,,,6,4
2019-05-31 02:46,SZX,5372,737-800,25,8,36,8,7,34,,,,,11,9
2019-05-31 02:45,HAK,1793,737-800,25,6,28,6,6,32,,,,,3,7
2019-05-31 02:45,ZGC,5428,737-800,20,7,22,4,6,24,,,,,2,4
2019-05-31 02:44,HAK,5082,737-800,25,8,34,8,6,30,,,,,9,5
2019-05-31 02:43,DLC,1493,737-800,20,4,26,5,5,24,,,,,6,4
2019-05-31 02:41,ZGC,6061,737-800,20,7,22,6,5,20,,,,,2,0
2019-05-31 02:31,HAK,1726,737-800,28,3,37,4,3,32,,,,,9,4
2019-05-31 02:27,HAK,5522,737-800,27,6,34,8,7,33,,,,,7,6
2019-05-31 02:24,DLC,1347,737-800,21,4,28,4,4,26,,,,,7,5
2019-05-31 02:18,DLC,1101,737-800,20,3,30,4,4,30,,,,,10,10
2019-05-31 02:17,XIY,6060,737-800,25,8,28,5,4,26,,,,,3,1
2019-05-31 02:15,DLC,1538,737-800,20,3,27,2,3,25,,,,,7,5
2019-05-31 02:14,HGH,1130,737-800,21,3,30,2,2,28,,,,,9,7
2019-05-31 02:14,HAK,1386,737-800,26,4,35,4,4,33,,,,,9,7
2019-05-31 02:13,HGH,7639,737-800,21,3,30,2,3,30,,,,,9,9
2019-05-31 02:11,TYN,5375,737-800,20,0,16,6,5,20,,,,,-4,0
2019-05-31 02:09,HHA,5852,737-800,21,4,28,4,4,26,,,,,7,5
2019-05-31 02:09,CGO,1209,737-800,21,4,30,4,4,30,,,,,9,9
2019-05-31 02:06,FOC,7395,737-800,22,6,32,6,6,30,,,,,10,8
2019-05-31 02:05,HHA,6065,737-800,22,5,37,4,5,32,,,,,15,10
2019-05-31 02:02,SZX,5620,737-800,28,3,34,3,4,31,,,,,6,3
2019-05-31 02:01,XIY,5116,737-800,20,4,22,4,4,22,,,,,2,2
2019-05-31 02:01,FOC,1435,737-800,22,7,30,6,6,30,,,,,8,8
2019-05-31 01:57,SZX,5417,737-800,26,4,30,4,4,32,,,,,4,6
2019-05-31 01:56,KMG,1798,737-800,15,6,28,6,6,25,,,,,13,10
2019-05-31 01:48,XIY,5180,737-800,24,4,30,4,5,28,,,,,6,4
2019-05-31 01:45,HAK,7619,737-800,27,4,28,6,4,30,,,,,1,3
2019-05-31 01:45,HGH,1785,737-800,21,2,30,5,6,30,,,,,9,9
2019-05-31 01:43,XIY,5430,737-800,22,2,28,4,6,28,,,,,6,6
2019-05-31 01:42,KMG,7993,737-800,15,5,25,5,5,23,,,,,10,8
2019-05-31 01:41,CAN,5733,737-800,25,7,34,7,6,34,,,,,9,9
2019-05-31 01:41,YIH,1348,737-800,23,4,32,4,4,33,,,,,9,10
2019-05-31 01:41,CAN,5579,737-800,25,5,32,4,5,30,,,,,7,5
2019-05-31 01:40,CAN,7399,737-800,25,4,34,7,6,24,,,,,9,-1
2019-05-31 01:39,CAN,5709,737-800,25,4,36,3,4,35,1,1,,11,11,10
2019-05-31 01:35,CGO,6015,737-800,25,4,24,4,4,24,,,,,-1,-1
2019-05-31 01:33,DLC,1372,737-800,25,4,30,4,4,28,,,,,5,3
2019-05-31 01:30,PEK ,5687,737-800,20,3,20,3,3,25,,,,,0,5
2019-05-31 01:30,HGH,5637,737-800,22,2,30,2,2,27,,,,,8,5
2019-05-31 01:29,XIY,1481,737-800,23,6,30,6,5,29,,,,,7,6
2019-05-31 01:29,DLC,1795,737-800,20,4,26,4,4,27,,,,,6,7
2019-05-31 01:26,SYX,1547,737-800,26,6,36,8,8,36,,,,,10,10
2019-05-31 01:25,CGO,6800,737-800,21,4,28,4,4,26,,,,,7,5
2019-05-31 01:22,SZX,5662,737-800,26,3,31,5,3,30,,,,,5,4
2019-05-31 01:17,CGO,7991,737-800,21,5,30,6,6,30,,,,,9,9
2019-05-31 01:16,XIY,1213,737-800,25,6,30,5,5,30,,,,,5,5
2019-05-31 01:15,SZX,1503,737-800,26,3,34,4,3,32,,,,,8,6
2019-05-31 01:14,TYN,5418,737-800,20,4,20,4,4,22,,,,,0,2
2019-05-31 01:11,HGH,1786,737-800,22,5,27,4,4,26,,,,,5,4
2019-05-31 01:11,PEK,5539,737-800,21,5,29,5,5,22,,,,,8,1
2019-05-31 01:11,HAK,1491,737-800,30,6,36,6,6,36,,,,,6,6
2019-05-31 01:09,HAK,1997,737-800,25,6,34,4,4,29,,,,,9,4
2019-05-31 01:07,YIH,1351,737-800,23,4,32,5,4,30,,,,,9,7
2019-05-31 01:04,DLC,5713,737-800,20,6,20,3,4,25,,,,,0,5
2019-05-31 00:44,SZX,1496,737-800,26,4,31,4,4,33,,,,,5,7
2019-05-31 00:42,XIY,1495,737-800,24,3,28,5,6,26,,,,,4,2
2019-05-31 00:42,HRB,1562,737-800,12,4,24,5,4,25,,,,,12,13
2019-05-31 00:41,CAN,1502,737-800,26,3,34,4,4,34,,,,,8,8
2019-05-31 00:38,CGO,1587,737-800,25,3,29,2,3,29,,,,,4,4
2019-05-31 00:35,URC,1725,737-800,23,4,28,4,4,27,,,,,5,4
2019-05-31 00:33,HRB,1433,737-800,13,4,26,4,5,24,,,,,13,11
2019-05-31 00:32,XIY,1487,737-800,30,2,26,2,2,28,,,,,-4,-2
2019-05-31 00:28,SYX,1131,737-800,31,5,36,2,4,36,,,,,5,5
2019-05-31 00:26,XIY,6060,737-800,25,8,28,5,4,26,,,,,3,1
2019-05-31 00:24,PEK,1796,737-800,24,4,24,4,4,0,,,,,0,-24
2019-05-31 00:18,SYX,5462,737-800,28,5,36,6,5,36,,,,,8,8
2019-05-31 00:17,Î÷Äþ,1103,737-800,15,4,17,5,5,20,,,,,2,5
2019-05-31 00:15,URC,5712,737-800,24,2,24,4,4,24,,,,,0,0
2019-05-31 00:12,KHG,1569,737-800,23,4,20,5,6,20,,,,,-3,-3
2019-05-31 00:11,URC,1322,737-800,23,6,25,2,2,24,,,,,2,1
2019-05-31 00:11,HAK,5083,737-800,28,3,28,5,5,37,,,,,0,9
2019-05-31 00:10,CAN,5521,737-800,26,4,30,5,4,30,,,,,4,4
2019-05-31 00:10,CGO,1492,737-800,23,4,28,4,4,28,,,,,5,5
2019-05-31 00:07,XIY,5346,737-800,24,4,23,5,5,23,,,,,-1,-1
2019-05-31 00:02,CKG,7400,737-800,22,4,26,4,4,26,,,,,4,4
2019-05-30 23:58,5686,,737-800,18,4,26,5,5,24,,,,,8,6
2019-05-30 23:56,CGO,5416,737-800,25,6,28,6,6,27,,,,,3,2
2019-05-30 23:55,HAK,5141,737-800,26,5,31,4,4,30,,,,,5,4
2019-05-30 23:55,TYN,5623,737-800,20,6,26,5,5,24,,,,,6,4
2019-05-30 23:54,SZX,1727,737-800,27,4,34,5,5,30,,,,,7,3
2019-05-30 23:50,HRB,1350,737-800,13,4,22,4,4,22,,,,,9,9
2019-05-30 23:41,CGO,1323,737-800,24,2,24,2,2,27,,,,,0,3
2019-05-30 23:41,PEK,5687,737-800,20,3,20,3,3,25,,,,,0,5
2019-05-30 23:34,HAK,5480,737-800,26,6,36,6,3,18,,,,,10,-8
2019-05-30 23:33,URC,205U,737-800,22,4,26,4,4,26,,,,,4,4
2019-05-30 23:30,XIY,7379,737-800,23,2,22,2,4,24,,,,,-1,1
2019-05-30 23:27,PEK,5479,737-800,20,6,20,2,2,18,,,,,0,-2
2019-05-30 23:17,SYX,1733,737-800,29,2,32,4,4,28,,,,,3,-1
2019-05-30 23:13,MIG,5407,737-800,25,3,28,6,4,28,,,,,3,3
2019-05-30 23:13,XIY,1215,737-800,25,4,28,4,4,28,,,,,3,3
2019-05-30 23:01,HAK,6016,737-800,26,9,37,4,4,37,,,,,11,11
2019-05-30 22:53,HAK,5089,737-800,28,5,25,1,1,34,,,,,-3,6
2019-05-30 22:50,URC,2159,737-800,25,2,24,2,2,25,,,,,-1,0
2019-05-30 22:46,PEK,1548,737-800,25,4,23,3,3,22,,,,,-2,-3
2019-05-30 22:31,XIY,1162,737-800,25,4,30,4,3,32,,,,,5,7
2019-05-30 22:24,URC,1568,737-800,23,6,28,6,6,28,,,,,5,5
2019-05-30 22:24,URC,5636,737-800,27,4,26,4,4,26,,,,,-1,-1
2019-05-30 22:21,SYX,206F,737-800,29,3,34,3,3,30,,,,,5,1
2019-05-30 22:17,XIY,1903,737-800,25,2,26,2,2,32,,,,,1,7
2019-05-30 22:16,HAK,206H,737-800,26,3,34,3,3,32,,,,,8,6
2019-05-30 22:11,Î÷Äþ,1375,737-800,21,5,24,5,4,20,,,,,3,-1
2019-05-30 22:09,FOC,5503,737-800,24,4,30,4,4,28,,,,,6,4
2019-05-30 21:35,CTU,7992 ,737-800,24,7,31,8,7,30,,,,,7,6
2019-05-30 21:32,PEK,5540,737-800,25,4,28,3,3,27,,,,,3,2
2019-05-30 21:18,URC,1570,737-800,25,8,20,6,6,22,,,,,-5,-3
2019-05-30 21:11,ÐìÖÝ,7167,737-800,20,7,31,7,7,28,,,,,11,8
2019-05-30 21:11,HRB,1559,737-800,15,4,27,3,4,24,,,,,12,9
2019-05-30 21:04,MIG,6809,737-800,20,5,26,6,6,28,,,,,6,8
2019-05-30 20:02,URC,206P,737-800,25,8,25,6,6,23,,,,,0,-2
2019-05-30 19:51,HHA,7398,737-800,20,2,30,2,2,29,,,,,10,9
2019-05-30 19:46,HAK,1929,737-800,25,4,32,4,4,32,,,,,7,7
2019-05-30 19:38,HAK,5137,737-800,27,5,26,2,3,32,,,,,-1,5
2019-05-30 18:09,URC,1325,737-800,23,4,18,4,4,22,,,,,-5,-1
2019-05-30 17:47,YIH,1905,737-800,24,3,29,3,4,25,,,,,5,1
2019-05-30 17:01,HRB,1559,737-800,23,4,26,4,4,26,,,,,3,3
2019-05-30 16:51,URC,205V,737-800,30,4,26,4,3,25,,,,,-4,-5
2019-05-30 15:50,FOC,1906,737-800,30,6,34,6,6,33,,,,,4,3
2019-05-30 15:49,FOC,1906,737-800,32,8,36,7,7,34,,,,,4,2
2019-05-30 11:30,CTU,7992,737-800,25,6,29,6,6,28,,,,,4,3
2019-05-30 09:58,KMG,5449,737-800,20,7,26,8,6,26,,,,,6,6
2019-05-30 09:39,PEK,6066,737-800,27,2,31,3,3,28,,,,,4,1
2019-05-30 08:51,CGO,1547,737-800,22,6,23,6,6,24,,,,,1,2
2019-05-30 08:25,HAK,5480,737-800,28,6,35,4,3,18,,,,,7,-10
2019-05-30 08:11,PEK,1787,737-800,30,2,32,6,5,32,,,,,2,2
2019-05-30 08:10,PEK,5797,737-800,25,5,27,5,5,28,,,,,2,3
2019-05-30 07:28,PEK,1726,737-800,25,4,30,4,4,26,,,,,5,1
2019-05-30 07:02,HAK,5141,737-800,27,5,32,5,5,28,,,,,5,1
2019-05-30 07:00,KMG,7991,737-800,20,6,30,8,8,24,,,,,10,4
2019-05-30 07:00,PEK,5482,737-800,27,4,24,3,4,25,,,,,-3,-2
2019-05-30 06:51,FOC,5503,737-800,24,4,25,3,3,25,,,,,1,1
2019-05-30 06:50,FOC,5503,737-800,24,4,26,3,3,25,,,,,2,1
2019-05-30 06:43,SZX,5662,737-800,25,3,30,3,5,30,,,,,5,5
2019-05-30 05:57,HAK,1799,737-800,26,4,35,6,5,32,,,,,9,6
2019-05-30 05:49,PEK,1549,737-800,24,5,30,6,6,28,,,,,6,4
2019-05-30 05:45,URC,1570,737-800,20,4,22,4,5,21,,,,,2,1
2019-05-30 05:44,URC,1141,737-800,20,5,30,6,6,22,,,,,10,2
2019-05-30 05:42,KMG,6016,737-800,20,3,23,4,3,28,,,,,3,8
2019-05-30 05:29,XIY,5853,737-800,17,4,24,4,5,26,,,,,7,9
2019-05-30 05:28,KMG,7167,737-800,20,6,26,5,5,26,,,,,6,6
2019-05-30 05:05,HGH,5359,737-800,23,4,24,4,4,24,,,,,1,1
2019-05-30 05:04,HGH,1728,737-800,23,4,30,4,4,30,,,,,7,7
2019-05-30 04:51,FOC,7105,737-800,21,3,30,3,3,30,,,,,9,9
2019-05-30 04:41,XIY,7113,737-800,20,5,28,5,5,26,,,,,8,6
2019-05-30 04:37,HRB,1562,737-800,21,5,29,5,6,27,,,,,8,6
2019-05-30 04:34,FOC,1435,737-800,21,4,35,6,6,36,,,,,14,15
2019-05-30 04:34,FOC,1435,737-800,20,4,32,4,4,32,,,,,12,12
2019-05-30 04:23,HAK,1102,737-800,26,4,36,6,4,36,,,,,10,10
2019-05-30 04:20,FOC,5520,737-800,23,4,27,5,5,28,,,,,4,5
2019-05-30 04:19,SYX,1786,737-800,27,2,29,0,0,25,,,,,2,-2
2019-05-30 04:18,DLC,6060,737-800,20,3,28,4,4,25,,,,,8,5
2019-05-30 04:11,URC,6268,737-800,20,4,26,5,5,25,,,,,6,5
2019-05-30 04:05,SYX,7400,737-800,25,6,34,6,5,32,,,,,9,7
2019-05-30 03:57,HAK,1130,737-800,25,2,36,3,3,35,,,,,11,10
2019-05-30 03:50,PEK,5538,737-800,25,4,30,4,4,34,,,,,5,9
2019-05-30 03:44,SYX,1733,737-800,27,4,34,6,6,36,,,,,7,9
2019-05-30 03:36,HHA,7638,737-800,25,4,29,3,4,28,,,,,4,3
2019-05-30 03:33,HAK,5709,737-800,25,6,34,7,6,34,,,,,9,9
2019-05-30 03:27,SZX,7619,737-800,25,5,31,5,6,30,,,,,6,5
2019-05-30 03:27,HGH,6061,737-800,25,3,29,5,4,28,,,,,4,3
2019-05-30 03:23,SZX,5620,737-800,25,2,36,4,4,32,,,,,11,7
2019-05-30 03:23,HAK,5540,737-800,26,6,36,6,6,32,,,,,10,6
2019-05-30 03:19,SYX,7172,737-800,27,6,36,6,4,34,,,,,9,7
2019-05-30 03:15,CAN,5483,737-800,25,4,32,4,4,30,,,,,7,5
2019-05-30 03:14,CAN,1783,737-800,25,4,28,6,4,34,,,,,3,9
2019-05-30 03:14,URC,7198,737-800,18,4,26,4,4,26,,,,,8,8
2019-05-30 03:14,URC,5625,737-800,19,5,28,5,5,26,,,,,9,7
2019-05-30 03:08,SZX,1386,737-800,25,2,34,4,4,32,,,,,9,7
2019-05-30 03:06,XIY,1482,737-800,20,4,28,5,5,22,,,,,8,2
2019-05-30 03:04,MIG,5732,737-800,18,3,27,3,3,26,,,,,9,8
2019-05-30 03:01,CGO,6015,737-800,22,4,28,4,2,27,,,,,6,5
2019-05-30 02:57,CAN,5713,737-800,25,6,30,7,7,30,,,,,5,5
2019-05-30 02:56,PEK,6062,737-800,26,4,30,4,4,30,,,,,4,4
2019-05-30 02:52,SYX,5136,737-800,27,4,32,5,5,35,,,,,5,8
2019-05-30 02:46,XIY,5180,737-800,17,3,26,4,4,25,,,,,9,8
2019-05-30 02:46,XIY,1902,737-800,17,4,28,3,4,26,,,,,11,9
2019-05-30 02:43,HAK,5429,737-800,25,7,36,8,8,37,,1,,1,11,12
2019-05-30 02:42,DLC,1490,737-800,22,5,28,6,6,28,,,,,6,6
2019-05-30 02:37,ZGC,5375,737-800,10,4,16,8,9,18,,,,,6,8
2019-05-30 02:37,HAK,6808,737-800,26,4,35,5,4,32,,,,,9,6
2019-05-30 02:37,DLC,1101,737-800,22,2,28,2,2,26,,,,,6,4
2019-05-30 02:36,ZGC,5428,737-800,15,7,24,5,4,21,,,,,9,6
2019-05-30 02:36,XIY,1162,737-800,18,3,32,3,3,32,1,1,,11,14,14
2019-05-30 02:35,SZX,1503,737-800,25,3,31,3,3,31,,,,,6,6
2019-05-30 02:35,XIY,1213,737-800,18,6,30,6,6,28,,,,,12,10
2019-05-30 02:34,DLC,1347,737-800,24,4,28,4,4,28,,,,,4,4
2019-05-30 02:33,PEK,5373,737-800,25,5,28,6,6,28,,,,,3,3
2019-05-30 02:33,XIY,5139,737-800,20,4,22,4,3,24,,,,,2,4
2019-05-30 02:33,ZGC,5502,737-800,15,5,21,7,6,22,,,,,6,7
2019-05-30 02:26,ZGC,1542,737-800,10,4,23,5,6,24,,,,,13,14
2019-05-30 02:26,XIY,1163,737-800,18,4,30,3,3,32,,,,,12,14
2019-05-30 02:24,XIY,5855,737-800,17,5,26,6,5,24,,,,,9,7
2019-05-30 02:24,URC,205T,737-800,20,2,22,2,2,24,,,,,2,4
2019-05-30 02:23,HHA,6065,737-800,23,8,35,7,9,32,1,,,1,12,9
2019-05-30 02:22,HAK,1502,737-800,26,3,34,4,4,32,,,,,8,6
2019-05-30 02:13,HGH,1215,737-800,25,4,29,4,4,28,,,,,4,3
2019-05-30 02:13,PEK,1796,737-800,24,4,30,4,4,0,,,,,6,-24
2019-05-30 02:13,URC,5712,737-800,20,2,22,3,2,20,,,,,2,0
2019-05-30 02:12,URC,1995,737-800,18,5,26,5,6,27,,,,,8,9
2019-05-30 02:10,XIY,5116,737-800,17,4,20,2,4,24,,,,,3,7
2019-05-30 02:06,KMG,1209,737-800,20,3,28,3,4,29,,,,,8,9
2019-05-30 02:03,HHA,1373,737-800,23,2,29,2,4,26,,,,,6,3
2019-05-30 01:59,CAN,1495,737-800,27,4,34,4,4,32,,,,,7,5
2019-05-30 01:59,SYX,1131,737-800,26,4,34,4,3,35,,,,,8,9
2019-05-30 01:55,SZX,1727,737-800,26,4,32,2,2,34,,,,,6,8
2019-05-30 01:51,CAN,5580,737-800,25,6,34,6,6,36,,1,,1,9,11
2019-05-30 01:51,CAN,1545,737-800,25,5,34,5,5,36,,,,,9,11
2019-05-30 01:50,FOC,5430,737-800,25,4,26,4,4,28,,,,,1,3
2019-05-30 01:40,SHA,5637,737-800,23,5,30,2,2,25,,,,,7,2
2019-05-30 01:38,SHA,5687,737-800,22,3,22,4,4,24,,,,,0,2
2019-05-30 01:37,FOC ,1905,737-800,22,4,28,5,5,24,,,,,6,2
2019-05-30 01:37,XIY,1483,737-800,17,5,23,6,5,24,,,,,6,7
2019-05-30 01:37,URC,5636,737-800,17,5,26,5,6,26,,,,,9,9
2019-05-30 01:36,HAK,5686,737-800,26,5,33,5,5,34,,,,,7,8
2019-05-30 01:34,,7378,737-800,25,8,36,6,6,36,1,1,,11,11,11
2019-05-30 01:30,HGH,7639,737-800,25,6,30,6,6,26,,,,,5,1
2019-05-30 01:30,URC,5798,737-800,27,4,25,2,2,21,,,,,-2,-6
2019-05-30 01:29,XMN,6103,737-800,22,6,30,5,5,31,,,,,8,9
2019-05-30 01:29,XMN,5408,737-800,23,4,30,4,4,26,,,,,7,3
2019-05-30 01:28,XMN,1735,737-800,20,3,29,3,3,29,,,,,9,9
2019-05-30 01:27,XMN,5462,737-800,20,5,29,7,5,28,,,,,9,8
2019-05-30 01:25,218,1492,737-800,25,3,34,3,3,32,,,,,9,7
2019-05-30 01:24,DLC,1487,737-800,22,2,25,4,3,24,,,,,3,2
2019-05-30 01:23,DLC,1487,737-800,22,2,25,4,3,24,,,,,3,2
2019-05-30 01:22,URC,6995,737-800,18,4,27,5,5,24,,,,,9,6
2019-05-30 01:21,URC,2157,737-800,20,4,23,8,4,25,,,,,3,5
2019-05-30 01:21,XIY,1161,737-800,17,5,24,2,4,22,,,,,7,5
2019-05-30 01:18,URC,5661,737-800,18,4,20,5,4,24,,,,,2,6
2019-05-30 01:17,TYN,,737-800,23,3,24,3,5,25,,,,,1,2
2019-05-30 01:15,XMN,1735,737-800,23,3,29,3,3,29,,,,,6,6
2019-05-30 01:14,XMN,6103,737-800,22,6,30,5,5,31,,,,,8,9
2019-05-30 01:14,HGH,5467,737-800,24,3,29,3,4,24,,,,,5,0
2019-05-30 01:11,CAN,5439,737-800,25,6,34,4,4,33,,,,,9,8
2019-05-30 01:11,PEK,5539,737-800,28,6,32,6,6,26,,,,,4,-2
2019-05-30 01:09,SZX,1346,737-800,25,5,30,4,5,26,,,,,5,1
2019-05-30 01:09,SZX,5662,737-800,25,3,30,3,5,30,,,,,5,5
2019-05-30 01:09,CKG,7618,737-800,20,5,28,6,5,26,,,,,8,6
2019-05-30 01:08,PEK,7616,737-800,27,4,29,4,4,28,,,,,2,1
2019-05-30 01:08,SZX,6662,737-800,25,3,30,35,30,0,,,,,5,-25
2019-05-30 01:06,URC,5611,737-800,18,5,28,4,4,26,,,,,10,8
2019-05-30 01:06,TYN,5372,737-800,24,8,26,8,8,23,,,,,2,-1
2019-05-30 01:03,XIY,5153,737-800,18,4,26,8,8,30,,,,,8,12
2019-05-30 01:03,SZX,5371,737-800,27,7,30,6,6,32,,,,,3,5
2019-05-30 01:02,HHA,5466,737-800,25,2,22,2,3,23,,,,,-3,-2
2019-05-30 01:01,HHA,5478,737-800,26,5,29,5,5,28,,,,,3,2
2019-05-30 00:55,URC,5623,737-800,20,6,27,6,6,25,,,,,7,5
2019-05-30 00:49,HAK,5338,737-800,26,3,30,4,4,32,,,,,4,6
2019-05-30 00:45,HAK,5417,737-800,26,4,31,4,4,31,,,,,5,5
2019-05-30 00:44,CGO,1498,737-800,21,5,30,4,4,26,,,,,9,5
2019-05-30 00:44,HAK,5735,737-800,25,3,30,2,2,30,,,,,5,5
2019-05-30 00:43,HGH,7377,737-800,25,5,28,6,5,28,,,,,3,3
2019-05-30 00:42,HAK,5089,737-800,26,4,21,2,2,32,,,,,-5,6
2019-05-30 00:41,XIY,1793,737-800,20,5,28,5,5,25,,,,,8,5
2019-05-30 00:40,XMN,5408,737-800,23,4,30,4,4,26,,,,,7,3
2019-05-30 00:37,XMN,5462,737-800,20,5,29,7,5,28,,,,,9,8
2019-05-30 00:36,CGO,1586,737-800,22,4,28,4,4,28,,,,,6,6
2019-05-30 00:36,CGO,1587,737-800,21,4,29,3,3,25,,,,,8,4
2019-05-30 00:35,CGO,206P,737-800,21,4,26,4,5,25,,,,,5,4
2019-05-30 00:34,KMG,7993,737-800,20,6,28,5,5,25,,,,,8,5
2019-05-30 00:34,URC,1725,737-800,20,4,28,5,4,29,,,,,8,9
2019-05-30 00:32,CGO,6800,737-800,20,4,24,4,4,24,,,,,4,4
2019-05-30 00:30,HRB,1350,737-800,20,3,28,3,5,26,,,,,8,6
2019-05-30 00:28,HGH,7639,737-800,25,6,30,6,6,26,,,,,5,1
2019-05-30 00:28,PEK,7171,737-800,27,4,27,4,4,28,,,,,0,1
2019-05-30 00:24,HAK,7989,737-800,26,5,36,5,5,35,,,,,10,9
2019-05-30 00:20,DLC,1795,737-800,21,4,28,3,3,26,,,,,7,5
2019-05-30 00:18,KMG,7990,737-800,22,3,26,3,3,26,,,,,4,4
2019-05-30 00:15,KMG,1798,737-800,19,6,28,7,7,24,,,,,9,5
2019-05-30 00:14,FOC,7395,737-800,22,6,30,6,6,27,,,,,8,5
2019-05-30 00:12,KMG ,1208,737-800,20,2,26,2,2,25,,,,,6,5
2019-05-30 00:10,PEK,1493,737-800,28,4,26,4,5,26,,,,,-2,-2
2019-05-30 00:09,CAN,1541,737-800,25,8,36,7,5,36,,,,,11,11
2019-05-30 00:09,HGH,5463,737-800,23,4,26,4,4,26,,,,,3,3
2019-05-30 00:03,TYN,5479,737-800,23,6,24,6,6,26,,,,,1,3
2019-05-30 00:02,SYX,5137,737-800,27,8,26,3,2,32,,,,,-1,5
2019-05-30 00:01,MIG,6809,737-800,16,4,26,5,5,27,,,,,10,11
2019-05-29 23:56,X?N?N,1103,737-800,13,4,26,5,5,23,,,,,13,10
2019-05-29 23:52,HHA,5733,737-800,27,7,30,6,6,28,,,,,3,1
2019-05-29 23:46,XIY,1785,737-800,20,2,30,8,8,29,,,,,10,9
2019-05-29 23:46,KHG,1568,737-800,19,3,23,3,4,22,,,,,4,3
2019-05-29 23:44,DLC,1101,737-800,22,2,28,2,2,26,,,,,6,4
2019-05-29 23:43,DLC,1928,737-800,22,4,24,4,4,24,,,,,2,2
2019-05-29 23:31,XNN,5135,737-800,14,2,22,2,2,19,,,,,8,5
2019-05-29 23:29,DLC,1372,737-800,20,6,28,5,4,25,,,,,8,5
2019-05-29 23:23,CKG,5416,737-800,20,8,30,8,8,30,,,,,10,10
2019-05-29 23:22,HAK,5480,737-800,25,8,36,5,4,28,,,,,11,3
2019-05-29 23:22,HAK,5082,737-800,26,5,36,5,4,32,,,,,10,6
2019-05-29 23:20,HRB,1433,737-800,21,2,26,2,2,22,,,,,5,1
2019-05-29 23:17,SYX,206F,737-800,27,3,33,3,3,31,,,,,6,4
2019-05-29 23:14,URC,1322,737-800,23,2,25,4,3,24,,,,,2,1
2019-05-29 23:12,XIY,1497,737-800,18,4,30,3,3,24,,,,,12,6
2019-05-29 23:06,HHA,1729,737-800,24,3,23,4,4,24,,,,,-1,0
2019-05-29 23:01,HAK,5579,737-800,28,6,34,6,5,31,,,,,6,3
2019-05-29 22:55,URC,5638,737-800,21,4,25,5,4,26,,,,,4,5
2019-05-29 22:44,XIY,1548,737-800,18,3,22,4,4,24,,,,,4,6
2019-05-29 22:43,URC,7175,737-800,20,4,22,5,5,24,,,,,2,4
2019-05-29 22:35,CAN,1491,737-800,28,5,36,6,6,34,,,,,8,6
2019-05-29 22:35,CAN,7399,737-800,25,5,32,5,4,27,,,,,7,2
2019-05-29 22:34,HAK,5522,737-800,25,5,33,9,9,34,,,,,8,9
2019-05-29 22:34,URC,2159,737-800,20,3,20,3,3,25,,,,,0,5
2019-05-29 22:29,HAK,1375,737-800,36,4,36,4,3,30,,,,,0,-6
2019-05-29 22:21,HAK,5418,737-800,26,7,30,4,4,33,,,,,4,7
2019-05-29 22:17,URC,1323,737-800,21,2,25,3,3,22,,,,,4,1
2019-05-29 21:52,MIG,5409,737-800,18,4,24,4,4,28,,,,,6,10
2019-05-29 21:51,FOC,5430,737-800,25,7,32,7,7,3,,,,,7,-22
2019-05-29 21:44,URC,1569,737-800,23,3,27,2,3,27,,,,,4,4
2019-05-29 21:43,URC,1569,737-800,23,3,27,2,3,27,,,,,4,4
2019-05-29 21:26,TYN,5090,737-800,27,1,18,1,2,22,,,,,-9,-5
2019-05-29 20:59,HAK,1997,737-800,32,4,34,4,4,30,,,,,2,-2
2019-05-29 19:56,HHA,5465,737-800,24,3,26,4,4,30,,,,,2,6
2019-05-29 19:44,HGH,5337,737-800,25,5,30,5,4,31,,,,,5,6
2019-05-29 19:38,HAK,5083,737-800,27,4,28,4,4,34,,,,,1,7
2019-05-29 19:24,HRB,1559,737-800,23,4,26,4,4,26,,,,,3,3
2019-05-29 19:20,URC,205U,737-800,29,4,26,4,4,26,,,,,-3,-3
2019-05-29 18:59,XIY,1903,737-800,19,2,28,2,2,29,,,,,9,10
2019-05-29 18:57,XIY,7379,737-800,19,2,28,3,3,30,,,,,9,11
2019-05-29 18:28,XUZ,7988,737-800,30,8,36,8,8,34,,,,,6,4
2019-05-29 17:20,HAK,5521,737-800,24,5,31,4,3,30,,,,,7,6
2019-05-29 16:22,TYN,1489,737-800,32,6,26,5,5,24,,,,,-6,-8
2019-05-29 16:01,XIY,5346,737-800,17,5,27,5,5,25,,,,,10,8
2019-05-29 15:15,URC,1325,737-800,22,2,20,4,4,22,,,,,-2,0
2019-05-29 15:15,PEK,5520,737-800,35,5,34,7,6,29,,,,,-1,-6
2019-05-29 12:38,MIG,5407,737-800,16,4,26,5,4,26,,,,,10,10
2019-05-29 11:21,URC,6268,737-800,20,3,23,3,4,24,,,,,3,4
2019-05-29 09:24,ZGC,1131,737-800,14,6,24,6,4,23,,,,,10,9
2019-05-29 09:24,ZGC,1735,737-800,15,4,22,5,6,18,,,,,7,3
2019-05-29 09:23,ZGC,5502,737-800,15,5,22,6,7,18,,,,,7,3
2019-05-29 09:23,ZGC,5482,737-800,15,4,20,8,6,26,,,,,5,11
2019-05-29 08:21,KMG ,6016,737-800,18,4,34,4,5,30,1,1,,11,16,12
2019-05-29 08:20,SZX,1503,737-800,26,4,34,4,4,34,,,,,8,8
2019-05-29 07:48,CAN,1213,737-800,26,6,35,6,5,36,,,,,9,10
2019-05-29 07:45,CAN,5713,737-800,26,6,31,6,6,30,,,,,5,4
2019-05-29 07:39,TYN,5372,737-800,20,6,24,6,6,24,,,,,4,4
2019-05-29 07:27,HAK,5540,737-800,30,8,37,5,6,34,,,,,7,4
2019-05-29 07:24,FOC,5430,737-800,21,6,30,5,6,30,,,,,9,9
2019-05-29 07:22,CAN,5579,737-800,25,8,34,6,6,32,,,,,9,7
2019-05-29 07:19,CAN,5735,737-800,26,6,36,2,3,35,,,,,10,9
2019-05-29 07:15,HAK,1997,737-800,25,6,36,4,3,30,1,,,1,11,5
2019-05-29 07:05,KMG ,5249,737-800,18,7,0,7,0,0,,,,,-18,-18
2019-05-29 07:02,XMN,1542,737-800,21,8,32,6,6,34,,,,,11,13
2019-05-29 07:02,XMN,5637,737-800,21,8,30,6,6,30,,,,,9,9
2019-05-29 07:01,XMN,5733,737-800,26,6,30,6,6,30,,,,,4,4
2019-05-29 07:01,XMN,1493,737-800,21,8,36,9,8,34,,,,,15,13
2019-05-29 06:44,PEK,1497,737-800,22,5,28,4,4,26,,,,,6,4
2019-05-29 06:37,SZX,1346,737-800,30,5,37,5,6,32,,,,,7,2
2019-05-29 06:37,HAK,5463,737-800,26,4,27,4,4,27,,,,,1,1
2019-05-29 06:37,SZX,5662,737-800,27,6,35,4,7,36,,,,,8,9
2019-05-29 06:31,CAN,5579,737-800,25,8,34,6,6,32,,,,,9,7
2019-05-29 06:23,HAK,5418,737-800,25,8,32,4,4,34,,,,,7,9
2019-05-29 06:05,PEK,7171,737-800,20,4,25,3,3,27,,,,,5,7
2019-05-29 05:55,FOC,1905,737-800,20,4,25,4,3,23,,,,,5,3
2019-05-29 05:51,PEK,1787,737-800,21,0,24,0,0,24,,,,,3,3
2019-05-29 05:44,HAK,7399,737-800,30,4,32,4,4,33,,,,,2,3
2019-05-29 05:39,CAN,5709,737-800,28,4,32,7,8,34,,,,,4,6
2019-05-29 05:37,CAN,1213,737-800,26,6,35,6,5,36,,,,,9,10
2019-05-29 05:34,CAN,1213,737-800,26,6,32,6,5,32,,,,,6,6
2019-05-29 05:01,PEK,5538,737-800,22,4,30,4,3,29,,,,,8,7
2019-05-29 04:59,HGH,5852,737-800,22,6,27,4,5,26,,,,,5,4
2019-05-29 04:54,FOC,7395,737-800,20,6,29,6,6,27,,,,,9,7
2019-05-29 04:51,CTU,7992,737-800,20,8,30,6,6,28,,,,,10,8
2019-05-29 04:45,HAK,5141,737-800,26,5,31,6,6,33,,,,,5,7
2019-05-29 04:36,FOC,1435,737-800,22,5,35,6,6,33,1,1,,11,13,11
2019-05-29 04:27,HAK,1130,737-800,28,37,2,2,4,38,1,1,,11,-26,10
2019-05-29 04:17,XIY ,1481,737-800,15,7,28,7,6,21,,,,,13,6
2019-05-29 04:14,PEK,1995,737-800,25,5,27,6,6,28,,,,,2,3
2019-05-29 04:09, SZX,5638,737-800,25,4,34,5,5,35,,1,,1,9,10
2019-05-29 04:09,ÃàÑô,5409,737-800,16,4,25,4,4,26,,,,,9,10
2019-05-29 04:07,SZX,1492,737-800,26,4,34,4,4,32,,,,,8,6
2019-05-29 03:58,YIH,1351,737-800,29,5,33,4,5,27,,,,,4,-2
2019-05-29 03:53,CAN,5358,737-800,26,9,36,8,9,36,,,ÓÒÖ÷¼¶É¢ÈÈÆ÷,ÓÒÖ÷¼¶É¢ÈÈÆ÷,10,10
2019-05-29 03:52,SZX,5620,737-800,26,4,32,4,5,33,,,,,6,7
2019-05-29 03:51,HHA,5429,737-800,23,4,30,4,4,29,,,,,7,6
2019-05-29 03:49,PEK,5539,737-800,20,4,30,5,4,25,,,,,10,5
2019-05-29 03:47,HGH,1375,737-800,21,5,27,5,5,24,,,,,6,3
2019-05-29 03:45,SYX,1786,737-800,28,3,30,5,4,30,,,,,2,2
2019-05-29 03:43,URC,7198,737-800,16,4,26,5,4,20,,,,,10,4
2019-05-29 03:42,CGO,5359,737-800,17,4,24,4,4,28,,,,,7,11
2019-05-29 03:42,CAN,1491,737-800,27,5,36,6,5,36,,,,,9,9
2019-05-29 03:35,SZX,7619,737-800,26,6,31,6,5,31,,,,,5,5
2019-05-29 03:33,HAK,1929,737-800,25,4,34,4,4,30,,,,,9,5
2019-05-29 03:32,HAK,1729,737-800,25,4,29,5,3,30,,,,,4,5
2019-05-29 03:26,FOC,1549,737-800,20,5,29,5,5,28,,,,,9,8
2019-05-29 03:25,Ö£ÖÝ,1586,737-800,18,6,28,4,4,28,,,,,10,10
2019-05-29 03:20,XIY,5182,737-800,15,4,23,3,3,22,,,,,8,7
2019-05-29 03:19,URC,5661,737-800,20,3,20,4,4,26,,,,,0,6
2019-05-29 03:19,XIY,1785,737-800,15,1,24,5,5,26,,,,,9,11
2019-05-29 03:16,URC,7639,737-800,10,4,20,6,6,24,,,,,10,14
2019-05-29 03:13,PEK,1796,737-800,24,4,30,4,4,0,,,,,6,-24
2019-05-29 03:03,TYN,1927,737-800,18,3,21,8,3,23,,,,,3,5
2019-05-29 03:01,HAK,5139,737-800,26,5,32,3,3,32,,,,,6,6
2019-05-29 02:58,CAN,5483,737-800,25,5,36,5,4,34,,,,,11,9
2019-05-29 02:56,Ö£ÖÝ,1586,737-800,18,28,6,4,4,28,,,,,-12,10
2019-05-29 02:56,HAK,5540,737-800,26,8,40,5,6,34,,,,,14,8
2019-05-29 02:56,URC,5661,737-800,20,3,20,4,4,26,,,,,0,6
2019-05-29 02:51,MIG,5449,737-800,15,4,28,4,5,27,,,,,13,12
2019-05-29 02:48,URC,6995,737-800,15,4,27,6,5,24,,,,,12,9
2019-05-29 02:48,XIY,1902,737-800,13,6,30,6,6,28,,,,,17,15
2019-05-29 02:44,SYX,7400,737-800,25,8,36,4,4,34,1,,,1,11,9
2019-05-29 02:43,SYX,7400,737-800,25,8,36,4,4,34,,,,,11,9
2019-05-29 02:41,URC,1726,737-800,20,3,26,3,3,22,,,,,6,2
2019-05-29 02:41,KMG,7993,737-800,20,6,28,6,6,27,,,,,8,7
2019-05-29 02:40,URC,1568,737-800,18,4,26,6,6,26,,,,,8,8
2019-05-29 02:40,HHA,6808,737-800,25,4,24,4,4,24,,,,,-1,-1
2019-05-29 02:32,KMG,7990,737-800,20,3,27,4,4,26,,,,,7,6
2019-05-29 02:31,XIY,5115,737-800,20,4,28,2,2,30,,,,,8,10
2019-05-29 02:27,KMG,7167,737-800,20,5,30,6,6,26,,,,,10,6
2019-05-29 02:25,HGH,5522,737-800,22,5,26,5,4,24,,,,,4,2
2019-05-29 02:23,HAK,5687,737-800,28,3,30,3,3,30,,,,,2,2
2019-05-29 02:21,HAK,7378,737-800,32,7,36,6,7,36,,,,,4,4
2019-05-29 02:19,SYX,5136,737-800,29,5,34,6,6,36,,,,,5,7
2019-05-29 02:18,CAN,7173,737-800,24,6,36,7,6,35,1,1,,11,12,11
2019-05-29 02:18,SYX,1733,737-800,29,4,34,8,8,37,,,,,5,8
2019-05-29 02:14,KMG,1798,737-800,20,6,29,7,7,24,,,,,9,4
2019-05-29 02:12,HHA,6103,737-800,25,5,30,5,5,30,,,,,5,5
2019-05-29 02:12,HHA,5478,737-800,25,2,28,3,2,29,,,,,3,4
2019-05-29 02:10,URC,1996,737-800,20,4,20,6,6,24,,,,,0,4
2019-05-29 02:09,KMG,7988,737-800,20,4,28,5,5,24,,,,,8,4
2019-05-29 02:07,SYX,1541,737-800,29,7,37,5,6,36,,,,,8,7
2019-05-29 02:06,DLC,1347,737-800,18,3,26,3,3,26,,,,,8,8
2019-05-29 02:03,HHA,6065,737-800,25,6,28,4,4,28,,,,,3,3
2019-05-29 02:03,XIY,5116,737-800,15,4,21,4,4,20,,,,,6,5
2019-05-29 02:02,HHA,5466,737-800,24,2,24,6,3,23,,,,,0,-1
2019-05-29 01:57,URC,1323,737-800,18,4,28,5,6,22,,,,,10,4
2019-05-29 01:54,HGH,1215,737-800,20,4,28,5,5,28,,,,,8,8
2019-05-29 01:54,XIY ,5139,737-800,15,6,26,6,4,25,,,,,11,10
2019-05-29 01:53,XIY ,7113,737-800,15,5,26,5,4,25,,,,,11,10
2019-05-29 01:51,URC,1725,737-800,15,4,28,4,4,28,,,,,13,13
2019-05-29 01:49,CAN,1545,737-800,27,4,36,6,6,36,,,,,9,9
2019-05-29 01:46,TYN,5479,737-800,18,3,22,3,4,23,,,,,4,5
2019-05-29 01:44,CGO,1547,737-800,20,6,28,6,6,28,,,,,8,8
2019-05-29 01:44,CGO,1587,737-800,18,3,28,4,3,26,,,,,10,8
2019-05-29 01:36,SZX,1492,737-800,26,4,34,4,4,32,,,,,8,6
2019-05-29 01:32,PEK,5855,737-800,26,6,28,6,6,24,,,,,2,-2
2019-05-29 01:32,´óÁ¬,1538,737-800,19,4,25,4,4,22,,,,,6,3
2019-05-29 01:30,MIG,5732,737-800,15,4,21,4,5,24,,,,,6,9
2019-05-29 01:30,XIY,5180,737-800,15,6,28,6,4,26,,,,,13,11
2019-05-29 01:28,URC,2157,737-800,16,4,22,8,5,28,,,,,6,12
2019-05-29 01:21,URC,1727,737-800,17,4,26,6,6,24,,,,,9,7
2019-05-29 01:17,HRB,1433,737-800,13,2,25,2,2,18,,,,,12,5
2019-05-29 01:17,CGO,1588,737-800,18,4,28,4,4,28,,,,,10,10
2019-05-29 01:16,FOC,7105,737-800,22,4,28,2,3,24,,,,,6,2
2019-05-29 01:08,HGH,5375,737-800,20,2,20,4,4,22,,,,,0,2
2019-05-29 01:05,HRB,1350,737-800,13,4,26,4,4,22,,,,,13,9
2019-05-29 01:02,515»úÎ»,6809,737-800,20,5,25,5,5,25,,,,,5,5
2019-05-29 01:01,104,5462,737-800,26,3,30,4,4,28,,,,,4,2
2019-05-29 00:56,URC,5611,737-800,18,6,28,6,6,25,,,,,10,7
2019-05-29 00:55,HRB,1559,737-800,13,4,28,2,2,20,,,,,15,7
2019-05-29 00:52,YIH,1348,737-800,24,4,31,4,4,32,,,,,7,8
2019-05-29 00:51,DLC,1372,737-800,20,5,28,5,5,24,,,,,8,4
2019-05-29 00:50,HHA,7886,737-800,25,3,30,3,3,31,,,,,5,6
2019-05-29 00:48,URC,5625,737-800,18,4,27,4,4,26,,,,,9,8
2019-05-29 00:46,XIY,5373,737-800,15,4,26,4,4,26,,,,,11,11
2019-05-29 00:45,HGH,1728,737-800,22,3,21,5,5,21,,,,,-1,-1
2019-05-29 00:44,XIY,1163,737-800,15,4,32,2,2,27,,,,,17,12
2019-05-29 00:42,TYN,206G,737-800,22,4,26,4,4,26,,,,,4,4
2019-05-29 00:39,HAK,5089,737-800,25,6,35,6,8,35,,,,,10,10
2019-05-29 00:39,SZX,5638,737-800,25,4,34,5,5,35,,,,,9,10
2019-05-29 00:37,PEK,5406,737-800,24,6,28,6,5,26,,,,,4,2
2019-05-29 00:36,URC,5712,737-800,19,2,25,3,2,23,,,,,6,4
2019-05-29 00:28,DLC,1795,737-800,21,5,26,5,5,26,,,,,5,5
2019-05-29 00:15,PEK,5482,737-800,23,5,23,4,5,25,,,,,0,2
2019-05-29 00:11,URC,1141,737-800,15,4,26,6,6,26,,,,,11,11
2019-05-29 00:10,CGO,205U,737-800,20,4,27,3,4,27,,,,,7,7
2019-05-29 00:07,CGO,6800,737-800,19,4,27,5,5,24,,,,,8,5
2019-05-29 00:05,KHG,1569,737-800,20,3,23,3,2,22,,,,,3,2
2019-05-29 00:04,XIY,1495,737-800,15,5,24,6,6,24,,,,,9,9
2019-05-29 00:03,CAN,1784,737-800,26,4,22,6,5,35,,,,,-4,9
2019-05-29 00:03,HGH,5467,737-800,22,0,26,2,0,23,,,,,4,1
2019-05-29 00:03,XIY,7379,737-800,16,5,23,4,4,25,,,,,7,9
2019-05-29 00:01,URC,5623,737-800,17,6,29,5,5,26,,,,,12,9
2019-05-28 23:58,PEK,1487,737-800,25,3,28,3,4,26,,,,,3,1
2019-05-28 23:57,CKG,7618,737-800,18,5,28,5,5,25,,,,,10,7
2019-05-28 23:56,PEK,7616,737-800,27,3,25,4,4,26,,,,,-2,-1
2019-05-28 23:54,URC,205V,737-800,18,1,30,8,9,32,,,ÓÒÉ¢ÈÈÆ÷,ÓÒÉ¢ÈÈÆ÷,12,14
2019-05-28 23:53,DLC,1101,737-800,19,2,26,2,2,28,,,,,7,9
2019-05-28 23:49,DLC,1490,737-800,21,4,24,4,4,24,,,,,3,3
2019-05-28 23:48,SYX,206F,737-800,28,4,33,5,5,32,,,,,5,4
2019-05-28 23:47,HAK,1102,737-800,26,3,36,4,4,35,,,,,10,9
2019-05-28 23:42,PEK,5797,737-800,26,5,21,4,5,23,,,,,-5,-3
2019-05-28 23:42,KMG,1208,737-800,18,2,26,2,2,25,,,,,8,7
2019-05-28 23:33,SYX,1498,737-800,30,5,36,5,6,32,,,,,6,2
2019-05-28 23:26,HAK,5082,737-800,25,4,36,4,4,32,,,,,11,7
2019-05-28 23:24,HRB,1433,737-800,13,3,25,2,2,20,,,,,12,7
2019-05-28 23:18,HAK,1489,737-800,26,4,33,5,4,32,,,,,7,6
2019-05-28 23:18,SZX,1386,737-800,26,4,35,4,4,35,,,,,9,9
2019-05-28 23:12,XIY ,7398 ,737-800,20,4,25,7,6,24,,,,,5,4
2019-05-28 23:11,XIY,5405,737-800,17,4,28,4,4,26,,,,,11,9
2019-05-28 23:09,KMG,6015,737-800,19,4,30,4,4,24,,,,,11,5
2019-05-28 23:05,CAN,5580,737-800,26,6,24,6,6,35,,,,,-2,9
2019-05-28 22:49,HAK,206H,737-800,26,2,34,2,2,32,,,,,8,6
2019-05-28 22:47,MIG,5407,737-800,15,4,23,4,4,21,,,,,8,6
2019-05-28 22:46,URC,5636,737-800,20,3,26,4,4,25,,,,,6,5
2019-05-28 22:43,´óÁ¬,1488,737-800,23,6,26,6,6,26,,,,,3,3
2019-05-28 22:37,HAK,1799,737-800,27,4,35,4,4,33,,,,,8,6
2019-05-28 22:33,SYX,5137,737-800,28,8,34,2,2,35,,,,,6,7
2019-05-28 22:27,HAK,6061,737-800,29,4,34,4,4,34,,,,,5,5
2019-05-28 22:22,TYN,5371,737-800,20,8,20,6,7,22,,,,,0,2
2019-05-28 22:20,URC,2159,737-800,20,2,22,2,2,24,,,,,2,4
2019-05-28 22:15,URC,205T,737-800,23,3,26,3,3,30,,,,,3,7
2019-05-28 21:48,HAK,5338,737-800,25,4,30,4,3,34,,,,,5,9
2019-05-28 21:37,103,6060,737-800,30,4,30,4,4,28,,,,,0,-2
2019-05-28 21:30,XNN,5135,737-800,19,2,21,4,4,22,,,,,2,3
2019-05-28 21:07,ÐìÖÝ,7989,737-800,24,4,34,5,4,30,,,,,10,6
2019-05-28 20:55,FOC,5503,737-800,21,3,25,3,3,25,,,,,4,4
2019-05-28 20:30,DLC,1928,737-800,25,6,24,6,6,22,,,,,-1,-3
2019-05-28 20:30,DLC,6062,737-800,23,3,28,3,3,28,,,,,5,5
2019-05-28 20:15,HAK,5083,737-800,28,4,30,5,4,35,,,,,2,7
2019-05-28 19:49,HHA,5465,737-800,25,2,32,3,3,32,,,,,7,7
2019-05-28 19:41,XIY,1903,737-800,20,1,22,1,2,23,,,,,2,3
2019-05-28 19:25,HGH,5337,737-800,24,4,26,4,4,26,,,,,2,2
2019-05-28 19:09,HAK,5138,737-800,27,5,33,5,4,34,,,,,6,7
2019-05-28 19:00,URC,1322,737-800,22,4,27,4,5,26,,,,,5,4
2019-05-28 18:58,URC,206P,737-800,25,4,23,5,5,22,,,,,-2,-3
2019-05-28 18:55,KMG,7991,737-800,23,6,28,6,6,28,,,,,5,5
2019-05-28 18:41,URC,1570,737-800,23,5,24,5,5,20,,,,,1,-3
2019-05-28 18:41,HAK,5481,737-800,25,5,33,6,5,33,,,,,8,8
2019-05-28 17:33,XIY,5346,737-800,18,5,24,4,5,24,,,,,6,6
2019-05-28 16:29,HAK,5375,737-800,35,8,37,8,8,36,,,,,2,1
2019-05-28 14:31,URC,1325,737-800,20,3,20,3,4,21,,,,,0,1
2019-05-28 14:05,XIY,5153,737-800,18,4,28,4,4,26,,,,,10,8
2019-05-28 14:04,XIY,5153,737-800,18,4,28,4,4,26,,,,,10,8
2019-05-28 11:17,KMG,7167,737-800,19,5,28,5,5,25,,,,,9,6
2019-05-28 11:14,CTU,1208,737-800,25,3,28,3,3,25,,,,,3,0
2019-05-28 08:50,PEK,5483,737-800,24,4,30,6,5,26,,,,,6,2
2019-05-28 08:39,FOC,5503,737-800,25,2,27,0,0,0,,,,,2,-25
2019-05-28 08:39,CAN,1496,737-800,28,7,36,6,6,36,,,,,8,8
2019-05-28 08:37,KMG,1798,737-800,17,5,28,6,6,24,,,,,11,7
2019-05-28 08:33,ZGC,1735,737-800,12,5,20,4,4,18,,,,,8,6
2019-05-28 08:32,DLC,1795,737-800,18,5,24,4,6,24,,,,,6,6
2019-05-28 08:31,ZGC,7400,737-800,10,6,25,6,6,24,,,,,15,14
2019-05-28 08:30,ZGC,7619,737-800,10,9,20,8,9,28,,,,,10,18
2019-05-28 08:28,ZGC,5372,737-800,20,8,23,8,9,20,,,,,3,0
2019-05-28 08:25,ZGC,5502,737-800,11,6,22,5,6,21,,,,,11,10
2019-05-28 08:25,KMG,7990,737-800,20,2,28,3,3,26,,,,,8,6
2019-05-28 08:13,PEK,5538,737-800,17,3,28,3,3,30,,,,,11,13
2019-05-28 07:56,DLC,1215,737-800,18,4,24,4,4,26,,,,,6,8
2019-05-28 07:41,HAK,5082,737-800,25,3,33,4,4,30,,,,,8,5
2019-05-28 07:23,CAN,5478,737-800,26,3,36,2,2,35,1,,,1,10,9
2019-05-28 07:14,PEK,5481,737-800,25,8,28,7,6,26,,,,,3,1
2019-05-28 07:07,XMN,5733,737-800,25,7,30,7,6,33,,,,,5,8
2019-05-28 07:06,XMN,7175,737-800,26,6,34,6,5,32,,,,,8,6
2019-05-28 07:06,XMN,7616,737-800,26,7,36,5,6,35,,,,,10,9
2019-05-28 07:04,XMN,1131,737-800,28,6,34,6,7,36,,,,,6,8
2019-05-28 06:55,PEK,5462,737-800,25,3,20,4,4,22,,,,,-5,-3
2019-05-28 06:50,FOC,7395,737-800,28,6,32,6,6,30,,,,,4,2
2019-05-28 06:44,HAK,1929,737-800,27,4,30,4,3,32,,,,,3,5
2019-05-28 06:35,SYX,1541,737-800,28,6,35,5,6,35,,,,,7,7
2019-05-28 06:30,HAK,5439,737-800,27,5,32,4,3,31,,,,,5,4
2019-05-28 06:19,HAK,5579,737-800,29,7,35,6,7,34,,,,,6,5
2019-05-28 06:15,XIY,5405,737-800,13,5,30,5,4,24,,,,,17,11
2019-05-28 06:13,XIY,1902,737-800,14,5,28,5,5,26,,,,,14,12
2019-05-28 06:12,HGH,5661,737-800,30,2,24,4,4,28,,,,,-6,-2
2019-05-28 06:09,FOC,7395,737-800,28,6,32,6,6,30,,,,,4,2
2019-05-28 05:41,FOC,7105,737-800,26,4,33,5,5,32,,,,,7,6
2019-05-28 05:25,URC,1996,737-800,15,4,10,5,5,23,,,,,-5,8
2019-05-28 05:09,KMG,1586,737-800,20,6,30,6,6,32,,1,,1,10,12
2019-05-28 05:02,FOC,5153,737-800,24,4,36,3,4,34,,,,,12,10
2019-05-28 04:59,PEK,1787,737-800,23,2,28,8,8,36,,1,,1,5,13
2019-05-28 04:59,SZX,1729,737-800,25,6,32,5,5,32,,,,,7,7
2019-05-28 04:58,SZX,5463,737-800,25,4,34,4,4,32,,,,,9,7
2019-05-28 04:56,KMG,7993,737-800,20,6,28,6,6,24,,,,,8,4
2019-05-28 04:48,HHA,1373,737-800,26,4,28,4,4,22,,,,,2,-4
2019-05-28 04:37,PEK,5482,737-800,21,2,24,5,5,30,,,,,3,9
2019-05-28 04:31,HAK,1997,737-800,26,6,36,6,5,32,,,,,10,6
2019-05-28 04:31,XIY,1481,737-800,15,6,30,6,6,26,,,,,15,11
2019-05-28 04:29,XIY,1903,737-800,14,2,26,2,2,26,,,,,12,12
2019-05-28 04:25,CAN,1213,737-800,25,7,36,6,7,36,1,1,,11,11,11
2019-05-28 04:24,PEK ,5539,737-800,20,3,24,3,2,21,,,,,4,1
2019-05-28 04:21,CAN,5580,737-800,28,8,35,7,6,37,,,,,7,9
2019-05-28 04:19,SZX,1346,737-800,28,8,37,6,6,36,1,,,1,9,8
2019-05-28 04:06,FOC,1905,737-800,27,3,22,3,3,28,,,,,-5,1
2019-05-28 04:00,HAK,5089,737-800,27,3,24,1,1,33,,,,,-3,6
2019-05-28 03:55,URC,7198,737-800,17,4,28,4,4,28,,,,,11,11
2019-05-28 03:54,CAN,5713,737-800,27,6,32,7,7,32,,,,,5,5
2019-05-28 03:50,URC,1325,737-800,16,2,24,4,4,24,,,,,8,8
2019-05-28 03:48,TYN,206G,737-800,20,4,24,4,4,22,,,,,4,2
2019-05-28 03:45,TYN,5090,737-800,15,2,22,4,4,24,,,,,7,9
2019-05-28 03:45,CAN,1928,737-800,27,5,28,7,7,32,,,,,1,5
2019-05-28 03:44,XIY,5611,737-800,16,6,30,6,6,24,,,,,14,8
2019-05-28 03:44,CKG,5522,737-800,18,6,26,4,5,26,,,,,8,8
2019-05-28 03:42,XIY,5611,737-800,16,6,30,6,6,24,,,,,14,8
2019-05-28 03:40,HAK,5662,737-800,30,6,35,4,6,35,,,,,5,5
2019-05-28 03:37,HAK,6060,737-800,29,4,34,6,5,32,,,,,5,3
2019-05-28 03:24,CAN,1542,737-800,25,5,34,4,5,32,,,,,9,7
2019-05-28 03:21,DLC,6062,737-800,18,4,24,4,3,24,,,,,6,6
2019-05-28 03:17,CGO,6016,737-800,22,4,24,4,4,2,,,,,2,-20
2019-05-28 03:09,FOC,5503,737-800,25,4,30,4,4,28,,,,,5,3
2019-05-28 03:09,TYN,5338,737-800,20,4,20,4,4,22,,,,,0,2
2019-05-28 03:09,URC,7379,737-800,15,4,28,2,2,26,,,,,13,11
2019-05-28 03:02,XIY,1435,737-800,25,6,30,6,5,32,,,,,5,7
2019-05-28 02:58,HHA,5429,737-800,26,4,30,7,7,37,,1,,1,4,11
2019-05-28 02:57,XIY,1161,737-800,15,3,24,3,3,24,,,,,9,9
2019-05-28 02:54,URC,6995,737-800,10,4,26,6,4,24,,,,,16,14
2019-05-28 02:50,PEK ,7377,737-800,20,2,25,3,4,24,,,,,5,4
2019-05-28 02:49,HGH,1728,737-800,21,4,28,4,4,24,,,,,7,3
2019-05-28 02:48,HGH,5687,737-800,21,4,20,4,4,25,,,,,-1,4
2019-05-28 02:44,SYX,5136,737-800,30,4,32,4,4,36,,,,,2,6
2019-05-28 02:43,TYN,1927,737-800,25,4,20,4,4,22,,,,,-5,-3
2019-05-28 02:35,HHA,5138,737-800,26,4,30,4,4,29,,,,,4,3
2019-05-28 02:35,SYX,206F,737-800,30,3,33,3,4,34,,,,,3,4
2019-05-28 02:34,URC,1569,737-800,17,2,27,2,2,28,,,,,10,11
2019-05-28 02:30,URC,205V,737-800,17,0,28,1,4,27,,,,,11,10
2019-05-28 02:23,XIY,1162,737-800,18,4,26,4,5,25,,,,,8,7
2019-05-28 02:23,URC,5712,737-800,20,2,24,2,1,23,,,,,4,3
2019-05-28 02:23,XIY,5180,737-800,15,6,30,6,6,26,,,,,15,11
2019-05-28 02:23,URC,5623,737-800,17,7,27,6,6,26,,,,,10,9
2019-05-28 02:22,URC,5637,737-800,18,2,26,2,2,26,,,,,8,8
2019-05-28 02:22,URC,1141,737-800,18,5,28,6,6,28,,,,,10,10
2019-05-28 02:21,CAN,5709,737-800,26,6,36,7,6,36,1,1,,11,10,10
2019-05-28 02:21,URC,1570,737-800,18,6,24,6,6,24,,,,,6,6
2019-05-28 02:21,º¼ÖÝ,5428,737-800,21,4,21,4,3,23,,,,,0,2
2019-05-28 02:21,URC,1786,737-800,17,2,24,4,4,20,,,,,7,3
2019-05-28 02:19,KMG,1588,737-800,19,4,26,4,4,27,,,,,7,8
2019-05-28 02:10,HAK,6060,737-800,29,34,4,6,5,32,,,,,-25,3
2019-05-28 02:10,FOC,7395,737-800,28,6,32,6,6,32,,,,,4,4
2019-05-28 02:08,URC,5853,737-800,20,4,29,4,5,25,,,,,9,5
2019-05-28 02:05,XIY,5182,737-800,15,3,12,4,4,14,,,,,-3,-1
2019-05-28 02:05,XIY,5116,737-800,15,4,22,4,4,22,,,,,7,7
2019-05-28 02:03,HHA,5465,737-800,27,3,28,2,2,30,,,,,1,3
2019-05-28 02:01,HAK,5371,737-800,25,8,30,6,6,32,,,,,5,7
2019-05-28 01:58,SYX,5417,737-800,28,4,32,5,5,34,,,,,4,6
2019-05-28 01:57,HGH,5337,737-800,21,4,26,5,4,29,,,,,5,8
2019-05-28 01:55,HGH,1375,737-800,20,6,20,4,6,24,,,,,0,4
2019-05-28 01:52,SYX,1498,737-800,29,6,35,5,6,33,,,,,6,4
2019-05-28 01:52,CAN,5418,737-800,26,7,30,4,4,30,,,,,4,4
2019-05-28 01:52,HAK,1102,737-800,27,3,34,4,4,35,,,,,7,8
2019-05-28 01:51,DLC,1488,737-800,19,6,27,6,6,24,,,,,8,5
2019-05-28 01:49,CKG,5416,737-800,20,8,30,8,8,30,,,,,10,10
2019-05-28 01:48,URC,2159,737-800,18,3,18,2,2,22,,,,,0,4
2019-05-28 01:47,HAK,1492,737-800,30,3,33,4,4,31,,,,,3,1
2019-05-28 01:44,XIY,5139,737-800,15,2,26,5,3,24,,,,,11,9
2019-05-28 01:42,HRB,1559,737-800,14,4,23,3,3,21,,,,,9,7
2019-05-28 01:37,YIH,1906,737-800,22,5,28,4,6,29,,,,,6,7
2019-05-28 01:35,YIH,1348,737-800,23,6,27,5,4,28,,,,,4,5
2019-05-28 01:30,SZX,5638,737-800,26,6,36,6,6,36,,,,,10,10
2019-05-28 01:27,HAK,1489,737-800,30,4,33,4,4,33,,,,,3,3
2019-05-28 01:26,HAK,1796,737-800,27,4,35,4,4,0,,,,,8,-27
2019-05-28 01:23,DLC,1538,737-800,18,2,24,4,4,22,,,,,6,4
2019-05-28 01:23,URC,1725,737-800,17,4,30,6,6,32,,1,,1,13,15
2019-05-28 01:22,CAN,7173,737-800,29,4,36,6,5,34,,,,,7,5
2019-05-28 01:22,XIY,1548,737-800,16,4,24,4,4,22,,,,,8,6
2019-05-28 01:21,XIY,1549,737-800,19,5,28,6,5,26,,,,,9,7
2019-05-28 01:19,HGH,5408,737-800,22,4,27,4,3,24,,,,,5,2
2019-05-28 01:19,CGO,1587,737-800,24,2,28,4,4,26,,,,,4,2
2019-05-28 01:16,HHA,7886,737-800,26,3,31,3,3,30,,,,,5,4
2019-05-28 01:11,CAN,5709,737-800,27,36,6,9,8,37,,,,,-21,10
2019-05-28 01:10,KMG,7989,737-800,20,5,28,5,5,26,,,,,8,6
2019-05-28 01:06,SYX,7618,737-800,28,5,34,6,5,33,,,,,6,5
2019-05-28 01:06,CAN,5521,737-800,27,5,30,4,5,30,,,,,3,3
2019-05-28 01:04,HRB,1433,737-800,14,3,24,3,4,24,,,,,10,10
2019-05-28 01:01,ÃàÑô,6809,737-800,18,5,24,6,6,24,,,,,6,6
2019-05-28 01:00,URC,206P,737-800,19,5,27,5,4,25,,,,,8,6
2019-05-28 01:00,XIY,5346,737-800,17,5,24,4,5,20,,,,,7,3
2019-05-28 00:59,FOC,5430,737-800,27,5,36,5,6,35,,,,,9,8
2019-05-28 00:56,PEK,5520,737-800,20,5,28,6,6,32,,,,,8,12
2019-05-28 00:55,HAK,5579,737-800,27,8,37,6,7,36,,,,,10,9
2019-05-28 00:55,FOC,5430,737-800,27,6,37,7,7,37,,,×óTCV,×óTCV,10,10
2019-05-28 00:53,SYX,5369,737-800,30,8,36,6,4,34,,,,,6,4
2019-05-28 00:50,PEK,1493,737-800,21,8,31,8,8,24,,,,,10,3
2019-05-28 00:47,HAK,5798,737-800,27,2,31,3,2,29,,,,,4,2
2019-05-28 00:43,HAK,6065,737-800,27,5,35,5,6,29,,,,,8,2
2019-05-28 00:33,HHA,6103,737-800,27,6,30,5,5,31,,,,,3,4
2019-05-28 00:33,URC,1322,737-800,17,3,27,4,4,25,,,,,10,8
2019-05-28 00:27,MIG,5732,737-800,18,2,25,4,5,23,,,,,7,5
2019-05-28 00:23,KHG,205T,737-800,16,3,24,2,3,23,,,,,8,7
2019-05-28 00:20,CAN,1545,737-800,27,6,32,4,4,32,,,,,5,5
2019-05-28 00:13,HAK,5540,737-800,25,8,36,6,6,36,1,,,1,11,11
2019-05-28 00:13,URC,1726,737-800,18,2,26,2,4,24,,,,,8,6
2019-05-28 00:09,XIY,1785,737-800,25,0,28,8,8,27,,,,,3,2
2019-05-28 00:03,KMG,7991,737-800,20,6,27,6,5,26,,,,,7,6
2019-05-28 00:02,CGO,7992,737-800,23,5,26,6,6,26,,,,,3,3
2019-05-27 23:51,DLC,1347,737-800,19,4,27,4,4,26,,,,,8,7
2019-05-27 23:51,SZX,1130,737-800,27,1,36,2,2,36,,,,,9,9
2019-05-27 23:45,CGO,1209,737-800,25,3,31,2,2,28,,,,,6,3
2019-05-27 23:42,HAK,206H,737-800,26,4,33,2,3,30,,,,,7,4
2019-05-27 23:37,XIY,7639,737-800,15,6,30,6,6,24,,,,,15,9
2019-05-27 23:29,SZX,1503,737-800,27,4,32,4,4,34,,,,,5,7
2019-05-27 23:26,XNN,1103,737-800,11,4,28,4,4,20,,,,,17,9
2019-05-27 23:23,PEK,5797,737-800,24,5,19,6,6,28,,,,,-5,4
2019-05-27 23:21,HRB,1562,737-800,14,4,24,4,3,25,,,,,10,11
2019-05-27 23:20,HHA,6808,737-800,27,4,30,5,4,28,,,,,3,1
2019-05-27 23:18,HAK,5735,737-800,26,5,34,4,5,35,,,,,8,9
2019-05-27 23:15,DLC,1372,737-800,18,5,27,4,4,25,,,,,9,7
2019-05-27 23:13,HAK,6061,737-800,30,3,32,6,5,30,,,,,2,0
2019-05-27 23:11,HAK,1799,737-800,28,5,34,4,5,32,,,,,6,4
2019-05-27 23:11,HAK,1487,737-800,25,4,34,3,3,32,,,,,9,7
2019-05-27 23:11,DLC,5852,737-800,20,4,24,3,3,24,,,,,4,4
2019-05-27 23:10,CGO,1733,737-800,20,4,27,4,4,26,,,,,7,6
2019-05-27 23:08,DLC,1491,737-800,18,4,24,4,5,24,,,,,6,6
2019-05-27 23:06,HAK,7988,737-800,28,4,31,4,4,32,,,,,3,4
2019-05-27 23:01,CGO,205U,737-800,26,4,28,4,4,28,,,,,2,2
2019-05-27 22:53,HAK,1487,737-800,25,4,34,3,3,32,,,,,9,7
2019-05-27 22:51,URC,1727,737-800,17,5,26,6,5,23,,,,,9,6
2019-05-27 22:47,HHA,5466,737-800,26,2,23,7,8,26,,,,,-3,0
2019-05-27 22:40,SYX,5137,737-800,30,8,30,4,4,36,,,,,0,6
2019-05-27 22:31,ÃàÑô,5449,737-800,19,6,28,6,6,26,,,,,9,7
2019-05-27 22:28,HGH,1101,737-800,24,2,32,2,2,30,,,,,8,6
2019-05-27 22:26,TSN,5478,737-800,23,4,28,6,5,26,,,,,5,3
2019-05-27 22:25,URC,1568,737-800,19,5,30,6,6,26,,,,,11,7
2019-05-27 22:24,DLC,1490,737-800,18,5,26,5,5,24,,,,,8,6
2019-05-27 22:23,HAK,5358,737-800,25,9,37,8,9,36,1,1,,11,12,11
2019-05-27 22:21,XNN,1103,737-800,18,4,28,4,4,20,,,,,10,2
2019-05-27 22:20,XIY,1793,737-800,16,2,22,2,4,24,,,,,6,8
2019-05-27 22:14,XIY,7398,737-800,15,4,28,4,4,28,,,,,13,13
2019-05-27 21:53,CGO,6800,737-800,20,4,24,4,4,24,,,,,4,4
2019-05-27 21:52,HAK,5855,737-800,25,7,33,7,7,29,,,,,8,4
2019-05-27 21:49,HAK,5089,737-800,28,4,25,2,2,33,,,,,-3,5
2019-05-27 21:34,HAK,5083,737-800,29,4,32,4,5,34,,,,,3,5
2019-05-27 21:32,XNN,5135,737-800,19,3,22,3,3,20,,,,,3,1
2019-05-27 21:12,URC,1323,737-800,20,2,23,3,3,22,,,,,3,2
2019-05-27 20:54,XIY,1495,737-800,17,6,28,8,8,24,,,,,11,7
2019-05-27 20:01,KMG,5409,737-800,25,4,24,5,4,28,,,,,-1,3
2019-05-27 19:54,HHA,7172,737-800,28,3,30,5,4,30,,,,,2,2
2019-05-27 19:40,URC,6268,737-800,20,2,20,2,3,22,,,,,0,2
2019-05-27 19:23,YIH,1351,737-800,24,6,28,6,6,28,,,,,4,4
2019-05-27 19:06,HRB,1350,737-800,27,4,27,5,5,26,,,,,0,-1
2019-05-27 18:55,SZX,5620,737-800,27,6,37,3,5,33,1,,,1,10,6
2019-05-27 18:51,XIY,1482,737-800,17,6,28,4,4,26,,,,,11,9
2019-05-27 18:48,XUZ,6015,737-800,30,4,32,4,4,34,,,,,2,4
2019-05-27 17:49,HAK,1480,737-800,34,5,34,5,4,31,,,,,0,-3
2019-05-27 17:28,SZX,1386,737-800,28,3,34,4,4,30,,,,,6,2
2019-05-27 17:11,TYN,5636,737-800,24,4,25,4,5,25,,,,,1,1
2019-05-27 16:27,HHA,5465,737-800,32,3,29,4,3,31,,,,,-3,-1
2019-05-27 16:02,PEK,5538,737-800,27,9,37,4,3,31,1,,,1,10,4
2019-05-27 15:43,HAK,7399,737-800,34,5,32,5,4,30,,,,,-2,-4
2019-05-27 15:09,XIY,5373,737-800,21,6,30,8,8,24,,,,,9,3
2019-05-27 13:27,TYN,5636,737-800,23,5,25,5,5,24,,,,,2,1
2019-05-27 11:21,KMG,7167,737-800,22,4,18,4,4,26,,,,,-4,4
2019-05-27 09:18,XMN,5467,737-800,25,4,30,4,6,24,,,,,5,-1
2019-05-27 09:17,HAK,1346,737-800,27,8,36,7,6,32,,,,,9,5
2019-05-27 09:17,XMN,6808,737-800,25,8,34,6,8,32,,,,,9,7
2019-05-27 09:17,HAK,5662,737-800,28,4,33,5,6,28,,,,,5,0
2019-05-27 09:16,XMN,5502,737-800,25,6,34,6,5,32,,,,,9,7
2019-05-27 09:16,XMN,1787,737-800,24,2,36,3,3,35,,,,,12,11
2019-05-27 09:16,PEK,5428,737-800,30,5,27,6,5,29,,,,,-3,-1
2019-05-27 09:07,HAK,1798,737-800,28,6,36,6,6,31,,,,,8,3
2019-05-27 09:02,KMG,7991,737-800,20,6,25,6,6,26,,,,,5,6
2019-05-27 08:53,HAK,1783,737-800,27,4,20,5,5,37,,,,,-7,10
2019-05-27 08:25,HAK,5522,737-800,26,9,36,8,9,35,1,,,1,10,9
2019-05-27 08:11,FOC,1480,737-800,25,5,29,5,5,29,,,,,4,4
2019-05-27 07:52,PEK,1493,737-800,21,6,24,6,6,24,,,,,3,3
2019-05-27 07:26,PEK,5709,737-800,21,6,28,6,6,30,,,,,7,9
2019-05-27 07:23,KMG,5732,737-800,20,4,26,4,4,26,,,,,6,6
2019-05-27 07:20,ZGC,7175,737-800,13,8,20,5,5,19,,,,,7,6
2019-05-27 07:15,PEK,1489,737-800,20,4,28,4,4,28,,,,,8,8
2019-05-27 07:13,XIY,5139,737-800,20,4,26,5,5,28,,,,,6,8
2019-05-27 07:13,PEK,1496,737-800,20,5,30,4,5,30,,,,,10,10
2019-05-27 06:59,ZGC,1735,737-800,11,4,22,4,4,20,,,,,11,9
2019-05-27 06:50,FOC,5430,737-800,24,6,34,5,4,35,1,1,,11,10,11
2019-05-27 06:31,HAK,5082,737-800,28,8,37,5,5,34,,,,,9,6
2019-05-27 06:23,ZGC,5372,737-800,9,8,20,7,8,20,,,,,11,11
2019-05-27 06:17,PEK,5520,737-800,19,7,29,7,6,24,,,,,10,5
2019-05-27 06:09,PEK,5482,737-800,20,2,22,4,4,28,,,,,2,8
2019-05-27 06:07,KMG,7990,737-800,20,4,28,4,3,26,,,,,8,6
2019-05-27 06:00,URC,5620,737-800,20,4,26,3,4,23,,,,,6,3
2019-05-27 06:00,FOC,5430,737-800,24,6,38,4,6,39,,,,,14,15
2019-05-27 05:58,URC,5620,737-800,25,4,26,4,5,24,,,,,1,-1
2019-05-27 05:53,URC,5712,737-800,17,2,22,3,2,23,,,,,5,6
2019-05-27 05:53,URC,2159,737-800,21,24,15,1,2,26,,,,,-6,5
2019-05-27 05:46,HAK,6063,737-800,27,6,36,6,7,36,,,,,9,9
2019-05-27 05:44,FOC,5430,737-800,24,6,38,4,6,38,,,,,14,14
2019-05-27 05:36,XIY,1495,737-800,22,5,25,8,0,28,,,,,3,6
2019-05-27 05:36,FOC,7113,737-800,20,5,30,5,5,27,,,,,10,7
2019-05-27 05:31,DLC,1538,737-800,17,2,26,4,2,24,,,,,9,7
2019-05-27 05:28,CAN,1928,737-800,28,6,28,9,8,34,,,,,0,6
2019-05-27 05:27,DLC,5138,737-800,17,4,30,4,6,28,,,,,13,11
2019-05-27 05:27,XIY,5180,737-800,21,4,26,4,5,24,,,,,5,3
2019-05-27 05:27,HHA,5466,737-800,26,4,28,7,8,30,,,,,2,4
2019-05-27 05:08,DLC ,5417,737-800,18,4,28,4,4,26,,,,,10,8
2019-05-27 04:57,URC,1541,737-800,22,5,28,7,6,27,,,,,6,5
2019-05-27 04:53,HGH,5337,737-800,24,5,32,6,5,32,,,,,8,8
2019-05-27 04:45,CAN,7173,737-800,27,4,36,5,5,36,,,,,9,9
2019-05-27 04:42,XIY,1162,737-800,25,2,30,3,3,26,,,,,5,1
2019-05-27 04:35,HGH,1497,737-800,25,4,32,4,4,33,,,,,7,8
2019-05-27 04:34,KMG,7993,737-800,15,6,28,6,6,28,,,,,13,13
2019-05-27 04:33,KMG,1209,737-800,15,4,32,3,4,28,1,,,1,17,13
2019-05-27 04:32,SZX,7619,737-800,27,7,36,7,6,36,,,,,9,9
2019-05-27 04:31,SZX,5579,737-800,27,7,36,7,6,36,,,,,9,9
2019-05-27 04:27,HAK,1213,737-800,30,4,36,6,6,36,,,,,6,6
2019-05-27 04:21,KMG,6015,737-800,20,4,30,4,4,24,,,,,10,4
2019-05-27 04:20,CGO,7992,737-800,28,7,28,8,7,28,,,,,0,0
2019-05-27 04:18,CGO,6800,737-800,28,4,26,5,4,24,,,,,-2,-4
2019-05-27 04:11,FOC,7395,737-800,25,6,28,4,5,27,,,,,3,2
2019-05-27 04:10,XIY,5180,737-800,22,8,30,8,8,26,,,,,8,4
2019-05-27 04:08,URC,1725,737-800,20,4,24,2,2,26,,,,,4,6
2019-05-27 04:04,CAN,1997,737-800,26,4,37,4,4,32,,,,,11,6
2019-05-27 03:59,HAK,1492,737-800,28,4,35,4,5,33,,,,,7,5
2019-05-27 03:58,HHA,5429,737-800,27,6,33,8,8,36,,,,,6,9
2019-05-27 03:58,HHA,7616,737-800,25,4,28,3,4,27,,,,,3,2
2019-05-27 03:54,KMG,7989,737-800,20,6,28,5,6,27,,,,,8,7
2019-05-27 03:54,MIG,5407,737-800,30,3,28,4,4,30,,,,,-2,0
2019-05-27 03:53,HRB,1433,737-800,10,4,26,4,4,25,,,,,16,15
2019-05-27 03:50,CAN,5521,737-800,27,4,30,5,4,30,,,,,3,3
2019-05-27 03:48,XIY,1435,737-800,24,6,29,6,6,28,,,,,5,4
2019-05-27 03:48,XIY,5115,737-800,20,4,20,6,5,21,,,,,0,1
2019-05-27 03:43,TYN ,5538 ,737-800,20,3,21,4,6,24,,,,,1,4
2019-05-27 03:42,URC,7378,737-800,20,5,28,6,6,28,,,,,8,8
2019-05-27 03:42,SYX,5137,737-800,29,8,31,5,4,35,,,,,2,6
2019-05-27 03:39,URC,1141,737-800,20,4,26,6,6,27,,,,,6,7
2019-05-27 03:38,CAN,5462,737-800,27,3,30,4,4,30,,,,,3,3
2019-05-27 03:36,DLC,1491,737-800,17,2,22,4,6,23,,,,,5,6
2019-05-27 03:36,HGH,7400,737-800,25,5,33,4,4,34,,,,,8,9
2019-05-27 03:32,DLC,6062,737-800,17,2,22,4,4,26,,,,,5,9
2019-05-27 03:30,HAK,1799,737-800,30,6,36,4,4,34,,,,,6,4
2019-05-27 03:28,DLC,5852,737-800,17,4,23,4,2,24,,,,,6,7
2019-05-27 03:26,URC,1795,737-800,20,3,27,4,4,26,,,,,7,6
2019-05-27 03:25,XIY,1902,737-800,24,4,27,5,5,26,,,,,3,2
2019-05-27 03:22,SZX,1130,737-800,27,3,36,3,3,36,,,,,9,9
2019-05-27 03:18,PEK,5406,737-800,20,4,25,4,5,24,,,,,5,4
2019-05-27 03:17,HAK,1386,737-800,28,7,33,6,4,36,,,,,5,8
2019-05-27 03:16,DLC,5359,737-800,15,5,26,3,4,24,,,,,11,9
2019-05-27 03:04,HGH,1101,737-800,26,3,32,3,4,32,,,,,6,6
2019-05-27 03:03,URC,7198,737-800,20,4,24,5,6,24,,,,,4,4
2019-05-27 02:58,XIY,1482,737-800,24,6,26,6,6,24,,,,,2,0
2019-05-27 02:58,XIY,1161,737-800,26,4,28,4,4,26,,,,,2,0
2019-05-27 02:57,SZX,6060,737-800,25,6,36,7,7,33,,,,,11,8
2019-05-27 02:56,HAK,1786,737-800,27,5,28,6,8,27,,,,,1,0
2019-05-27 02:55,CAN,5439,737-800,28,9,35,4,4,35,,,,,7,7
2019-05-27 02:48,HAK,1386,737-800,28,7,33,6,4,36,,,,,5,8
2019-05-27 02:47,URC,2157,737-800,19,3,23,6,6,22,,,,,4,3
2019-05-27 02:42,SZX,7619,737-800,26,4,30,6,6,32,,,,,4,6
2019-05-27 02:38,URC,5637,737-800,20,4,22,3,3,24,,,,,2,4
2019-05-27 02:38,SYX,1733,737-800,30,5,35,8,8,37,,1,,1,5,7
2019-05-27 02:36,SZX,5479,737-800,26,6,32,6,4,32,,,,,6,6
2019-05-27 02:34,HHA,7172,737-800,27,6,33,6,5,33,,,,,6,6
2019-05-27 02:33,URC,6268,737-800,25,4,29,4,5,27,,,,,4,2
2019-05-27 02:30,URC,1322,737-800,20,4,26,5,5,25,,,,,6,5
2019-05-27 02:30,CGO,1586,737-800,30,4,24,4,4,26,,,,,-6,-4
2019-05-27 02:28,CAN,5580,737-800,28,7,34,7,6,36,,,,,6,8
2019-05-27 02:26,HHA,1375,737-800,27,4,32,4,4,30,,,,,5,3
2019-05-27 02:22,XIY,5611,737-800,26,6,28,5,6,24,,,,,2,-2
2019-05-27 02:19,XIY,1903,737-800,20,1,22,2,2,21,,,,,2,1
2019-05-27 02:16,HHA,6103,737-800,27,6,30,6,5,32,,,,,3,5
2019-05-27 02:14,FOC,1549,737-800,26,5,26,4,5,27,,,,,0,1
2019-05-27 02:12,CAN,1542,737-800,28,4,34,4,4,31,,,,,6,3
2019-05-27 02:12,SYX,206G,737-800,29,3,30,4,4,30,,,,,1,1
2019-05-27 02:10,URC,5625,737-800,24,5,29,5,4,26,,,,,5,2
2019-05-27 02:01,YIH,1906,737-800,32,6,35,6,6,34,,,,,3,2
2019-05-27 02:00,YIH,1351,737-800,25,4,30,4,5,30,,,,,5,5
2019-05-27 02:00,URC,6995,737-800,20,3,26,2,2,23,,,,,6,3
2019-05-27 01:59,FOC,5503,737-800,24,2,34,4,3,28,,,,,10,4
2019-05-27 01:58,MIG,5409,737-800,20,4,26,4,5,28,,,,,6,8
2019-05-27 01:58,HAK,1995,737-800,28,9,37,6,5,36,,,,,9,8
2019-05-27 01:55,TYN,5371,737-800,18,8,22,6,6,24,,,,,4,6
2019-05-27 01:53,CAN,1548,737-800,26,4,32,4,3,30,,,,,6,4
2019-05-27 01:48,6016,KMG,737-800,20,4,24,4,4,22,,,,,4,2
2019-05-27 01:45,PEK,5481,737-800,20,5,28,5,5,26,,,,,8,6
2019-05-27 01:42,XIY,1163,737-800,25,4,23,4,5,24,,,,,-2,-1
2019-05-27 01:36,SYX,6065,737-800,29,4,37,5,5,36,,,,,8,7
2019-05-27 01:26,º£¿Ú,1547,737-800,27,8,36,8,8,34,,,,,9,7
2019-05-27 01:25,HHA,6066,737-800,27,2,30,3,3,30,,,,,3,3
2019-05-27 01:24,PEK,1372,737-800,18,5,28,4,5,26,,,,,10,8
2019-05-27 01:15,URC,1568,737-800,20,5,28,6,6,26,,,,,8,6
2019-05-27 01:14,SYX,1488,737-800,29,6,36,6,5,30,,,,,7,1
2019-05-27 01:12,MIG,5449,737-800,29,5,31,5,5,30,,,,,2,1
2019-05-27 01:10,HAK,5798,737-800,28,4,34,3,4,30,,,,,6,2
2019-05-27 01:08,URC,1726,737-800,20,4,28,4,4,22,,,,,8,2
2019-05-27 01:07,SYX ,1498,737-800,30,5,35,4,4,36,,,,,5,6
2019-05-27 01:07,HAK,5636,737-800,28,9,37,8,9,37,,,,,9,9
2019-05-27 01:05,HGH,5375,737-800,25,2,30,6,5,30,,,,,5,5
2019-05-27 01:03,HAK,206H,737-800,30,4,34,3,3,34,,,,,4,4
2019-05-27 01:02,XIY,7377,737-800,26,6,28,6,6,26,,,,,2,0
2019-05-27 00:54,TYN,5090,737-800,18,2,22,4,6,0,,,,,4,-18
2019-05-27 00:54,TYN,5090,737-800,18,2,22,4,6,0,,,,,4,-18
2019-05-27 00:54,TYN,5090,737-800,18,2,22,4,6,0,,,,,4,-18
2019-05-27 00:54,TYN,5090,737-800,18,2,22,4,6,0,,,,,4,-18
2019-05-27 00:54,TYN,5090,737-800,18,2,22,4,6,0,,,,,4,-18
2019-05-27 00:50,XIY,5373,737-800,20,4,22,4,3,23,,,,,2,3
2019-05-27 00:45,DLC,1490,737-800,17,2,24,2,4,24,,,,,7,7
2019-05-27 00:39,HHA,7886,737-800,27,4,34,4,4,34,,,,,7,7
2019-05-27 00:32,HAK,5089,737-800,27,8,31,1,2,35,,,,,4,8
2019-05-27 00:30,DLC,7639,737-800,16,4,26,4,4,27,,,,,10,11
2019-05-27 00:28,KHG,1323,737-800,15,3,22,3,4,23,,,,,7,8
2019-05-27 00:16,TSN,1373,737-800,20,2,28,1,2,25,,,,,8,5
2019-05-27 00:12,SZX,1729,737-800,28,5,30,5,4,32,,,,,2,4
2019-05-27 00:12,SZX,1503,737-800,28,3,35,4,3,35,,,,,7,7
2019-05-27 00:11,HGH,1728,737-800,24,5,30,5,5,28,,,,,6,4
2019-05-27 00:09,CGO,5687,737-800,29,4,24,4,5,26,,,,,-5,-3
2019-05-27 00:07,URC ,1996,737-800,25,4,22,5,5,25,,,,,-3,0
2019-05-27 00:07,URC ,1996,737-800,25,4,22,5,5,25,,,,,-3,0
2019-05-27 00:06,SZX,1102,737-800,27,4,36,4,4,36,,,,,9,9
2019-05-27 00:05,HAK,1793,737-800,28,6,35,4,4,34,,,,,7,6
2019-05-27 00:04,HAK,6061,737-800,27,6,32,4,3,30,,,,,5,3
2019-05-26 23:56,URC,7379,737-800,20,3,24,4,3,26,,,,,4,6
2019-05-26 23:53,URC,5623,737-800,25,4,26,4,5,24,,,,,1,-1
2019-05-26 23:46,HRB,1559,737-800,13,3,18,4,4,18,,,,,5,5
2019-05-26 23:41,TYN,1797,737-800,20,2,21,2,3,22,,,,,1,2
2019-05-26 23:40,CGO,1587,737-800,30,2,28,5,4,26,,,,,-2,-4
2019-05-26 23:39,URC,1570,737-800,15,3,22,3,4,22,,,,,7,7
2019-05-26 23:36,FOC,1562,737-800,25,5,34,4,5,34,,,,,9,9
2019-05-26 23:32,HGH,5408,737-800,24,5,30,5,5,28,,,,,6,4
2019-05-26 23:32,HAK,1929,737-800,27,8,38,4,3,35,,,Ö÷É¢ÈÈÆ÷,Ö÷É¢ÈÈÆ÷,11,8
2019-05-26 23:28,HAK,5855,737-800,27,7,33,8,7,31,,,,,6,4
2019-05-26 23:27,CGO,205U,737-800,31,4,28,4,4,28,,,,,-3,-3
2019-05-26 23:26,XNN,1103,737-800,3,4,15,4,5,19,,,,,12,16
2019-05-26 23:25,XNN,5116,737-800,3,6,18,7,6,16,,,,,15,13
2019-05-26 23:24,XNN,5135,737-800,3,4,16,5,5,19,,,,,13,16
2019-05-26 23:19,PEK,7171,737-800,22,4,26,4,3,27,,,,,4,5
2019-05-26 23:16,CKG,7399,737-800,20,5,31,6,4,28,,,,,11,8
2019-05-26 23:15,TYN,5136,737-800,20,4,18,4,4,22,,,,,-2,2
2019-05-26 23:12,CGO,205U,737-800,31,4,28,4,4,28,,,,,-3,-3
2019-05-26 23:10,CTU,1208,737-800,25,4,31,3,3,29,,,,,6,4
2019-05-26 23:01,HRB,1350,737-800,16,2,27,3,2,23,,,,,11,7
2019-05-26 22:57,CGO,1588,737-800,32,4,26,4,4,28,,,,,-6,-4
2019-05-26 22:57,CGO,5686,737-800,31,4,24,5,5,27,,,,,-7,-4
2019-05-26 22:56,CGO,1588,737-800,32,4,26,4,4,28,,,,,-6,-4
2019-05-26 22:49,CKG,5416,737-800,30,8,31,8,8,34,,,,,1,4
2019-05-26 22:45,SHE,7618,737-800,22,6,25,7,5,26,,,,,3,4
2019-05-26 22:45,URC,205V,737-800,24,5,29,2,3,28,,,,,5,4
2019-05-26 22:36,URC ,205T ,737-800,25,3,28,3,3,29,,,,,3,4
2019-05-26 22:30,XIY,7398,737-800,26,4,28,4,4,26,,,,,2,0
2019-05-26 22:30,SYX,206F,737-800,30,2,33,4,3,31,,,,,3,1
2019-05-26 22:20,URC,5733,737-800,25,6,26,6,6,26,,,,,1,1
2019-05-26 22:15,TYN,5463,737-800,25,5,18,6,5,19,,,,,-7,-6
2019-05-26 22:12,HAK,5083,737-800,29,5,30,9,8,37,,,,,1,8
2019-05-26 22:11,XIY,5638,737-800,26,4,22,6,4,30,,,,,-4,4
2019-05-26 22:04,URC,1325,737-800,23,4,20,4,4,23,,,,,-3,0
2019-05-26 22:02,MIG,6809,737-800,30,4,30,6,6,30,,,,,0,0
2019-05-26 21:59,HAK,1545,737-800,28,6,36,6,5,35,,,,,8,7
2019-05-26 21:44,PEK,5853,737-800,21,6,32,5,4,28,1,,,1,11,7
2019-05-26 20:37,HGH,5661,737-800,26,2,30,4,4,32,,,,,4,6
2019-05-26 20:23,URC,206P,737-800,25,3,24,5,4,24,,,,,-1,-1
2019-05-26 19:44,HGH,5661,737-800,26,2,30,4,4,32,,,,,4,6
2019-05-26 19:21,SZX,1786,737-800,28,2,31,2,2,31,,,,,3,3
2019-05-26 19:13,HGH,1487,737-800,25,2,30,2,2,30,,,,,5,5
2019-05-26 18:37,PEK,5538,737-800,24,7,35,2,2,33,,,,,11,9
2019-05-26 17:08,XIY,5405,737-800,33,5,28,6,5,27,,,,,-5,-6
2019-05-26 17:07,ÐìÖÝ,7988,737-800,20,7,34,3,7,34,,,,,14,14
2019-05-26 16:57,HAK,5346,737-800,30,8,36,6,6,36,,,,,6,6
2019-05-26 16:49,URC,1569,737-800,25,3,26,2,3,25,,,,,1,0
2019-05-26 13:46,YIH,1348,737-800,32,5,33,6,6,34,,,,,1,2
2019-05-26 10:29,URC,6268,737-800,20,3,28,4,4,28,,,,,8,8
2019-05-26 10:08,TYN,5090,737-800,20,2,26,2,2,26,,,,,6,6
2019-05-26 09:39,KMG,7993,737-800,20,5,26,6,6,24,,,,,6,4
2019-05-26 08:44,PEK,5481,737-800,24,6,22,7,5,30,,,,,-2,6
2019-05-26 08:21,XIY,5709,737-800,28,8,30,8,7,30,,,,,2,2
2019-05-26 08:16,SZX,1213,737-800,28,7,37,6,6,37,,,,,9,9
2019-05-26 08:14,SZX,1995,737-800,27,7,34,6,5,33,,,,,7,6
2019-05-26 08:12,SZX,7619,737-800,26,6,30,6,5,30,,,,,4,4
2019-05-26 07:59,ZGC,5136,737-800,12,6,26,4,5,24,,,,,14,12
2019-05-26 07:58,ZGC,7639,737-800,15,6,26,6,6,22,,,,,11,7
2019-05-26 07:41,PEK,5853,737-800,25,5,32,5,5,28,,,,,7,3
2019-05-26 07:25,PEK,1997,737-800,25,5,30,4,4,28,,,,,5,3
2019-05-26 07:23,XIY,1163,737-800,25,4,34,4,4,32,,,,,9,7
2019-05-26 07:20,ZGC,1735,737-800,15,0,20,5,5,19,,,,,5,4
2019-05-26 07:04,PEK,1787,737-800,25,1,30,6,5,30,,,,,5,5
2019-05-26 06:57,HGH,5337,737-800,24,4,30,4,4,34,,,,,6,10
2019-05-26 06:55,HGH,5502,737-800,24,4,30,4,4,34,,,,,6,10
2019-05-26 06:52,URC,1783,737-800,20,3,18,5,5,26,,,,,-2,6
2019-05-26 06:23,FOC,1435,737-800,24,8,36,8,8,32,,,,,12,8
2019-05-26 06:22,CAN,6065,737-800,24,6,36,7,7,34,1,,,1,12,10
2019-05-26 06:19,CKG,5416,737-800,23,6,26,4,5,25,,,,,3,2
2019-05-26 06:12,URC,1570,737-800,20,4,22,4,4,20,,,,,2,0
2019-05-26 06:07,SHA,1493,737-800,23,5,26,6,6,24,,,,,3,1
2019-05-26 06:06,CAN,5611,737-800,26,5,35,6,6,31,,,,,9,5
2019-05-26 05:51,CGO,7991,737-800,25,4,27,5,4,26,,,,,2,1
2019-05-26 05:51,CGO,7992,737-800,24,6,30,7,7,30,,,,,6,6
2019-05-26 05:50,CGO,1799,737-800,25,4,28,4,4,27,,,,,3,2
2019-05-26 05:45,XIY,5797,737-800,33,5,25,5,4,24,,,,,-8,-9
2019-05-26 05:42,HGH,6063,737-800,24,6,30,5,5,30,,,,,6,6
2019-05-26 05:39,URC,2159,737-800,20,8,26,2,2,24,,,,,6,4
2019-05-26 05:18,URC,1725,737-800,20,4,28,4,4,30,,,,,8,10
2019-05-26 05:16,PEK,5482,737-800,27,5,26,6,8,26,,,,,-1,-1
2019-05-26 05:16,HAK,HAK,737-800,26,3,27,4,5,32,,,,,1,6
2019-05-26 05:16,CGO,1587,737-800,24,5,32,3,3,30,,,,,8,6
2019-05-26 05:12,PEK,5539,737-800,27,6,32,5,5,28,,,,,5,1
2019-05-26 04:50,HAK,5522,737-800,27,7,36,7,6,34,,,,,9,7
2019-05-26 04:47,TSN,1542,737-800,27,4,30,3,3,28,,,,,3,1
2019-05-26 04:40,PEK,7171,737-800,25,6,24,8,6,26,,,,,-1,1
2019-05-26 04:35,CGO,5465,737-800,24,1,25,3,3,28,,,,,1,4
2019-05-26 04:35,HGH,5137,737-800,25,4,24,4,4,28,,,,,-1,3
2019-05-26 04:25,HAK,5480,737-800,27,10,38,7,4,23,,,,,11,-4
2019-05-26 04:21,PEK,5620,737-800,25,4,31,4,3,30,,,,,6,5
2019-05-26 04:06,FOC,1559,737-800,27,2,36,3,3,31,,,,,9,4
2019-05-26 04:05,FOC,1559,737-800,27,3,37,3,3,31,,,,,10,4
2019-05-26 04:04,FOC,1559,737-800,27,3,37,3,3,31,,,,,10,4
2019-05-26 04:04,CTU,1208,737-800,26,4,30,4,4,30,,,,,4,4
2019-05-26 04:01,PEK,5580,737-800,28,6,29,6,6,34,,,,,1,6
2019-05-26 03:53,CGO,5467,737-800,24,5,26,1,3,28,,,,,2,4
2019-05-26 03:50,XIY,5405,737-800,29,4,34,4,4,32,,,,,5,3
2019-05-26 03:48,URC,5637,737-800,20,4,22,2,2,20,,,,,2,0
2019-05-26 03:25,PEK,5538,737-800,27,7,29,3,5,28,,,,,2,1
2019-05-26 03:20,URC,5623,737-800,20,6,26,4,4,30,,,,,6,10
2019-05-26 03:18,FOC,1435,737-800,25,8,40,8,8,32,,,,,15,7
2019-05-26 03:14,TYN,206G,737-800,25,3,30,4,4,28,,,,,5,3
2019-05-26 03:13,XIY ,7398,737-800,26,6,25,5,6,26,,,,,-1,0
2019-05-26 03:07,XIY,5138,737-800,26,2,30,4,4,28,,,,,4,2
2019-05-26 03:02,KMG,1588,737-800,20,4,26,4,4,26,,,,,6,6
2019-05-26 03:00,HAK,6061,737-800,27,4,32,4,4,32,,,,,5,5
2019-05-26 02:59,Î÷°²,7113,737-800,25,6,30,6,6,29,,,,,5,4
2019-05-26 02:58,XIY,1162,737-800,25,2,30,2,2,28,,,,,5,3
2019-05-26 02:57,KMG,1209,737-800,25,3,30,4,4,28,,,,,5,3
2019-05-26 02:55,KMG ,6016,737-800,20,4,24,4,4,26,,,,,4,6
2019-05-26 02:54,KMG ,1586,737-800,18,4,24,4,6,30,,,,,6,12
2019-05-26 02:53,HAK,5733,737-800,27,8,36,6,7,34,,,,,9,7
2019-05-26 02:51,CAN,1928,737-800,25,7,27,6,8,28,,,,,2,3
2019-05-26 02:49,XIY,6060,737-800,28,6,32,5,5,20,,,,,4,-8
2019-05-26 02:46,HGH,5712,737-800,23,2,28,5,1,26,,,,,5,3
2019-05-26 02:43,HHA,7172,737-800,26,5,33,6,5,32,,,,,7,6
2019-05-26 02:42,HGH,5502,737-800,26,5,26,5,5,27,,,,,0,1
2019-05-26 02:41,HGH,5375,737-800,25,2,26,4,3,26,,,,,1,1
2019-05-26 02:41,HHA,5466,737-800,26,3,26,5,3,27,,,,,0,1
2019-05-26 02:41,HHA,1347,737-800,25,4,30,4,3,30,,,,,5,5
2019-05-26 02:40,CAN,1492,737-800,28,4,32,4,5,31,,,,,4,3
2019-05-26 02:39,CGO,7992,737-800,24,6,30,7,7,30,,,,,6,6
2019-05-26 02:39,URC,1996,737-800,17,5,18,5,5,24,,,,,1,7
2019-05-26 02:37,FOC,1562,737-800,25,4,34,5,4,34,,,,,9,9
2019-05-26 02:34,URC,5373,737-800,25,6,24,8,6,24,,,,,-1,-1
2019-05-26 02:32,FOC,5182,737-800,25,4,30,3,3,31,,,,,5,6
2019-05-26 02:30,XMN,5372,737-800,20,6,37,8,7,29,1,,,1,17,9
2019-05-26 02:29,FOC ,5428,737-800,23,4,27,5,4,28,,,,,4,5
2019-05-26 02:28,XMN,1796,737-800,20,4,27,0,0,0,,,,,7,-20
2019-05-26 02:26,SHA,1795,737-800,23,6,33,5,4,32,,,,,10,9
2019-05-26 02:22,KMG,1798,737-800,20,4,28,6,6,24,,,,,8,4
2019-05-26 02:22,URC,5637,737-800,20,4,22,2,2,20,,,,,2,0
2019-05-26 02:21,URC,206P,737-800,18,4,24,4,4,22,,,,,6,4
2019-05-26 02:19,URC,1568,737-800,18,6,24,6,6,22,,,,,6,4
2019-05-26 02:19,CAN,7173,737-800,26,4,35,5,4,34,,,,,9,8
2019-05-26 02:16,HET,5429,737-800,16,2,20,2,1,18,,,,,4,2
2019-05-26 02:16,URC,1726,737-800,18,5,23,3,4,30,,,,,5,12
2019-05-26 02:15,KMG,7988,737-800,20,4,26,6,4,28,,,,,6,8
2019-05-26 02:11,HAK,1497,737-800,26,4,34,4,5,30,,,,,8,4
2019-05-26 02:10,´óÁ¬,6062,737-800,17,6,26,4,4,24,,,,,9,7
2019-05-26 02:10,XIY,1481,737-800,28,6,25,5,5,25,,,,,-3,-3
2019-05-26 02:04,HHA,1375,737-800,26,4,24,4,4,26,,,,,-2,0
2019-05-26 01:59,HHA,7616,737-800,25,2,28,4,4,28,,,,,3,3
2019-05-26 01:58,FOC,1480,737-800,24,4,30,4,4,30,,,,,6,6
2019-05-26 01:57,URC,5661,737-800,20,4,20,4,4,24,,,,,0,4
2019-05-26 01:57,PEK,5338,737-800,27,3,28,4,4,32,,,,,1,5
2019-05-26 01:56,HAK,1372,737-800,26,6,36,5,5,36,,,,,10,10
2019-05-26 01:55,TYN,1545,737-800,25,6,30,6,6,30,,,,,5,5
2019-05-26 01:55,XIY,1902,737-800,28,6,32,5,6,30,,,,,4,2
2019-05-26 01:54,HHA,1547,737-800,26,6,34,6,6,35,,,,,8,9
2019-05-26 01:52,URC,1728,737-800,20,4,22,5,5,20,,,,,2,0
2019-05-26 01:52,SYX,1488,737-800,30,6,36,6,6,32,,,,,6,2
2019-05-26 01:52,XIY,1482,737-800,28,5,32,5,5,28,,,,,4,0
2019-05-26 01:49,URC,7379,737-800,20,4,26,4,4,28,,,,,6,8
2019-05-26 01:47,HRB,1433,737-800,17,2,26,2,3,21,,,,,9,4
2019-05-26 01:46,SZX,5638,737-800,27,6,36,6,5,37,,,,,9,10
2019-05-26 01:45,YIH,1351,737-800,22,5,29,5,4,28,,,,,7,6
2019-05-26 01:45,URC,2157,737-800,15,4,20,5,6,24,,,,,5,9
2019-05-26 01:37,KMG,5732,737-800,20,4,26,5,5,25,,,,,6,5
2019-05-26 01:31,HAK,5520,737-800,26,5,34,6,5,35,,,,,8,9
2019-05-26 01:29,PEK,5153,737-800,26,3,30,3,3,31,,,,,4,5
2019-05-26 01:27,SYX,5408,737-800,28,8,36,7,8,32,,,,,8,4
2019-05-26 01:27,SZX,1503,737-800,28,3,33,4,3,33,,,,,5,5
2019-05-26 01:27,SYX,5686,737-800,30,6,36,5,5,36,,,,,6,6
2019-05-26 01:24,HAK,1346,737-800,26,7,37,7,7,37,1,1,,11,11,11
2019-05-26 01:22,PEK,1549,737-800,28,5,32,6,6,33,,,,,4,5
2019-05-26 01:21,URC,295T,737-800,20,3,26,4,4,26,,,,,6,6
2019-05-26 01:21,PEK,1549,737-800,28,5,32,6,6,33,,,,,4,5
2019-05-26 01:13,CGO,6800,737-800,25,4,30,5,5,28,,,,,5,3
2019-05-26 01:12,XIY,1141,737-800,30,6,28,6,6,26,,,,,-2,-4
2019-05-26 01:11,MIG,7990,737-800,30,2,30,3,4,30,,,,,0,0
2019-05-26 01:08,DLC,1538,737-800,19,3,26,3,3,26,,,,,7,7
2019-05-26 01:05,SHE,5417,737-800,20,5,24,4,4,26,,,,,4,6
2019-05-26 01:05,XIY,5358,737-800,30,8,32,7,8,31,,,,,2,1
2019-05-26 01:01,HAK,1793,737-800,27,4,32,5,4,33,,,,,5,6
2019-05-26 01:00,DLC,1490,737-800,16,5,27,4,5,25,,,,,11,9
2019-05-26 00:57,URC,7378,737-800,19,5,28,5,5,29,,,,,9,10
2019-05-26 00:51,HAK,7886,737-800,26,4,36,3,4,36,1,1,,11,10,10
2019-05-26 00:44,MIG,5409,737-800,24,4,28,4,3,32,,,,,4,8
2019-05-26 00:41,DLC,1491,737-800,19,4,28,4,4,28,,,,,9,9
2019-05-26 00:41,URC,206P,737-800,20,4,23,4,4,26,,,,,3,6
2019-05-26 00:35,CAN,1386,737-800,25,4,34,4,4,34,,,,,9,9
2019-05-26 00:34,HAK,5083,737-800,29,6,32,6,6,36,,,,,3,7
2019-05-26 00:32,CGO,7400,737-800,26,5,32,6,6,32,,,,,6,6
2019-05-26 00:32,HAK,5436,737-800,30,6,31,5,6,30,,,,,1,0
2019-05-26 00:24,PEK,1373,737-800,27,4,32,3,3,26,,,,,5,-1
2019-05-26 00:23,YIH,1348,737-800,20,6,29,6,6,28,,,,,9,8
2019-05-26 00:22,CGO,7167,737-800,26,5,23,6,5,29,,,,,-3,3
2019-05-26 00:20,XIY,5139,737-800,28,6,30,6,6,28,,,,,2,0
2019-05-26 00:19,XIY,7377,737-800,29,8,32,7,6,30,,,,,3,1
2019-05-26 00:11,XMN,5406,737-800,26,4,30,3,5,30,,,,,4,4
2019-05-26 00:10,KHG,205V,737-800,15,3,22,2,3,23,,,,,7,8
2019-05-26 00:03,TYN,5371,737-800,26,7,30,5,5,28,,,,,4,2
2019-05-26 00:03,SZX,5579,737-800,27,8,37,8,8,36,1,,×óTCV¡¢×óSTCV,1×óTCV¡¢×óSTCV,10,9
2019-05-25 23:57,HAK,5713,737-800,27,7,37,7,7,32,1,,,1,10,5
2019-05-25 23:56,URC,1797,737-800,20,4,22,4,4,22,,,,,2,2
2019-05-25 23:55,URC,1797,737-800,20,4,22,4,4,22,,,,,2,2
2019-05-25 23:52,SYX,5439,737-800,28,8,34,8,7,34,,,,,6,6
2019-05-25 23:50,URC,5625,737-800,20,4,26,5,5,23,,,,,6,3
2019-05-25 23:49,XNN,5135,737-800,17,4,22,4,4,20,,,,,5,3
2019-05-25 23:42,TYN,1729,737-800,26,5,23,5,5,25,,,,,-3,-1
2019-05-25 23:42,HAK,1131,737-800,27,6,36,5,5,36,,,,,9,9
2019-05-25 23:41,FOC,5430,737-800,25,6,36,6,6,35,1,1,,11,11,10
2019-05-25 23:40,FOC,5430,737-800,25,6,38,6,6,36,,,,,13,11
2019-05-25 23:37,XIY,1785,737-800,25,2,26,6,4,28,,,,,1,3
2019-05-25 23:32,115,1496,737-800,28,5,31,5,5,32,,,,,3,4
2019-05-25 23:31,CKG,7399,737-800,25,5,31,5,6,27,,,,,6,2
2019-05-25 23:29,DLC,1927,737-800,19,3,22,6,3,22,,,,,3,3
2019-05-25 23:25,DLC,5852,737-800,18,3,28,4,4,26,,,,,10,8
2019-05-25 23:21,HRB,1350,737-800,19,4,27,5,5,25,,,,,8,6
2019-05-25 23:17,CGO,205U,737-800,26,4,30,4,4,30,,,,,4,4
2019-05-25 23:16,MIG,5407,737-800,25,4,30,4,2,24,,,,,5,-1
2019-05-25 23:13,HAK,5462,737-800,27,4,34,4,5,34,,,,,7,7
2019-05-25 23:12,PEK,1215,737-800,28,5,32,5,5,32,,,,,4,4
2019-05-25 23:12,DLC,6103,737-800,17,5,28,5,5,30,,,,,11,13
2019-05-25 23:05,PEK,1727,737-800,33,5,24,5,5,28,,,,,-9,-5
2019-05-25 23:05,CAN,5855,737-800,27,4,34,5,5,30,,,,,7,3
2019-05-25 23:05,HGH,1487,737-800,25,2,30,3,2,28,,,,,5,3
2019-05-25 22:58,URC,1541,737-800,23,4,28,5,5,28,,,,,5,5
2019-05-25 22:56,CAN,5483,737-800,28,6,36,6,7,32,,,,,8,4
2019-05-25 22:55,HRB,1905,737-800,21,3,27,4,4,21,,,,,6,0
2019-05-25 22:48,HAK,1929,737-800,27,6,37,6,7,37,,,,,10,10
2019-05-25 22:39,URC,1325,737-800,15,4,22,4,4,20,,,,,7,5
2019-05-25 22:35,SYX,1733,737-800,28,3,34,8,8,36,,,,,6,8
2019-05-25 22:23,HAK,5089,737-800,28,5,26,1,1,33,,,,,-2,5
2019-05-25 22:16,URC,1569,737-800,22,4,24,2,3,26,,,,,2,4
2019-05-25 22:12,HAK,5798,737-800,29,3,29,3,2,27,,,,,0,-2
2019-05-25 22:01,XNN,1103,737-800,20,4,26,5,4,24,,,,,6,4
2019-05-25 22:00,XNN,5116,737-800,20,4,18,4,4,20,,,,,-2,0
2019-05-25 21:59,HAK,5662,737-800,26,7,37,4,8,37,1,1,,11,11,11
2019-05-25 21:47,DLC,1489,737-800,18,4,24,4,4,26,,,,,6,8
2019-05-25 21:44,TYN,1102,737-800,28,3,30,4,4,30,,,,,2,2
2019-05-25 21:24,MIG,6809,737-800,26,4,28,6,6,28,,,,,2,2
2019-05-25 21:22,MIG,6809,737-800,26,4,28,6,6,28,,,,,2,2
2019-05-25 21:14,XUZ,7989,737-800,24,4,34,4,4,32,,,,,10,8
2019-05-25 20:26,HAK,1548,737-800,27,4,32,3,3,30,,,,,5,3
2019-05-25 20:25,HAK,206H,737-800,29,3,33,4,3,33,,,,,4,4
2019-05-25 20:17,DLC,1495,737-800,19,5,26,4,4,26,,,,,7,7
2019-05-25 20:13,SYX,7618,737-800,30,5,34,6,6,33,,,,,4,3
2019-05-25 19:55,XIY,5115,737-800,34,4,24,4,5,24,,,,,-10,-10
2019-05-25 19:38,URC,1322,737-800,27,4,25,5,4,25,,,,,-2,-2
2019-05-25 18:30,URC,7198,737-800,27,5,26,8,6,25,,,,,-1,-2
2019-05-25 15:09,URC,6995,737-800,23,5,25,6,5,21,,,,,2,-2
2019-05-25 13:23,FOC,7105,737-800,29,4,27,4,3,29,,,,,-2,0
2019-05-25 13:18,CTU,6800,737-800,20,3,29,3,3,28,,,,,9,8
2019-05-25 08:49,KMG,1798,737-800,20,6,29,6,6,22,,,,,9,2
2019-05-25 08:46,XNN,5135,737-800,18,6,18,7,7,19,,,,,0,1
2019-05-25 08:46,XNN,5522,737-800,18,5,17,6,6,18,,,,,-1,0
2019-05-25 08:24,PEK,5481,737-800,25,5,29,6,5,30,,,,,4,5
2019-05-25 08:04,HAK,7378,737-800,27,8,35,8,6,35,,,,,8,8
2019-05-25 08:04,HAK,7378,737-800,27,8,35,8,6,35,,,,,8,8
2019-05-25 07:42,ZGC ,1488,737-800,20,3,21,6,7,23,,,,,1,3
2019-05-25 07:41,HAK,1346,737-800,30,8,37,8,9,32,,,,,7,2
2019-05-25 07:39,PEK,1101,737-800,26,3,33,2,2,30,,,,,7,4
2019-05-25 07:30,XMN,5406,737-800,20,9,28,8,5,26,,,,,8,6
2019-05-25 07:29,HAK,1131,737-800,33,4,34,4,4,35,,,,,1,2
2019-05-25 07:29,XMN,5153,737-800,19,3,25,7,7,29,,,,,6,10
2019-05-25 07:28,XMN,7639,737-800,20,7,33,6,6,29,1,,,1,13,9
2019-05-25 07:28,XMN,1795,737-800,25,4,34,4,4,33,,,,,9,8
2019-05-25 07:23,SZX,7619,737-800,27,4,29,5,5,37,,,,,2,10
2019-05-25 07:20,XIY,5180,737-800,25,7,30,6,6,28,,,,,5,3
2019-05-25 07:15,PEK ,7379,737-800,20,6,30,5,5,30,,,,,10,10
2019-05-25 06:53,ZGC,5479,737-800,20,6,21,5,3,23,,,,,1,3
2019-05-25 06:48,URC,5467,737-800,17,4,26,5,4,23,,,,,9,6
2019-05-25 06:36,SZX,1213,737-800,27,7,36,6,6,35,,,,,9,8
2019-05-25 06:36,SZX,7619,737-800,27,4,29,5,5,37,,,,,2,10
2019-05-25 06:28,HAK,5375,737-800,27,4,34,2,2,27,,,,,7,0
2019-05-25 06:26,HAK,6065,737-800,30,4,36,6,6,36,,,,,6,6
2019-05-25 06:14,XIY,5116,737-800,25,4,26,4,4,26,,,,,1,1
2019-05-25 05:43,FOC,1435,737-800,25,6,35,7,7,32,1,,,1,10,7
2019-05-25 05:31,SZX,5579,737-800,29,8,36,6,6,34,,,,,7,5
2019-05-25 05:23,PEK,5620,737-800,29,4,28,4,3,26,,,,,-1,-3
2019-05-25 05:16,XIY,1163,737-800,28,2,30,2,2,24,,,,,2,-4
2019-05-25 05:12,HAK,5735,737-800,27,5,36,4,4,36,,,,,9,9
2019-05-25 05:10,URC,2159,737-800,18,5,18,4,5,20,,,,,0,2
2019-05-25 05:00,HHA,7172,737-800,28,4,32,4,4,32,,,,,4,4
2019-05-25 04:56,XIY,5138,737-800,30,4,28,4,4,31,,,,,-2,1
2019-05-25 04:55,XIY,1348,737-800,23,3,30,4,4,30,,,,,7,7
2019-05-25 04:54,XIY,1726,737-800,25,4,32,4,4,26,,,,,7,1
2019-05-25 04:39,HAK,5371,737-800,27,9,34,6,6,34,,,,,7,7
2019-05-25 04:36,FOC,5182,737-800,24,3,28,4,4,28,,,,,4,4
2019-05-25 04:36,FOC,5182,737-800,24,3,28,4,4,28,,,,,4,4
2019-05-25 04:35,FOC,1435,737-800,25,10,40,7,7,32,,,,,15,7
2019-05-25 04:31,CKG,5416,737-800,20,6,28,8,8,28,,,,,8,8
2019-05-25 04:28,SYX,5686,737-800,29,6,33,2,3,33,,,,,4,4
2019-05-25 04:28,CGO,1548,737-800,26,4,28,4,4,26,,,,,2,0
2019-05-25 04:28,CGO,1587,737-800,26,4,34,4,3,29,,,,,8,3
2019-05-25 04:22,SYX,5439,737-800,29,8,32,6,8,33,,,,,3,4
2019-05-25 04:16,PEK,5853,737-800,25,6,30,5,5,26,,,,,5,1
2019-05-25 04:11,PEK,5538,737-800,24,4,32,2,2,30,,,,,8,6
2019-05-25 04:06,SYX,5686,737-800,29,6,33,2,3,33,,,,,4,4
2019-05-25 04:04,PEK,5482,737-800,24,8,34,6,6,32,,,,,10,8
2019-05-25 04:02,XIY,1903,737-800,24,2,28,2,2,30,,,,,4,6
2019-05-25 03:57,FOC,5430,737-800,24,6,36,6,6,36,1,1,,11,12,12
2019-05-25 03:56,FOC,1562,737-800,24,4,31,4,4,31,,,,,7,7
2019-05-25 03:55,FOC,1562,737-800,24,4,32,4,5,32,,,,,8,8
2019-05-25 03:48,PEK,5463,737-800,30,5,26,5,4,27,,,,,-4,-3
2019-05-25 03:48,KMG,7993,737-800,18,6,27,6,7,24,,,,,9,6
2019-05-25 03:46,CGO,205V,737-800,26,5,30,5,2,28,,,,,4,2
2019-05-25 03:44,URC,1797,737-800,17,6,26,4,4,24,,,,,9,7
2019-05-25 03:43,URC,6268,737-800,15,3,26,4,5,24,,,,,11,9
2019-05-25 03:42,URC,5661,737-800,16,4,20,4,4,24,,,,,4,8
2019-05-25 03:42,URC,5625,737-800,16,3,23,3,4,23,,,,,7,7
2019-05-25 03:42,TYN,206G,737-800,20,4,28,4,4,26,,,,,8,6
2019-05-25 03:42,URC,205U,737-800,15,4,25,4,4,25,,,,,10,10
2019-05-25 03:41,URC,1728,737-800,17,4,28,5,5,22,,,,,11,5
2019-05-25 03:41,URC,1570,737-800,20,6,24,6,6,20,,,,,4,0
2019-05-25 03:40,URC,5623,737-800,17,6,27,6,6,24,,,,,10,7
2019-05-25 03:40,URC,5373,737-800,16,7,22,6,5,22,,,,,6,6
2019-05-25 03:39,URC,1725,737-800,20,4,26,4,5,26,,,,,6,6
2019-05-25 03:39,XIY,1482,737-800,23,6,28,6,6,22,,,,,5,-1
2019-05-25 03:33,URC,1568,737-800,20,7,27,6,6,24,,,,,7,4
2019-05-25 03:31,SZX,5733,737-800,27,6,34,6,6,32,,,,,7,5
2019-05-25 03:29,HAK,5375,737-800,28,7,38,10,10,36,,,,,10,8
2019-05-25 03:25,HHA,1547,737-800,27,6,36,6,5,36,,,,,9,9
2019-05-25 03:25,HAK,5405,737-800,27,7,36,7,5,36,,,,,9,9
2019-05-25 03:24,DLC,1489,737-800,22,4,23,3,4,24,,,,,1,2
2019-05-25 03:17,KMG,7990,737-800,20,3,28,4,4,24,,,,,8,4
2019-05-25 03:16,DLC,6103,737-800,20,6,27,6,6,27,,,,,7,7
2019-05-25 03:14,XIY,5503,737-800,20,5,18,4,6,16,,,,,-2,-4
2019-05-25 03:13,DLC,1549,737-800,21,5,24,4,4,26,,,,,3,5
2019-05-25 03:11,FOC,1559,737-800,24,3,34,3,4,22,1,,,1,10,-2
2019-05-25 03:09,DLC,1490,737-800,20,5,26,5,4,25,,,,,6,5
2019-05-25 03:06,DLC,5358,737-800,20,4,28,6,6,28,,,,,8,8
2019-05-25 03:06,XIY,7398,737-800,29,2,22,2,4,22,,,,,-7,-7
2019-05-25 03:06,XIY,5797,737-800,29,4,26,4,6,28,,,,,-3,-1
2019-05-25 03:04,HAK,5083,737-800,28,4,30,8,8,36,,,,,2,8
2019-05-25 03:00,PEK,5852,737-800,25,6,29,4,4,24,,,,,4,-1
2019-05-25 02:58,HAK,1929,737-800,28,6,34,5,4,32,,,,,6,4
2019-05-25 02:57,PEK,1785,737-800,25,0,25,5,4,25,,,,,0,0
2019-05-25 02:53,SYX,1498,737-800,28,4,36,4,5,32,,,,,8,4
2019-05-25 02:52,XIY,1162,737-800,26,3,31,4,4,33,,,,,5,7
2019-05-25 02:51,CAN,7173,737-800,26,4,34,5,4,33,,,,,8,7
2019-05-25 02:49,HHA,1347,737-800,27,4,30,4,4,30,,,,,3,3
2019-05-25 02:49,º£¿Ú,1103,737-800,27,4,37,6,5,36,,,,,10,9
2019-05-25 02:48,SYX,206F,737-800,28,3,34,3,3,32,,,,,6,4
2019-05-25 02:44,TYN,1102,737-800,28,4,26,5,5,26,,,,,-2,-2
2019-05-25 02:42,YIH,1351,737-800,25,4,30,5,4,29,,,,,5,4
2019-05-25 02:40,SYX,1733,737-800,38,3,34,6,6,34,,,,,-4,-4
2019-05-25 02:37,KMG,7988,737-800,21,5,27,5,4,26,,,,,6,5
2019-05-25 02:32,SZX,1995,737-800,25,7,34,8,6,32,,,,,9,7
2019-05-25 02:31,XIY,5136,737-800,24,4,26,4,4,33,,,,,2,9
2019-05-25 02:30,HAK,7886,737-800,27,3,30,4,3,35,,,,,3,8
2019-05-25 02:30,URC,7377,737-800,15,5,22,3,4,20,,,,,7,5
2019-05-25 02:29,URC,5346,737-800,15,4,24,2,4,22,,,,,9,7
2019-05-25 02:28,URC,1996,737-800,15,3,22,5,4,20,,,,,7,5
2019-05-25 02:28,HGH,5636,737-800,25,6,30,6,6,30,,,,,5,5
2019-05-25 02:27,HAK,1497,737-800,27,3,36,4,3,35,,,,,9,8
2019-05-25 02:26,CGO,1588,737-800,25,4,28,4,4,28,,,,,3,3
2019-05-25 02:25,CAN,5480,737-800,25,8,36,5,3,24,,,,,11,-1
2019-05-25 02:20,URC,7198,737-800,22,2,25,3,2,26,,,,,3,4
2019-05-25 02:18,HGH,7175,737-800,26,5,30,5,4,27,,,,,4,1
2019-05-25 02:15,XIY,1348,737-800,23,3,30,4,4,30,,,,,7,7
2019-05-25 02:13,XIY,1161,737-800,24,4,32,4,4,28,,,,,8,4
2019-05-25 02:07,CAN,1727,737-800,27,4,29,8,9,30,,,,,2,3
2019-05-25 02:02,FOC,1480,737-800,24,4,27,5,4,28,,,,,3,4
2019-05-25 02:02,HHA,5082,737-800,28,4,30,4,5,30,,,,,2,2
2019-05-25 02:00,CAN,1799,737-800,27,4,36,4,5,32,,,,,9,5
2019-05-25 01:59,FOC,1997,737-800,24,5,32,4,4,28,,,,,8,4
2019-05-25 01:58,SYX,5465,737-800,28,6,37,6,5,38,1,1,,11,9,10
2019-05-25 01:58,DLC,5359,737-800,22,4,24,5,4,24,,,,,2,2
2019-05-25 01:54,HHA,5466,737-800,28,2,28,4,2,22,,,,,0,-6
2019-05-25 01:50,DLC,1495,737-800,20,4,26,4,4,24,,,,,6,4
2019-05-25 01:50,FOC,7113,737-800,28,4,32,4,4,32,,,,,4,4
2019-05-25 01:46,ZGC,1735,737-800,20,6,23,7,5,25,,,,,3,5
2019-05-25 01:45,KMG,6016,737-800,21,6,30,4,4,29,,,,,9,8
2019-05-25 01:42,KMG,7991,737-800,21,6,27,7,6,26,,,,,6,5
2019-05-25 01:42,MIG,5449,737-800,23,5,32,4,4,29,,,,,9,6
2019-05-25 01:39,PEK,5539,737-800,25,6,34,5,5,28,,,,,9,3
2019-05-25 01:39,XIY,1902,737-800,26,5,30,5,6,28,,,,,4,2
2019-05-25 01:34,HAK,1372,737-800,28,6,32,5,5,32,,,,,4,4
2019-05-25 01:33,CAN,5855,737-800,27,4,28,6,6,29,,,,,1,2
2019-05-25 01:33,HGH,6061,737-800,25,4,30,4,4,29,,,,,5,4
2019-05-25 01:32,KMG,7167,737-800,20,6,28,5,6,26,,,,,8,6
2019-05-25 01:27,MIG,5407,737-800,20,4,28,5,4,29,,,,,8,9
2019-05-25 01:27,CAN,5611,737-800,26,5,36,5,5,31,1,,,1,10,5
2019-05-25 01:25,CKG,7618,737-800,23,5,26,4,4,27,,,,,3,4
2019-05-25 01:24,XIY,5483,737-800,20,5,20,4,5,20,,,,,0,0
2019-05-25 01:23,HAK,5798,737-800,28,3,34,2,2,28,,,,,6,0
2019-05-25 01:20,HAK,1793,737-800,25,4,36,7,7,30,,,,,11,5
2019-05-25 01:20,CAN,1492,737-800,26,4,32,4,3,31,,,,,6,5
2019-05-25 01:18,TYN,5090,737-800,25,2,24,2,2,24,,,,,-1,-1
2019-05-25 01:18,HHA,5429,737-800,28,4,32,7,7,34,,,,,4,6
2019-05-25 01:17,URC,6995,737-800,15,4,26,5,5,22,,,,,11,7
2019-05-25 01:16,YIH,1906,737-800,24,6,30,5,5,30,,,,,6,6
2019-05-25 01:15,HGH,5137,737-800,30,3,20,3,2,28,,,,,-10,-2
2019-05-25 01:08,5418,CAN,737-800,27,9,30,3,3,30,,,,,3,3
2019-05-25 01:04,DLC,6062,737-800,20,4,24,6,5,22,,,,,4,2
2019-05-25 01:04,XIY,1726,737-800,25,4,32,4,4,26,,,,,7,1
2019-05-25 01:02,SZX,1729,737-800,25,6,32,6,6,30,,,,,7,5
2019-05-25 01:01,KMG,7989,737-800,19,5,28,6,5,28,,,,,9,9
2019-05-25 00:59,URC,1322,737-800,18,2,26,2,2,26,,,,,8,8
2019-05-25 00:56,HHA,1375,737-800,28,4,32,4,4,28,,,,,4,0
2019-05-25 00:51,TYN,1545,737-800,20,4,26,6,6,28,,,,,6,8
2019-05-25 00:48,HGH,5502,737-800,30,4,28,3,3,28,,,,,-2,-2
2019-05-25 00:44,HAK,7616,737-800,27,4,33,4,5,33,,,,,6,6
2019-05-25 00:37,CGO,1587,737-800,26,4,34,4,3,29,,,,,8,3
2019-05-25 00:37,DLC,1491,737-800,20,5,30,5,5,28,,,,,10,8
2019-05-25 00:28,SYX,5417,737-800,29,6,31,6,5,33,,,,,2,4
2019-05-25 00:19,XIY,1373,737-800,29,4,28,4,4,24,,,,,-1,-5
2019-05-25 00:10,XIY,1141,737-800,24,6,34,6,6,32,1,,,1,10,8
2019-05-25 00:08,HAK,1503,737-800,28,6,34,4,4,32,,,,,6,4
2019-05-25 00:01,HGH,5712,737-800,30,2,28,6,2,26,,,,,-2,-4
2019-05-24 23:56,KHG,206P,737-800,28,3,23,4,3,22,,,,,-5,-6
2019-05-24 23:47,809,5580,737-800,25,6,28,6,6,24,,,,,3,-1
2019-05-24 23:37,XIY,1538,737-800,29,3,28,4,3,28,,,,,-1,-1
2019-05-24 23:34,CAN,5521,737-800,27,5,30,4,2,28,,,,,3,1
2019-05-24 23:33,HAK,7400,737-800,28,7,36,7,8,36,,,,,8,8
2019-05-24 23:25,HAK,1542,737-800,27,4,35,5,6,34,,,,,8,7
2019-05-24 23:22,HRB,7395,737-800,26,7,28,7,6,27,,,,,2,1
2019-05-24 23:08,TYN,1493,737-800,25,6,23,6,6,24,,,,,-2,-1
2019-05-24 23:07,HAK,5581,737-800,28,8,33,7,6,36,,,,,5,8
2019-05-24 23:03,HRB,1350,737-800,25,3,30,4,4,28,,,,,5,3
2019-05-24 22:59,CGO,1209,737-800,26,4,35,4,4,31,,,,,9,5
2019-05-24 22:59,HHA,5482,737-800,30,5,34,6,4,35,,,,,4,5
2019-05-24 22:49,HHA,6808,737-800,28,4,32,4,4,31,,,,,4,3
2019-05-24 22:48,HAK,1386,737-800,30,2,35,3,4,32,,,,,5,2
2019-05-24 22:48,SZX,5478,737-800,27,4,34,4,4,33,,,,,7,6
2019-05-24 22:47,DLC,1927,737-800,24,3,25,5,3,26,,,,,1,2
2019-05-24 22:46,URC,1783,737-800,20,4,20,4,4,22,,,,,0,2
2019-05-24 22:45,CGO,7399,737-800,25,6,30,4,4,25,,,,,5,0
2019-05-24 22:41,HAK,5662,737-800,29,8,37,6,8,37,,,,,8,8
2019-05-24 22:33,SZX,1541,737-800,27,6,35,6,6,36,,,,,8,9
2019-05-24 22:29,HAK,206H,737-800,28,4,34,3,2,33,,,,,6,5
2019-05-24 22:28,URC,1323,737-800,18,4,26,3,4,23,,,,,8,5
2019-05-24 22:25,CGO,6015,737-800,29,4,26,4,4,26,,,,,-3,-3
2019-05-24 22:22,CAN,1215,737-800,27,4,32,6,6,34,,,,,5,7
2019-05-24 22:18,HAK,5462,737-800,28,6,36,7,6,34,,,,,8,6
2019-05-24 22:14,URC,1496,737-800,20,4,28,4,4,28,,,,,8,8
2019-05-24 22:04,TYN,1786,737-800,20,4,24,4,4,22,,,,,4,2
2019-05-24 22:00,MIG,5409,737-800,23,4,28,4,4,29,,,,,5,6
2019-05-24 21:57,URC,1569,737-800,18,5,28,4,3,26,,,,,10,8
2019-05-24 21:53,CGO,7992,737-800,29,6,26,6,6,26,,,,,-3,-3
2019-05-24 21:53,SYX,5408,737-800,30,8,36,6,4,31,,,,,6,1
2019-05-24 21:52,HGH,5337,737-800,29,5,31,5,5,31,,,,,2,2
2019-05-24 21:51,HAK,5713,737-800,25,6,36,6,6,32,,,,,11,7
2019-05-24 21:39,CAN,1928,737-800,27,5,27,6,7,30,,,,,0,3
2019-05-24 21:34,ZGC,6060,737-800,24,4,28,6,6,24,,,,,4,0
2019-05-24 21:26,XIY,5139,737-800,32,4,30,4,4,28,,,,,-2,-4
2019-05-24 21:25,FOC,5430,737-800,24,6,24,6,6,24,,,,,0,0
2019-05-24 21:01,HA?K,5713,737-800,27,6,36,6,6,32,,,,,9,5
2019-05-24 20:30,HHA,5082,737-800,30,4,30,4,5,30,,,,,0,0
2019-05-24 20:23,HAK,7171,737-800,34,4,32,5,4,32,,,,,-2,-2
2019-05-24 20:03,HAK,1346,737-800,30,10,44,8,8,39,,,,,14,9
2019-05-24 19:59,URC,1325,737-800,20,4,26,4,5,22,,,,,6,2
2019-05-24 19:12,HRB,1905,737-800,34,3,24,5,4,24,,,,,-10,-10
2019-05-24 17:33,ÐìÖÝ,1208,737-800,25,3,32,3,2,30,,,,,7,5
2019-05-24 16:11,URC,1570,737-800,20,6,24,6,6,20,,,,,4,0
2019-05-24 15:35,HAK,5687,737-800,36,5,32,4,4,34,,,,,-4,-2
2019-05-24 13:58,YIH,7105,737-800,32,4,31,3,4,31,,,,,-1,-1
2019-05-24 12:03,URC,6268,737-800,20,3,27,5,5,24,,,,,7,4
2019-05-24 11:28,PEK,5482,737-800,28,6,30,5,4,31,,,,,2,3
2019-05-24 09:29,PEK,7639,737-800,29,6,26,6,7,26,,,,,-3,-3
2019-05-24 08:43,SZX,1571,737-800,26,4,32,4,4,29,,,,,6,3
2019-05-24 08:25,PEK,1785,737-800,28,3,25,4,4,26,,,,,-3,-2
2019-05-24 08:23,KMG,6015,737-800,21,5,24,4,6,26,,,,,3,5
2019-05-24 08:02,HRB,1559,737-800,20,3,28,3,4,26,,,,,8,6
2019-05-24 07:40,HAK,1487,737-800,25,3,32,2,2,31,,,,,7,6
2019-05-24 07:38,URC,2159,737-800,13,5,24,4,4,20,,,,,11,7
2019-05-24 07:37,URC,2157,737-800,13,4,22,5,5,24,,,,,9,11
2019-05-24 07:26,ZGC ,6060,737-800,15,4,20,4,4,16,,,,,5,1
2019-05-24 07:25,ZGC ,5581,737-800,15,4,21,4,5,18,,,,,6,3
2019-05-24 07:05,PEK,1103,737-800,25,6,32,4,4,30,,,,,7,5
2019-05-24 06:57,CKG,5416,737-800,20,8,30,9,9,32,,1,,1,10,12
2019-05-24 06:46,XMN,1488,737-800,25,6,34,6,5,30,,,,,9,5
2019-05-24 06:27,HGH,5580,737-800,25,4,26,5,5,30,,,,,1,5
2019-05-24 06:15,XMN,6063,737-800,25,6,35,6,5,35,1,1,,11,10,10
2019-05-24 06:15,XMN,1795,737-800,25,4,32,4,4,32,,,,,7,7
2019-05-24 06:14,XMN,5372,737-800,24,8,30,8,8,33,,,,,6,9
2019-05-24 05:59,KMG,5449,737-800,20,5,20,6,6,24,,,,,0,4
2019-05-24 05:42,CAN,5855,737-800,26,7,32,8,7,28,,,,,6,2
2019-05-24 05:32,CAN,5521,737-800,26,4,29,3,2,27,,,,,3,1
2019-05-24 05:31,CAN,5153,737-800,25,4,34,4,4,36,,,,,9,11
2019-05-24 05:30,HGH,5853,737-800,25,4,30,4,4,28,,,,,5,3
2019-05-24 05:25,CAN,5418,737-800,25,6,28,4,3,28,,,,,3,3
2019-05-24 05:09,URC,5637,737-800,14,2,24,2,2,22,,,,,10,8
2019-05-24 04:56,SYX,5405,737-800,29,6,36,7,5,35,,,,,7,6
2019-05-24 04:44,ZGC,5417,737-800,20,7,21,6,5,23,,,,,1,3
2019-05-24 04:41,URC,1725,737-800,14,6,28,5,5,26,,,,,14,12
2019-05-24 04:32,SYX,5686,737-800,30,5,34,4,5,30,,,,,4,0
2019-05-24 04:24,PEK,5465,737-800,25,2,28,2,3,22,,,,,3,-3
2019-05-24 04:22,HAK,1796,737-800,28,3,31,3,4,33,,,,,3,5
2019-05-24 04:19,HHA,5429,737-800,25,4,26,5,5,28,,,,,1,3
2019-05-24 04:17,HAK,5375,737-800,27,4,34,7,7,33,,,,,7,6
2019-05-24 04:14,DLC,5358,737-800,20,6,26,5,5,28,,,,,6,8
2019-05-24 04:14,XIY ,5579,737-800,20,6,32,6,6,29,1,,,1,12,9
2019-05-24 04:13,DLC,7378,737-800,17,6,30,5,6,30,,,,,13,13
2019-05-24 04:12,DLC,7378,737-800,17,6,30,5,6,30,,,,,13,13
2019-05-24 04:11,CKG,5416,737-800,20,8,26,5,5,28,,,,,6,8
2019-05-24 04:10,CKG,5416,737-800,20,8,30,9,9,32,,,,,10,12
2019-05-24 04:10,HAK,7167,737-800,28,6,32,7,5,33,,,,,4,5
2019-05-24 04:05,SYX,5439,737-800,29,6,37,5,5,35,1,,,1,8,6
2019-05-24 03:55,KMG,1208,737-800,20,3,26,3,3,25,,,,,6,5
2019-05-24 03:54,KMG,7991,737-800,21,6,27,6,6,27,,,,,6,6
2019-05-24 03:54,KMG,1586,737-800,20,5,26,4,4,34,,1,,1,6,14
2019-05-24 03:53,DLC,1490,737-800,17,5,26,4,4,24,,,,,9,7
2019-05-24 03:49,SYX,5408,737-800,28,5,32,3,3,28,,,,,4,0
2019-05-24 03:48,TYN,5139,737-800,20,1,18,5,5,15,,,,,-2,-5
2019-05-24 03:47,FOC,1435,737-800,25,5,36,6,6,34,1,,,1,11,9
2019-05-24 03:45,XIY,1903,737-800,20,1,20,1,2,22,,,,,0,2
2019-05-24 03:42,HHA,5466,737-800,24,3,20,4,4,22,,,,,-4,-2
2019-05-24 03:41,HHA,5481,737-800,25,6,30,7,6,28,,,,,5,3
2019-05-24 03:40,XIY,1163,737-800,25,2,34,2,2,30,,,,,9,5
2019-05-24 03:37,HHA,6065,737-800,25,4,26,5,5,27,,,,,1,2
2019-05-24 03:37,FOC,1480,737-800,22,5,28,5,4,26,,,,,6,4
2019-05-24 03:29,FOC,5338,737-800,23,4,26,4,4,28,,,,,3,5
2019-05-24 03:28,HHA,1547,737-800,27,5,29,5,6,31,,,,,2,4
2019-05-24 03:25,SZX,5520,737-800,25,5,34,6,6,32,,,,,9,7
2019-05-24 03:25,DLC,1927,737-800,18,4,23,8,3,24,,,,,5,6
2019-05-24 03:23,DLC,1102,737-800,18,3,28,4,4,28,,,,,10,10
2019-05-24 03:12,CGO,1587,737-800,26,2,28,4,2,26,,,,,2,0
2019-05-24 03:10,TYN ,5709,737-800,25,6,28,6,8,28,,,,,3,3
2019-05-24 03:02,XIY,1161,737-800,23,3,30,3,3,28,,,,,7,5
2019-05-24 03:01,HAK,7400,737-800,26,5,34,5,5,35,,,,,8,9
2019-05-24 02:58,URC,5625,737-800,15,5,28,5,5,24,,,,,13,9
2019-05-24 02:56,SYX,7399,737-800,28,4,32,4,4,32,,,,,4,4
2019-05-24 02:54,CAN,7886,737-800,25,3,34,4,3,34,,,,,9,9
2019-05-24 02:50,HHA,5428,737-800,25,4,28,6,5,30,,,,,3,5
2019-05-24 02:48,XIY,1902,737-800,20,7,25,7,8,27,,,,,5,7
2019-05-24 02:48,URC,1568,737-800,15,6,26,6,7,23,,,,,11,8
2019-05-24 02:37,XIY,5503,737-800,25,2,24,7,8,33,,,,,-1,8
2019-05-24 02:35,HAK,5733,737-800,27,7,33,5,6,33,,,,,6,6
2019-05-24 02:35,URC,1496,737-800,14,4,24,3,4,24,,,,,10,10
2019-05-24 02:32,DLC,1495,737-800,17,4,28,3,4,25,,,,,11,8
2019-05-24 02:29,HAK,1492,737-800,26,4,34,4,4,32,,,,,8,6
2019-05-24 02:27,URC,5620,737-800,13,2,24,3,4,22,,,,,11,9
2019-05-24 02:23,XIY,5116,737-800,27,5,24,5,5,24,,,,,-3,-3
2019-05-24 02:21,URC,7198,737-800,14,4,26,6,5,24,,,,,12,10
2019-05-24 02:17,URC,5373,737-800,14,3,28,4,4,22,,,,,14,8
2019-05-24 02:13,CAN,1538,737-800,25,4,34,4,3,31,,,,,9,6
2019-05-24 02:13,CGO,1325,737-800,28,4,23,5,5,25,,,,,-5,-3
2019-05-24 02:11,PEK,5539,737-800,22,5,30,8,7,35,,,,,8,13
2019-05-24 02:11,HAK,7172,737-800,28,4,34,4,5,33,,,,,6,5
2019-05-24 02:09,XIY,1348,737-800,26,5,30,4,4,30,,,,,4,4
2019-05-24 02:08,CAN,5611,737-800,25,6,35,6,5,30,1,,,1,10,5
2019-05-24 02:08,HGH,5137,737-800,28,2,18,2,2,26,,,,,-10,-2
2019-05-24 02:07,URC ,1996,737-800,15,5,22,5,5,24,,,,,7,9
2019-05-24 02:06,KMG,6016,737-800,20,3,24,4,5,25,,,,,4,5
2019-05-24 02:04,CAN,1549,737-800,26,6,32,6,6,30,,,,,6,4
2019-05-24 02:02,SYX,206F,737-800,33,4,34,2,2,31,,,,,1,-2
2019-05-24 02:02,CGO,1209,737-800,27,4,30,4,4,28,,,,,3,1
2019-05-24 02:01,CGO,7990,737-800,26,3,27,3,3,27,,,,,1,1
2019-05-24 02:01,HAK,5735,737-800,30,2,32,2,2,33,,,,,2,3
2019-05-24 02:00,SYX,7175,737-800,28,3,33,5,3,32,,,,,5,4
2019-05-24 02:00,HAK,6066,737-800,30,4,36,2,2,35,,,,,6,5
2019-05-24 01:59,HRB,1905,737-800,17,3,25,5,6,27,,,,,8,10
2019-05-24 01:56,FOC,7113,737-800,25,0,0,0,0,0,,,,,-25,-25
2019-05-24 01:56,FOC,7113,737-800,25,4,30,5,5,28,,,,,5,3
2019-05-24 01:53,URC,1997,737-800,13,6,28,3,4,20,,,,,15,7
2019-05-24 01:53,URC,5620,737-800,16,2,24,3,4,22,,,,,8,6
2019-05-24 01:52,PEK,6062,737-800,27,4,34,4,4,32,,,,,7,5
2019-05-24 01:49,SZX,1995,737-800,27,6,32,6,6,32,,,,,5,5
2019-05-24 01:49,URC,6995,737-800,17,4,26,5,4,22,,,,,9,5
2019-05-24 01:49,XIY,1141,737-800,25,5,28,5,5,28,,,,,3,3
2019-05-24 01:49,XIY,1141,737-800,25,5,28,5,5,28,,,,,3,3
2019-05-24 01:47,HAK,5540,737-800,28,8,35,5,5,34,,,,,7,6
2019-05-24 01:47,PEK,5463,737-800,26,4,24,4,4,24,,,,,-2,-2
2019-05-24 01:44,HAK,1503,737-800,26,3,32,4,4,32,,,,,6,6
2019-05-24 01:44,HAK,1131,737-800,26,5,34,4,5,34,,,,,8,8
2019-05-24 01:44,PEK,5538,737-800,26,6,36,3,3,34,,,,,10,8
2019-05-24 01:41,HGH,1130,737-800,30,2,31,2,2,32,,,,,1,2
2019-05-24 01:35,XIY,5713,737-800,25,6,22,6,6,26,,,,,-3,1
2019-05-24 01:32,FOC,1350,737-800,22,4,30,4,4,28,,,,,8,6
2019-05-24 01:32,XIY,5115,737-800,24,4,20,6,6,26,,,,,-4,2
2019-05-24 01:20,YIH,7105,737-800,30,4,28,4,3,26,,,,,-2,-4
2019-05-24 01:20,HAK,1493,737-800,28,6,32,5,6,30,,,,,4,2
2019-05-24 01:18,YIH,1906,737-800,30,6,32,6,6,31,,,,,2,1
2019-05-24 01:16,CGO,1209,737-800,27,4,30,4,4,28,,,,,3,1
2019-05-24 01:15,URC,5467,737-800,15,1,26,4,1,22,,,,,11,7
2019-05-24 01:11,HHA,5481,737-800,25,6,30,7,6,28,,,,,5,3
2019-05-24 01:08,HGH,5478,737-800,27,4,29,5,4,27,,,,,2,0
2019-05-24 01:01,XIY,1162,737-800,25,4,32,2,3,32,,,,,7,7
2019-05-24 00:59,SZX,1728,737-800,27,4,33,4,5,27,,,,,6,0
2019-05-24 00:58,HGH,5502,737-800,28,4,26,4,4,28,,,,,-2,0
2019-05-24 00:57,HAK,1799,737-800,27,6,35,2,3,30,,,,,8,3
2019-05-24 00:56,XIY,5136,737-800,27,4,26,6,6,30,,,,,-1,3
2019-05-24 00:53,XIY,5359,737-800,26,4,25,5,5,25,,,,,-1,-1
2019-05-24 00:52,XIY,5180,737-800,25,6,34,7,6,30,,,,,9,5
2019-05-24 00:51,PEK,5638,737-800,27,7,26,4,5,27,,,,,-1,0
2019-05-24 00:46,TYN,1786,737-800,20,4,24,5,5,24,,,,,4,4
2019-05-24 00:42,CGO,7993,737-800,28,5,26,6,5,25,,,,,-2,-3
2019-05-24 00:41,HGH,5337,737-800,28,3,32,3,3,31,,,,,4,3
2019-05-24 00:36,XNN,5135,737-800,17,7,21,6,6,19,,,,,4,2
2019-05-24 00:35,URC,7377,737-800,17,6,26,5,6,25,,,,,9,8
2019-05-24 00:35,XNN,5135,737-800,17,7,19,6,6,21,,,,,2,4
2019-05-24 00:35,URC,5346,737-800,12,6,26,4,5,21,,,,,14,9
2019-05-24 00:35,XNN,1929,737-800,17,7,21,6,6,19,,,,,4,2
2019-05-24 00:30,URC,5623,737-800,15,6,27,6,6,24,,,,,12,9
2019-05-24 00:29,SZX,7619,737-800,25,5,29,6,5,30,,,,,4,5
2019-05-24 00:29,HAK,5089,737-800,28,4,29,3,3,30,,,,,1,2
2019-05-24 00:29,MIG,5407,737-800,20,4,28,4,4,29,,,,,8,9
2019-05-24 00:28,DLC,1787,737-800,18,1,30,5,6,30,,,,,12,12
2019-05-24 00:28,HRB,7395,737-800,17,5,25,4,5,24,,,,,8,7
2019-05-24 00:28,KHG,1569,737-800,20,3,22,4,3,23,,,,,2,3
2019-05-24 00:25,SZX,1372,737-800,27,6,36,4,4,34,,,,,9,7
2019-05-24 00:21,URC,1483,737-800,14,4,20,5,4,25,,,,,6,11
2019-05-24 00:20,HAK,5798,737-800,29,6,34,4,2,28,,,,,5,-1
2019-05-24 00:19,HAK,5662,737-800,26,5,34,5,5,34,,,,,8,8
2019-05-24 00:19,KMG,7988,737-800,21,5,28,5,4,26,,,,,7,5
2019-05-24 00:16,ZGC,1735,737-800,15,2,20,4,4,22,,,,,5,7
2019-05-24 00:15,URC,5797,737-800,15,5,18,5,4,20,,,,,3,5
2019-05-24 00:14,CGO,7992,737-800,27,6,28,6,6,26,,,,,1,-1
2019-05-24 00:12,CAN,7173,737-800,25,3,30,6,5,34,,,,,5,9
2019-05-24 00:12,XIY,5522,737-800,28,5,28,6,6,27,,,,,0,-1
2019-05-24 00:11,FOC,5430,737-800,23,6,34,6,6,34,1,1,,11,11,11
2019-05-24 00:11,FOC,5430,737-800,23,6,34,6,6,34,,,,,11,11
2019-05-24 00:06,XIY,5462,737-800,26,3,27,4,4,28,,,,,1,2
2019-05-24 00:05,XIY,5483,737-800,29,5,30,6,5,29,,,,,1,0
2019-05-24 00:04,MIG,5409,737-800,21,4,25,5,4,29,,,,,4,8
2019-05-24 00:01,,7171,737-800,26,5,30,5,4,30,,,,,4,4
2019-05-23 23:59,TYN,206G,737-800,24,3,23,4,3,24,,,,,-1,0
2019-05-23 23:58,HAK,1497,737-800,25,3,34,4,4,32,,,,,9,7
2019-05-23 23:56,HAK,5712,737-800,26,2,30,2,3,32,,,,,4,6
2019-05-23 23:54,SYX,5480,737-800,30,8,37,6,5,22,1,,,1,7,-8
2019-05-23 23:48,CGO,1498,737-800,28,4,27,4,4,26,,,,,-1,-2
2019-05-23 23:47,XIY,5636,737-800,23,4,27,6,5,30,,,,,4,7
2019-05-23 23:45,CAN,5418,737-800,26,8,30,4,4,32,,,,,4,6
2019-05-23 23:41,PEK,7379,737-800,28,4,32,3,3,33,,,,,4,5
2019-05-23 23:41,DLC,1797,737-800,19,3,24,2,2,24,,,,,5,5
2019-05-23 23:40,HHA,1491,737-800,24,5,28,5,5,29,,,,,4,5
2019-05-23 23:33,URC,1570,737-800,13,4,20,5,5,20,,,,,7,7
2019-05-23 23:32,HRB,1433,737-800,15,4,26,4,3,24,,,,,11,9
2019-05-23 23:23,HAK,1793,737-800,27,4,34,4,4,32,,,,,7,5
2019-05-23 23:22,CTU,6800,737-800,30,4,28,4,4,28,,,,,-2,-2
2019-05-23 23:21,MIG,1798,737-800,20,6,28,7,6,29,,,,,8,9
2019-05-23 23:11,HAK,1346,737-800,29,8,36,7,7,36,,,,,7,7
2019-05-23 23:07,URC,1322,737-800,15,4,27,4,4,26,,,,,12,11
2019-05-23 22:58,CAN,1928,737-800,28,6,26,8,8,30,,,,,-2,2
2019-05-23 22:53,SYX,1733,737-800,29,3,34,6,5,34,,,,,5,5
2019-05-23 22:51,HAK,5687,737-800,26,4,30,4,4,31,,,,,4,5
2019-05-23 22:46,TYN,1213,737-800,26,6,24,6,6,26,,,,,-2,0
2019-05-23 22:41,PEK,1101,737-800,30,2,36,8,8,35,,,,,6,5
2019-05-23 22:35,TYN,5090,737-800,28,3,24,3,5,26,,,,,-4,-2
2019-05-23 22:34,CKG,7618,737-800,25,5,30,6,4,29,,,,,5,4
2019-05-23 22:30,CAN,1727,737-800,26,5,32,6,5,30,,,,,6,4
2019-05-23 22:29,DLC,1489,737-800,20,2,21,2,2,22,,,,,1,2
2019-05-23 22:00,HAK,1386,737-800,25,3,34,3,3,32,,,,,9,7
2019-05-23 21:57,PEK,5852,737-800,33,4,30,5,5,30,,,,,-3,-3
2019-05-23 21:56,HAK,1215,737-800,28,3,33,4,4,34,,,,,5,6
2019-05-23 21:54,URC,205U,737-800,14,4,24,5,5,25,,,,,10,11
2019-05-23 21:51,HAK,5082,737-800,25,4,33,3,4,31,,,,,8,6
2019-05-23 21:48,HAK,1346,737-800,29,8,36,7,7,36,,,,,7,7
2019-05-23 20:38,XUZ,7989,737-800,30,4,34,6,6,32,,,,,4,2
2019-05-23 20:18,FOC,1562,737-800,25,5,30,6,6,32,,,,,5,7
2019-05-23 20:12,HAK,5083,737-800,30,4,29,6,5,35,,,,,-1,5
2019-05-23 20:07,HAK,206H,737-800,26,3,33,3,2,30,,,,,7,4
2019-05-23 20:04,FOC,5182,737-800,25,3,28,4,4,30,,,,,3,5
2019-05-23 19:59,URC,205V,737-800,13,4,30,2,5,22,,,,,17,9
2019-05-23 19:16,URC,206P,737-800,17,4,25,4,4,24,,,,,8,7
2019-05-23 17:56,XIY,1737,737-800,36,4,38,4,4,24,,,,,2,-12
2019-05-23 17:53,HHA,1347,737-800,34,4,34,4,3,30,,,,,0,-4
2019-05-23 17:51,KMG,1588,737-800,30,4,28,4,4,28,,,,,-2,-2
2019-05-23 17:35,YIH,1351,737-800,30,3,22,5,4,26,,,,,-8,-4
2019-05-23 17:04,URC,1323,737-800,18,2,26,2,2,20,,,,,8,2
2019-05-23 16:25,XIY,5138,737-800,35,4,28,5,4,29,,,,,-7,-6
2019-05-23 15:38,URC,205T,737-800,11,6,27,3,4,28,,,,,16,17
2019-05-23 14:03,HHA,1375,737-800,40,4,30,4,4,28,,,,,-10,-12
2019-05-23 12:14,CTU,6800,737-800,32,5,28,5,4,26,,,,,-4,-6
2019-05-23 08:53,ZGC,5439,737-800,20,8,22,6,8,20,,,,,2,0
2019-05-23 08:36,HAK,7173,737-800,27,6,36,6,5,33,,,,,9,6
2019-05-23 08:35,HAK,1493,737-800,26,4,26,4,5,21,,,,,0,-5
2019-05-23 08:23,HAK,5137,737-800,26,4,25,3,2,32,,,,,-1,6
2019-05-23 08:17,MIG,5407,737-800,25,4,28,4,5,25,,,,,3,0
2019-05-23 07:48,PEK,1375,737-800,25,5,26,6,4,26,,,,,1,1
2019-05-23 07:32,PEK,1785,737-800,25,0,30,8,8,30,,,,,5,5
2019-05-23 07:24,XMN,5581,737-800,25,5,28,4,4,30,,,,,3,5
2019-05-23 07:23,XMN,1795,737-800,25,8,20,2,3,20,,,,,-5,-5
2019-05-23 07:23,XMN,5638,737-800,25,6,24,6,7,20,,,,,-1,-5
2019-05-23 07:17,PEK,1997,737-800,24,5,28,4,4,24,,,,,4,0
2019-05-23 07:00,FOC,1350,737-800,22,3,29,3,3,26,,,,,7,4
2019-05-23 06:50,PEK,5538,737-800,26,3,32,3,3,30,,,,,6,4
2019-05-23 06:50,HAK,5483,737-800,25,5,30,6,4,32,,,,,5,7
2019-05-23 06:45,PEK,1103,737-800,24,4,23,5,4,27,,,,,-1,3
2019-05-23 06:22,PEK,5406,737-800,25,4,27,4,7,28,,,,,2,3
2019-05-23 05:57,URC,1323,737-800,28,4,26,18,20,16,,1,,1,-2,-12
2019-05-23 05:51,SYX,1130,737-800,30,2,34,2,2,32,,,,,4,2
2019-05-23 05:33,ZGC,5139,737-800,20,6,22,4,6,24,,,,,2,4
2019-05-23 05:04,XIY,1796,737-800,20,4,25,4,5,24,,,,,5,4
2019-05-23 04:51,PEK,5482,737-800,23,6,30,6,4,28,,,,,7,5
2019-05-23 04:47,FOC,7113,737-800,22,5,28,4,5,27,,,,,6,5
2019-05-23 04:46,XIY,5503,737-800,20,3,25,4,3,28,,,,,5,8
2019-05-23 04:46,HGH,6066,737-800,24,3,30,2,3,26,,,,,6,2
2019-05-23 04:44,HRB,1433,737-800,13,2,28,2,2,28,,,,,15,15
2019-05-23 04:40,HGH,1487,737-800,26,2,27,2,2,28,,,,,1,2
2019-05-23 04:39,HGH,6061,737-800,26,4,30,4,4,30,,,,,4,4
2019-05-23 04:31,KMG,5409,737-800,17,4,22,4,4,26,,,,,5,9
2019-05-23 04:29,URC,1570,737-800,10,4,22,4,4,22,,,,,12,12
2019-05-23 04:18,CGO,7990,737-800,30,2,28,2,3,27,,,,,-2,-3
2019-05-23 04:16,XIY,1163,737-800,22,2,30,2,1,24,,,,,8,2
2019-05-23 04:15,XIY,1545,737-800,22,4,30,6,6,26,,,,,8,4
2019-05-23 04:09,HAK,5540,737-800,26,6,36,6,6,30,1,,,1,10,4
2019-05-23 04:03,HAK,1215,737-800,28,4,32,4,4,34,,,,,4,6
2019-05-23 03:57,SZX,1541,737-800,27,6,35,6,6,36,,,,,8,9
2019-05-23 03:51,HHA,1347,737-800,23,3,30,4,3,28,,,,,7,5
2019-05-23 03:48,URC,205U,737-800,15,4,25,4,4,25,,,,,10,10
2019-05-23 03:48,XIY,1903,737-800,20,2,17,2,2,17,,,,,-3,-3
2019-05-23 03:47,URC,1570,737-800,10,4,22,4,4,22,,,,,12,12
2019-05-23 03:45,HAK,1131,737-800,26,4,35,4,4,34,,,,,9,8
2019-05-23 03:43,XIY,5359,737-800,25,4,22,5,5,22,,,,,-3,-3
2019-05-23 03:39,URC,6268,737-800,16,4,28,4,5,27,,,,,12,11
2019-05-23 03:35,URC,1568,737-800,15,6,30,6,6,27,,,,,15,12
2019-05-23 03:35,URC,5713,737-800,15,5,26,5,5,24,,,,,11,9
2019-05-23 03:35,URC,7377,737-800,15,6,26,6,7,26,,,,,11,11
2019-05-23 03:28,XIY,1348,737-800,18,4,28,4,4,28,,,,,10,10
2019-05-23 03:26,KMG,7167,737-800,20,4,24,5,5,24,,,,,4,4
2019-05-23 03:20,Ö£ÖÝ,7992,737-800,26,7,28,7,7,27,,,,,2,1
2019-05-23 03:18,SZX,1992,737-800,30,9,37,8,5,34,1,1,,11,7,4
2019-05-23 03:16,KMG,7988,737-800,20,4,26,4,4,26,,,,,6,6
2019-05-23 03:15,HAK,5371,737-800,25,6,28,5,5,30,,,,,3,5
2019-05-23 03:07,SYX,206F,737-800,30,4,34,3,2,30,,,,,4,0
2019-05-23 03:07,KMG,1209,737-800,15,4,30,3,3,27,,,,,15,12
2019-05-23 03:05,ZGC,5735,737-800,25,8,24,7,8,23,,,,,-1,-2
2019-05-23 03:05,URC,205T,737-800,19,4,28,3,4,30,,,,,9,11
2019-05-23 03:04,URC,5713,737-800,19,5,26,5,5,24,,,,,7,5
2019-05-23 03:04,HGH,1386,737-800,23,3,28,4,3,26,,,,,5,3
2019-05-23 03:04,HGH,1907,737-800,24,6,25,5,7,25,,,,,1,1
2019-05-23 03:03,SYX,1733,737-800,30,3,34,4,4,34,,,,,4,4
2019-05-23 02:59,KHG,206P,737-800,20,4,24,3,4,22,,,,,4,2
2019-05-23 02:58,URC,2157,737-800,18,4,24,8,4,26,,,,,6,8
2019-05-23 02:56,FOC,5182,737-800,21,4,30,4,4,28,,,,,9,7
2019-05-23 02:51,SYX,5480,737-800,28,8,36,4,6,20,,,,,8,-8
2019-05-23 02:51,URC,7379,737-800,19,4,30,4,4,30,,,,,11,11
2019-05-23 02:49,KMG,6016,737-800,15,4,28,3,3,28,,,,,13,13
2019-05-23 02:47,HHA,5429,737-800,22,3,29,3,3,30,,,,,7,8
2019-05-23 02:45,PEK,1928,737-800,23,6,24,5,6,25,,,,,1,2
2019-05-23 02:44,HHA,5852,737-800,22,5,26,5,5,24,,,,,4,2
2019-05-23 02:43,URC,5373,737-800,19,5,26,6,4,25,,,,,7,6
2019-05-23 02:39,URC,6063,737-800,19,6,30,8,9,32,,,,,11,13
2019-05-23 02:37,HHA,6062,737-800,21,4,28,3,3,28,,,,,7,7
2019-05-23 02:35,XIY,1903,737-800,20,2,17,2,2,18,,,,,-3,-2
2019-05-23 02:33,PEK,5661,737-800,26,4,25,4,4,27,,,,,-1,1
2019-05-23 02:27,FOC,1562,737-800,22,5,26,4,5,25,,,,,4,3
2019-05-23 02:25,FOC,5636,737-800,21,4,27,5,5,26,,,,,6,5
2019-05-23 02:20,HRB,7395,737-800,12,7,26,6,6,22,,,,,14,10
2019-05-23 02:16,URC,5620,737-800,15,2,28,2,4,25,,,,,13,10
2019-05-23 02:15,XIY,1481,737-800,23,6,28,6,6,26,,,,,5,3
2019-05-23 02:09,´óÁ¬,1141,737-800,20,6,26,4,4,26,,,,,6,6
2019-05-23 02:07,HAK,1372,737-800,27,7,36,5,5,34,,,,,9,7
2019-05-23 02:04,URC,5625,737-800,15,4,26,4,4,26,,,,,11,11
2019-05-23 01:56,HAK,1548,737-800,26,4,30,4,4,30,,,,,4,4
2019-05-23 01:54,SZX,1799,737-800,27,4,34,5,4,32,,,,,7,5
2019-05-23 01:50,DLC,6103,737-800,22,6,26,4,6,25,,,,,4,3
2019-05-23 01:49,HAK,5478,737-800,30,4,36,6,5,34,,,,,6,4
2019-05-23 01:48,HGH,1488,737-800,25,4,22,4,4,20,,,,,-3,-5
2019-05-23 01:47,HGH,5853,737-800,25,5,31,6,5,26,,,,,6,1
2019-05-23 01:46,XIY,1162,737-800,19,2,22,4,2,26,,,,,3,7
2019-05-23 01:46,TYN,5709,737-800,22,6,26,8,6,26,,,,,4,4
2019-05-23 01:45,XIY ,5338,737-800,18,6,25,7,7,24,,,,,7,6
2019-05-23 01:44,HAK,5712,737-800,25,4,32,6,5,30,,,,,7,5
2019-05-23 01:42,XIY,1902,737-800,25,5,28,6,6,24,,,,,3,-1
2019-05-23 01:38,CGO,7618,737-800,27,4,26,5,5,26,,,,,-1,-1
2019-05-23 01:36,HAK,1497,737-800,25,4,31,3,3,32,,,,,6,7
2019-05-23 01:35,SYX,5408,737-800,29,7,35,3,5,30,,,,,6,1
2019-05-23 01:34,SYX,5138,737-800,30,6,36,6,7,35,,,,,6,5
2019-05-23 01:33,103,5463,737-800,24,5,30,6,4,22,,,,,6,-2
2019-05-23 01:31,URC,5623,737-800,18,6,26,8,6,26,,,,,8,8
2019-05-23 01:30,SYX,7175,737-800,28,5,37,6,5,33,1,,,1,9,5
2019-05-23 01:28,HHA,6065,737-800,25,4,28,4,4,28,,,,,3,3
2019-05-23 01:25,FOC,1350,737-800,22,3,30,3,3,26,,,,,8,4
2019-05-23 01:24,HAK,5481,737-800,26,5,33,7,6,32,,,,,7,6
2019-05-23 01:22,MIG,5407,737-800,25,4,28,4,5,25,,,,,3,0
2019-05-23 01:22,HAK,5465,737-800,17,3,33,3,4,32,1,1,,11,16,15
2019-05-23 01:19,HHA,7172,737-800,25,6,28,5,4,28,,,,,3,3
2019-05-23 01:17,CGO,1587,737-800,27,3,27,6,4,26,,,,,0,-1
2019-05-23 01:17,XIY,5180,737-800,22,6,30,6,6,26,,,,,8,4
2019-05-23 01:13,TYN,6060,737-800,23,6,25,6,5,24,,,,,2,1
2019-05-23 01:11,KMG,5449,737-800,18,4,26,3,4,25,,,,,8,7
2019-05-23 01:09,XIY ,5115,737-800,24,3,21,4,4,24,,,,,-3,0
2019-05-23 01:06,XIY,1726,737-800,20,4,26,4,4,22,,,,,6,2
2019-05-23 01:04,CKG,1538,737-800,23,3,29,3,3,29,,,,,6,6
2019-05-23 01:04,À¥Ã÷,1208,737-800,20,5,25,4,3,23,,,,,5,3
2019-05-23 01:02,´óÁ¬,1490,737-800,20,6,26,6,4,22,,,,,6,2
2019-05-23 01:00,SZX,1729,737-800,30,6,36,4,4,36,,,,,6,6
2019-05-23 00:58,PEK,7398,737-800,23,2,23,3,4,24,,,,,0,1
2019-05-23 00:55,URC,1725,737-800,20,5,30,5,5,34,,1,,1,10,14
2019-05-23 00:53,TYN,7886,737-800,21,4,26,4,4,24,,,,,5,3
2019-05-23 00:53,DLC,1495,737-800,20,4,26,4,4,24,,,,,6,4
2019-05-23 00:50,HGH,5853,737-800,25,5,31,6,5,26,,,,,6,1
2019-05-23 00:49,HHA,1547,737-800,23,6,32,6,6,32,,,,,9,9
2019-05-23 00:46,SZX,7619,737-800,28,5,29,6,5,30,,,,,1,2
2019-05-23 00:44,CGO,1586,737-800,29,4,27,4,4,28,,,,,-2,-1
2019-05-23 00:41,CAN,5418,737-800,27,8,32,4,4,31,,,,,5,4
2019-05-23 00:40,104,5358,737-800,25,3,28,4,4,28,,,,,3,3
2019-05-23 00:39,PEK,5539,737-800,23,5,29,5,6,29,,,,,6,6
2019-05-23 00:31,URC,5346,737-800,18,6,26,8,6,26,,,,,8,8
2019-05-23 00:29,XIY,1996,737-800,22,4,20,5,5,27,,,,,-2,5
2019-05-23 00:29,XIY,1996,737-800,22,4,20,5,5,27,,,,,-2,5
2019-05-23 00:22,HAK,1588,737-800,26,2,28,4,4,33,,,,,2,7
2019-05-23 00:22,HAK,5153,737-800,25,3,37,4,4,34,1,,,1,12,9
2019-05-23 00:14,TYN,206G,737-800,25,4,26,4,4,24,,,,,1,-1
2019-05-23 00:14,PEK,1101,737-800,30,2,32,2,3,30,,,,,2,0
2019-05-23 00:12,CGO,7993,737-800,28,6,28,8,9,26,,,,,0,-2
2019-05-23 00:11,HGH,5479,737-800,25,5,29,7,6,30,,,,,4,5
2019-05-23 00:09,ÃàÑô,6809,737-800,24,6,26,6,6,26,,,,,2,2
2019-05-23 00:09,HRB,1905,737-800,12,3,24,4,3,19,,,,,12,7
2019-05-23 00:08,HAK,5083,737-800,25,4,27,4,5,32,,,,,2,7
2019-05-23 00:04,HAK,5375,737-800,27,2,34,4,4,28,,,,,7,1
2019-05-22 23:56,SZX,7400,737-800,27,6,36,7,7,36,,,,,9,9
2019-05-22 23:56,URC,5797,737-800,25,5,21,5,5,23,,,,,-4,-2
2019-05-22 23:54,HAK,1793,737-800,26,5,34,6,6,30,,,,,8,4
2019-05-22 23:53,TYN,1783,737-800,20,3,20,4,3,22,,,,,0,2
2019-05-22 23:51,HAK,1498,737-800,26,4,35,5,4,34,,,,,9,8
2019-05-22 23:47,URC,1322,737-800,20,2,18,4,4,14,,,,,-2,-6
2019-05-22 23:45,XIY,5462,737-800,26,4,24,5,5,25,,,,,-2,-1
2019-05-22 23:37,HAK,7399,737-800,26,4,32,4,4,30,,,,,6,4
2019-05-22 23:37,DLC,1102,737-800,20,3,26,4,4,26,,,,,6,6
2019-05-22 23:36,XIY,7639,737-800,20,4,28,6,4,26,,,,,8,6
2019-05-22 23:36,DLC,1489,737-800,22,4,26,4,4,25,,,,,4,3
2019-05-22 23:33,URC,2159,737-800,20,6,22,4,4,20,,,,,2,0
2019-05-22 23:26,´óÁ¬,1787,737-800,24,2,26,2,2,26,,,,,2,2
2019-05-22 23:24,XNN,7171,737-800,15,4,20,4,4,22,,,,,5,7
2019-05-22 23:24,XNN,5135,737-800,15,4,22,3,3,20,,,,,7,5
2019-05-22 23:23,HHA,5466,737-800,23,2,22,7,2,21,,,,,-1,-2
2019-05-22 23:19,TYN,1786,737-800,15,2,20,2,2,18,,,,,5,3
2019-05-22 23:18,HAK,5521,737-800,27,6,29,3,3,30,,,,,2,3
2019-05-22 23:04,CAN,5417,737-800,24,3,30,3,2,32,,,,,6,8
2019-05-22 23:03,HAK,5798,737-800,25,2,32,3,2,26,,,,,7,1
2019-05-22 22:59,DLC,7378,737-800,23,5,28,6,7,28,,,,,5,5
2019-05-22 22:49,SYX,5405,737-800,30,6,36,6,5,36,,,,,6,6
2019-05-22 22:49,HAK,7616,737-800,27,4,34,4,4,32,,,,,7,5
2019-05-22 22:48,KMG,7991,737-800,18,6,28,6,6,26,,,,,10,8
2019-05-22 22:48,DLC,1797,737-800,24,4,24,4,4,24,,,,,0,0
2019-05-22 22:45,ZGC,1727,737-800,20,6,21,7,6,23,,,,,1,3
2019-05-22 22:44,CKG,5416,737-800,24,6,26,6,6,26,,,,,2,2
2019-05-22 22:42,SYX,5480,737-800,31,9,36,4,3,19,,,,,5,-12
2019-05-22 22:40,SYX,5662,737-800,28,7,36,4,7,35,,,,,8,7
2019-05-22 22:37,URC,5467,737-800,28,2,28,6,6,26,,,,,0,-2
2019-05-22 22:23,URC,1569,737-800,25,4,24,3,2,26,,,,,-1,1
2019-05-22 22:17,HAK,5089,737-800,26,3,24,2,2,32,,,,,-2,6
2019-05-22 22:15,HAK,206H,737-800,27,6,34,3,4,32,,,,,7,5
2019-05-22 21:48,XIY,5733,737-800,25,4,24,6,6,24,,,,,-1,-1
2019-05-22 21:40,MIG,1798,737-800,25,6,29,6,6,25,,,,,4,0
2019-05-22 20:49,XIY,5136,737-800,33,4,24,6,6,28,,,,,-9,-5
2019-05-22 20:26,DLC,1491,737-800,23,5,27,5,6,28,,,,,4,5
2019-05-22 20:10,HGH,5337,737-800,27,4,30,4,4,30,,,,,3,3
2019-05-22 19:35,HRB,1559,737-800,18,3,27,3,3,23,,,,,9,5
2019-05-22 19:30,CGO,7990,737-800,30,2,28,2,3,27,,,,,-2,-3
2019-05-22 19:29,FOC,1480,737-800,20,4,26,5,4,26,,,,,6,6
2019-05-22 19:24,URC,7198,737-800,25,4,28,5,6,27,,,,,3,2
2019-05-22 19:15,HAK,1929,737-800,30,5,35,3,3,32,,,,,5,2
2019-05-22 19:11,HHA,5428,737-800,27,5,31,4,5,30,,,,,4,3
2019-05-22 17:48,FOC,1351,737-800,25,6,25,4,4,28,,,,,0,3
2019-05-22 17:48,XUZ,7989,737-800,32,4,30,4,4,30,,,,,-2,-2
2019-05-22 16:27,SZX,1995,737-800,30,6,32,6,6,33,,,,,2,3
2019-05-22 16:17,HAK,5687,737-800,32,4,30,4,5,32,,,,,-2,0
2019-05-22 15:19,HAK,1213,737-800,35,6,34,6,6,35,,,,,-1,0
2019-05-22 14:35,YIH,7105,737-800,33,4,30,5,4,29,,,,,-3,-4
2019-05-22 13:37,DLC,7379,737-800,28,4,28,5,4,30,,,,,0,2
2019-05-22 12:03,MIG,6015,737-800,25,4,28,3,4,26,,,,,3,1
2019-05-22 11:11,URC,7198,737-800,22,4,27,4,4,28,,,,,5,6
2019-05-22 09:23,HAK,5138,737-800,30,4,34,3,2,34,,,,,4,4
2019-05-22 09:17,KMG,5449,737-800,20,4,28,5,5,27,,,,,8,7
2019-05-22 09:05,SYX,5408,737-800,30,6,33,5,4,32,,,,,3,2
2019-05-22 08:33,HAK,5089,737-800,25,4,26,2,2,32,,,,,1,7
2019-05-22 08:11,PEK,5153,737-800,25,4,24,4,4,28,,,,,-1,3
2019-05-22 07:57,XMN,5735,737-800,24,2,30,3,2,29,,,,,6,5
2019-05-22 07:57,XMN,5581,737-800,23,3,21,3,4,30,,,,,-2,7
2019-05-22 07:56,XMN,5638,737-800,24,5,30,4,4,30,,,,,6,6
2019-05-22 07:56,XMN,5358,737-800,20,6,27,5,4,29,,,,,7,9
2019-05-22 07:38,XIY,7639,737-800,19,6,28,6,6,26,,,,,9,7
2019-05-22 07:30,PEK ,5661,737-800,25,3,22,3,4,23,,,,,-3,-2
2019-05-22 06:59,XNN,7171,737-800,17,6,17,5,5,19,,,,,0,2
2019-05-22 06:58,XNN,5135,737-800,14,9,19,8,8,21,,,,,5,7
2019-05-22 06:50,PEK,1492,737-800,20,4,26,4,4,26,,,,,6,6
2019-05-22 06:49,PEK,1492,737-800,20,4,26,4,4,26,,,,,6,6
2019-05-22 06:46,ZGC,1795,737-800,20,8,24,6,5,22,,,,,4,2
2019-05-22 06:45,ZGC,5709,737-800,15,6,24,8,6,24,,,,,9,9
2019-05-22 06:44,ZGC,7175,737-800,15,5,22,5,6,21,,,,,7,6
2019-05-22 06:42,ZGC,1727,737-800,15,5,21,6,5,20,,,,,6,5
2019-05-22 06:01,FOC,1480,737-800,22,4,25,4,4,26,,,,,3,4
2019-05-22 06:00,FOC,1480,737-800,22,4,26,4,4,27,,,,,4,5
2019-05-22 05:59,KMG,6809,737-800,15,5,21,6,6,24,,,,,6,9
2019-05-22 05:54,XIY,1348,737-800,25,4,30,4,4,28,,,,,5,3
2019-05-22 05:52,PEK,1928,737-800,18,5,20,6,6,22,,,,,2,4
2019-05-22 05:39,XIY,1162,737-800,20,3,29,3,3,28,,,,,9,8
2019-05-22 05:39,XIY,1903,737-800,20,2,27,2,2,28,,,,,7,8
2019-05-22 05:34,PEK,5538,737-800,17,2,30,2,2,30,,,,,13,13
2019-05-22 05:06,XIY,5798,737-800,25,2,22,4,3,22,,,,,-3,-3
2019-05-22 05:04,XIY,5116,737-800,22,4,22,4,4,22,,,,,0,0
2019-05-22 04:54,XIY,5359,737-800,27,3,21,2,2,23,,,,,-6,-4
2019-05-22 04:53,FOC ,1433,737-800,23,4,28,4,5,27,,,,,5,4
2019-05-22 04:41,URC,5797,737-800,20,4,22,3,5,24,,,,,2,4
2019-05-22 04:30,KMG,7167,737-800,18,5,27,6,5,24,,,,,9,6
2019-05-22 04:24,HAK,6062,737-800,26,4,34,4,3,34,,,,,8,8
2019-05-22 04:24,SZX,1541,737-800,25,6,32,5,5,33,,,,,7,8
2019-05-22 04:14,URC,1491,737-800,24,4,28,5,5,27,,,,,4,3
2019-05-22 04:12,SYX,206F,737-800,28,4,32,3,3,30,,,,,4,2
2019-05-22 04:09,URC,1568,737-800,23,6,26,6,6,24,,,,,3,1
2019-05-22 04:06,XIY,1163,737-800,22,5,29,4,3,28,,,,,7,6
2019-05-22 04:03,DLC,6060,737-800,19,4,26,6,5,25,,,,,7,6
2019-05-22 04:03,URC,5346,737-800,27,5,26,6,6,24,,,,,-1,-3
2019-05-22 03:58,URC,1725,737-800,24,3,23,3,4,22,,,,,-1,-2
2019-05-22 03:58,KMG,1588,737-800,17,4,25,4,4,24,,,,,8,7
2019-05-22 03:57,HAK,1549,737-800,30,4,30,5,5,30,,,,,0,0
2019-05-22 03:52,HAK,1503,737-800,25,1,20,4,2,22,,,,,-5,-3
2019-05-22 03:52,CGO,6016,737-800,23,3,26,3,2,28,,,,,3,5
2019-05-22 03:51,SYX,1733,737-800,30,3,32,3,3,30,,,,,2,0
2019-05-22 03:49,DLC,1489,737-800,18,4,26,4,4,23,,,,,8,5
2019-05-22 03:43,HGH,1786,737-800,24,4,27,5,4,23,,,,,3,-1
2019-05-22 03:41,DLC,5463,737-800,19,5,26,4,5,22,,,,,7,3
2019-05-22 03:36,SHA,1346,737-800,21,5,30,4,5,28,,,,,9,7
2019-05-22 03:36,DLC,6103,737-800,20,5,26,4,4,24,,,,,6,4
2019-05-22 03:33,CKG,1538,737-800,17,2,24,3,2,24,,,,,7,7
2019-05-22 03:32,HAK,1505,737-800,27,6,37,4,4,31,,,,,10,4
2019-05-22 03:30,SHA,5467,737-800,23,5,31,5,2,24,,,,,8,1
2019-05-22 03:28,XIY,5579,737-800,20,6,30,6,6,28,,,,,10,8
2019-05-22 03:23,CGO,5481,737-800,25,5,27,7,6,26,,,,,2,1
2019-05-22 03:20,SYX,5405,737-800,29,6,37,7,6,36,,,,,8,7
2019-05-22 03:19,XMN,5735,737-800,23,2,30,3,2,29,,,,,7,6
2019-05-22 03:19,URC,5373,737-800,25,6,22,6,6,29,,,,,-3,4
2019-05-22 03:19,XMN,5581,737-800,23,3,26,3,4,30,,,,,3,7
2019-05-22 03:18,HAK,1375,737-800,25,3,30,4,4,27,,,,,5,2
2019-05-22 03:18,URC,1323,737-800,29,3,24,5,4,30,,,,,-5,1
2019-05-22 03:18,URC,5625,737-800,25,6,20,4,4,24,,,,,-5,-1
2019-05-22 03:18,URC,1568,737-800,23,6,20,6,6,24,,,,,-3,1
2019-05-22 03:15,DLC,1490,737-800,20,4,26,4,4,22,,,,,6,2
2019-05-22 03:14,URC,5853,737-800,27,6,26,6,6,22,,,,,-1,-5
2019-05-22 03:14,URC,5713,737-800,25,6,20,6,6,24,,,,,-5,-1
2019-05-22 03:13,YIH,7105,737-800,22,4,29,5,4,28,,,,,7,6
2019-05-22 03:10,KMG,7989,737-800,19,6,28,5,4,26,,,,,9,7
2019-05-22 03:09,SZX,1995,737-800,25,6,36,6,6,30,1,,,1,11,5
2019-05-22 03:07,XMN,5638,737-800,24,5,30,4,4,30,,,,,6,6
2019-05-22 03:05,KMG,5409,737-800,20,4,22,4,4,24,,,,,2,4
2019-05-22 03:05,URC,5623,737-800,24,5,27,6,6,24,,,,,3,0
2019-05-22 03:03,º¼ÖÝ,1498,737-800,25,4,19,3,4,20,,,,,-6,-5
2019-05-22 02:56,CAN,5417,737-800,27,5,30,5,5,32,,,,,3,5
2019-05-22 02:54,HAK,5637,737-800,25,2,35,3,2,33,1,,,1,10,8
2019-05-22 02:49,URC,6995,737-800,23,4,27,5,4,26,,,,,4,3
2019-05-22 02:46,URC,1785,737-800,25,6,26,6,6,27,,,,,1,2
2019-05-22 02:46,SYX,1493,737-800,28,4,30,4,4,28,,,,,2,0
2019-05-22 02:45,XIY,1902,737-800,20,6,28,6,6,24,,,,,8,4
2019-05-22 02:43,SZX,5712,737-800,24,2,30,7,2,30,,,,,6,6
2019-05-22 02:42,KMG,1208,737-800,15,3,25,4,4,23,,,,,10,8
2019-05-22 02:40,XIY,5338,737-800,25,3,24,3,4,27,,,,,-1,2
2019-05-22 02:33,HAK,5620,737-800,25,3,34,4,5,30,,,,,9,5
2019-05-22 02:26,SZX,5465,737-800,25,2,28,4,4,32,,,,,3,7
2019-05-22 02:25,FOC,5483,737-800,22,4,32,4,4,28,,,,,10,6
2019-05-22 02:24,HGH,7377,737-800,24,6,28,6,6,28,,,,,4,4
2019-05-22 02:23,XIY,1482,737-800,25,6,28,6,6,24,,,,,3,-1
2019-05-22 02:22,HHA,1347,737-800,19,3,29,3,3,27,,,,,10,8
2019-05-22 02:22,HAK,5521,737-800,30,2,29,4,4,25,,,,,-1,-5
2019-05-22 02:22,XIY,5503,737-800,25,4,24,4,4,26,,,,,-1,1
2019-05-22 02:22,HAK,5137,737-800,30,4,30,4,5,32,,,,,0,2
2019-05-22 02:21,SZX,1728,737-800,24,4,31,5,5,32,,,,,7,8
2019-05-22 02:21,HAK,1783,737-800,30,6,22,4,3,24,,,,,-8,-6
2019-05-22 02:20,SZX,1728,737-800,24,4,31,5,5,32,,,,,7,8
2019-05-22 02:14,URC,6268,737-800,28,2,28,4,4,28,,,,,0,0
2019-05-22 02:13,FOC,5182,737-800,20,4,26,4,4,27,,,,,6,7
2019-05-22 02:10,HAK,5478,737-800,25,6,35,3,2,32,,,,,10,7
2019-05-22 02:06,TYN,1102,737-800,14,4,23,4,4,24,,,,,9,10
2019-05-22 02:04,TYN,5139,737-800,15,4,22,5,5,24,,,,,7,9
2019-05-22 02:00,CAN,5662,737-800,26,7,36,6,5,36,,,,,10,10
2019-05-22 01:55,¹ãÖÝ,1497,737-800,30,4,32,4,4,33,,,,,2,3
2019-05-22 01:52,CGO,7992,737-800,24,6,27,6,6,27,,,,,3,3
2019-05-22 01:50,CGO,1586,737-800,23,4,28,4,4,29,,,,,5,6
2019-05-22 01:47,XIY,1481,737-800,23,5,29,5,4,26,,,,,6,3
2019-05-22 01:39,HHA,1547,737-800,21,6,30,6,6,30,,,,,9,9
2019-05-22 01:38,CAN,6808,737-800,25,3,36,3,2,35,1,1,,11,11,10
2019-05-22 01:34,HHA,5852,737-800,25,4,28,4,4,24,,,,,3,-1
2019-05-22 01:33,HHA,5428,737-800,21,4,30,6,4,31,,,,,9,10
2019-05-22 01:33,HAK,5406,737-800,25,4,33,7,4,30,,,,,8,5
2019-05-22 01:30,HGH,7173,737-800,25,4,31,5,5,28,,,,,6,3
2019-05-22 01:28,CAN,5855,737-800,26,6,30,7,7,29,,,,,4,3
2019-05-22 01:27,URC,205V,737-800,20,1,26,2,4,24,,,,,6,4
2019-05-22 01:26,CKG,5416,737-800,22,7,26,8,8,28,,,,,4,6
2019-05-22 01:22,FOC,1350,737-800,25,3,30,3,4,32,,,,,5,7
2019-05-22 01:22,SZX,1729,737-800,23,5,30,3,4,30,,,,,7,7
2019-05-22 01:18,MIG,5407,737-800,25,6,25,4,5,26,,,,,0,1
2019-05-22 01:17,ÃàÑô,5732,737-800,21,3,28,3,4,27,,,,,7,6
2019-05-22 01:16,SYX,7816,737-800,28,6,33,6,6,32,,,,,5,4
2019-05-22 01:16,PEK,1130,737-800,24,3,30,3,3,27,,,,,6,3
2019-05-22 01:16,PEK,5661,737-800,27,4,25,4,4,24,,,,,-2,-3
2019-05-22 01:13,CAN,5502,737-800,25,5,30,6,5,32,,,,,5,7
2019-05-22 01:12,º£¿Ú,7619,737-800,25,5,30,6,5,24,,,,,5,-1
2019-05-22 01:07,HGH,1386,737-800,25,3,26,3,3,26,,,,,1,1
2019-05-22 01:05,FOC,7113,737-800,21,5,28,5,5,27,,,,,7,6
2019-05-22 01:02,HAK,1929,737-800,25,4,34,2,2,30,,,,,9,5
2019-05-22 00:58,SZX,1373,737-800,23,4,30,4,4,28,,,,,7,5
2019-05-22 00:57,HRB,1559,737-800,12,4,24,4,3,25,,,,,12,13
2019-05-22 00:55,CGO,1587,737-800,22,3,28,5,3,26,,,,,6,4
2019-05-22 00:54,SZX,1799,737-800,23,4,34,4,4,30,,,,,11,7
2019-05-22 00:53,TYN,5090,737-800,18,1,25,1,2,21,,,,,7,3
2019-05-22 00:53,DLC,1545,737-800,20,5,25,5,4,26,,,,,5,6
2019-05-22 00:52,XIY,1927,737-800,25,3,22,6,4,24,,,,,-3,-1
2019-05-22 00:52,DLC,1545,737-800,20,5,25,5,4,26,,,,,5,6
2019-05-22 00:51,XIY,5180,737-800,20,6,30,6,6,28,,,,,10,8
2019-05-22 00:51,XIY,5115,737-800,22,4,18,5,5,25,,,,,-4,3
2019-05-22 00:48,HGH,6061,737-800,24,4,28,5,4,28,,,,,4,4
2019-05-22 00:47,CAN,1131,737-800,26,4,33,3,4,34,,,,,7,8
2019-05-22 00:42,KHG,1569,737-800,20,2,18,3,3,24,,,,,-2,4
2019-05-22 00:41,NKG,5480,737-800,20,5,27,3,5,22,,,,,7,2
2019-05-22 00:40,HAK,5418,737-800,24,7,30,5,4,32,,,,,6,8
2019-05-22 00:39,YIH,1906,737-800,23,7,29,8,8,29,,,,,6,6
2019-05-22 00:39,YIH,1435,737-800,22,6,27,5,6,28,,,,,5,6
2019-05-22 00:34,DLC,1797,737-800,22,3,23,4,4,23,,,,,1,1
2019-05-22 00:34,URC,1322,737-800,26,4,26,4,4,26,,,,,0,0
2019-05-22 00:32,FOC,5430,737-800,24,6,30,6,6,30,,,,,6,6
2019-05-22 00:28,PEK,7398,737-800,25,4,27,4,4,26,,,,,2,1
2019-05-22 00:20,PEK,5540,737-800,25,6,32,6,5,28,,,,,7,3
2019-05-22 00:13,KMG,7991,737-800,15,6,24,6,6,22,,,,,9,7
2019-05-22 00:13,XIY,5733,737-800,15,5,18,6,6,20,,,,,3,5
2019-05-22 00:09,HAK,1793,737-800,25,4,34,4,5,30,,,,,9,5
2019-05-22 00:03,HAK,1488,737-800,27,6,34,7,6,30,,,,,7,3
2019-05-22 00:02,URC,1735,737-800,28,4,24,4,4,22,,,,,-4,-6
2019-05-21 23:58,XIY,1796,737-800,21,4,26,6,6,30,,,,,5,9
2019-05-21 23:58,SYX,7886,737-800,29,4,34,4,4,34,,,,,5,5
2019-05-21 23:56,URC,1325,737-800,28,3,20,4,4,22,,,,,-8,-6
2019-05-21 23:50,XMN,5358,737-800,20,6,27,5,4,29,,,,,7,9
2019-05-21 23:46,MIG,1798,737-800,25,6,27,5,6,26,,,,,2,1
2019-05-21 23:45,HAK,1213,737-800,25,6,37,7,6,38,,,,,12,13
2019-05-21 23:45,XIY,5686,737-800,20,4,26,4,4,24,,,,,6,4
2019-05-21 23:45,MIG,1798,737-800,25,0,0,0,0,0,,,,,-25,-25
2019-05-21 23:35,CAN,5611,737-800,26,6,35,7,7,32,,,,,9,6
2019-05-21 23:32,URC,2159,737-800,26,6,20,4,2,25,,,,,-6,-1
2019-05-21 23:29,CGO,206P,737-800,25,4,24,4,4,24,,,,,-1,-1
2019-05-21 23:29,CAN,5611,737-800,26,6,35,7,7,32,,,,,9,6
2019-05-21 23:23,HAK,1548,737-800,25,4,30,5,4,28,,,,,5,3
2019-05-21 23:22,HAK,1213,737-800,25,34,6,7,6,33,,,,,-19,8
2019-05-21 23:20,HRB,1905,737-800,13,2,22,3,3,20,,,,,9,7
2019-05-21 23:19,HRB,7395,737-800,14,5,22,5,5,20,,,,,8,6
2019-05-21 23:17,CAN,1372,737-800,25,5,35,5,4,33,,,,,10,8
2019-05-21 23:14,HAK,5520,737-800,25,4,36,6,5,33,,,,,11,8
2019-05-21 23:13,HRB,1562,737-800,11,4,20,5,4,19,,,,,9,8
2019-05-21 23:10,CTU,6800,737-800,23,4,26,5,4,24,,,,,3,1
2019-05-21 23:08,HAK,5687,737-800,25,4,32,4,4,32,,,,,7,7
2019-05-21 23:01,CAN,5580,737-800,26,6,32,6,6,36,,,,,6,10
2019-05-21 22:44,CAN,5462,737-800,29,4,33,4,4,33,,,,,4,4
2019-05-21 22:37,HAK,7399,737-800,25,5,30,4,6,20,,,,,5,-5
2019-05-21 22:30,SYX,5522,737-800,28,6,34,8,8,34,,,,,6,6
2019-05-21 22:28,HAK,206G,737-800,25,3,36,4,4,32,1,,,1,11,7
2019-05-21 22:21,HHA,5429,737-800,24,3,26,3,3,28,,,,,2,4
2019-05-21 22:19,ÃàÑô,6015,737-800,23,4,24,3,3,25,,,,,1,2
2019-05-21 22:09,HGH,1101,737-800,25,3,33,2,2,30,,,,,8,5
2019-05-21 22:08,TYN,1215,737-800,23,6,24,4,4,21,,,,,1,-2
2019-05-21 22:01,URC,1570,737-800,25,6,18,6,6,22,,,,,-7,-3
2019-05-21 21:57,URC,205T,737-800,29,2,26,4,4,28,,,,,-3,-1
2019-05-21 21:53,XIY,1996,737-800,25,5,22,6,5,26,,,,,-3,1
2019-05-21 21:52,HAK,206H,737-800,25,3,34,3,3,31,,,,,9,6
2019-05-21 21:47,FOC,1351,737-800,20,8,30,6,6,28,,,,,10,8
2019-05-21 21:39,DLC,7378,737-800,20,5,26,5,6,26,,,,,6,6
2019-05-21 21:33,DLC,1787,737-800,22,4,22,3,2,24,,,,,0,2
2019-05-21 21:19,XUZ,7988,737-800,23,4,24,8,8,20,,,,,1,-3
2019-05-21 20:39,W113,1103,737-800,26,3,31,5,4,28,,,,,5,2
2019-05-21 20:19,KMG,7990,737-800,25,3,22,3,3,23,,,,,-3,-2
2019-05-21 20:17,HAK,5375,737-800,26,3,34,6,7,32,,,,,8,6
2019-05-21 19:52,URC,205U,737-800,33,4,26,5,4,27,,,,,-7,-6
2019-05-21 19:21,FOC,7113,737-800,22,5,30,6,5,27,,,,,8,5
2019-05-21 18:19,TYN,1495,737-800,33,4,14,4,4,20,,,,,-19,-13
2019-05-21 18:14,Î÷°²,5338,737-800,31,3,24,3,4,27,,,,,-7,-4
2019-05-21 14:20,HAK,7616,737-800,32,4,32,4,4,32,,,,,0,0
2019-05-21 13:54,HAK,5082,737-800,36,6,36,7,6,36,,,,,0,0
2019-05-21 13:28,PEK,7398,737-800,30,4,26,6,4,27,,,,,-4,-3
2019-05-21 13:06,CTU,6800,737-800,25,4,26,5,4,25,,,,,1,0
2019-05-21 11:49,À¥Ã÷,6809,737-800,30,6,24,5,6,23,,,,,-6,-7
2019-05-21 09:13,XMN,1727,737-800,23,6,30,8,6,30,,,,,7,7
2019-05-21 09:12,XMN,5358,737-800,22,6,30,6,6,32,,,,,8,10
2019-05-21 09:11,XMN,5540,737-800,20,8,35,7,3,21,,,,,15,1
2019-05-21 09:09,XMN,5467,737-800,20,3,32,1,1,20,,,,,12,0
2019-05-21 08:30,KMG,1209,737-800,20,4,24,3,3,24,,,,,4,4
2019-05-21 08:19,KMG,7993,737-800,19,5,22,5,7,24,,,,,3,5
2019-05-21 07:51,CGO,5416,737-800,22,5,22,6,6,20,,,,,0,-2
2019-05-21 07:22,HAK,1213,737-800,28,7,36,7,6,36,,,,,8,8
2019-05-21 07:20,PEK,1346,737-800,21,5,25,5,6,25,,,,,4,4
2019-05-21 07:19,HAK,5709,737-800,29,9,36,8,9,36,,,,,7,7
2019-05-21 07:19,HAK,5521,737-800,30,5,35,7,6,34,,,,,5,4
2019-05-21 06:52,FOC,1348,737-800,23,4,27,4,5,28,,,,,4,5
2019-05-21 06:07,KMG,5407,737-800,16,4,24,2,2,19,,,,,8,3
2019-05-21 06:04,PEK,5538,737-800,18,6,35,4,4,28,1,,,1,17,10
2019-05-21 05:58,XIY,1163,737-800,17,2,20,3,3,22,,,,,3,5
2019-05-21 05:55,XIY,1162,737-800,18,4,30,3,3,24,,,,,12,6
2019-05-21 05:54,XIY,1480,737-800,19,4,20,5,5,22,,,,,1,3
2019-05-21 05:49,CAN,5502,737-800,26,3,26,4,4,29,,,,,0,3
2019-05-21 05:46,SZX,7400,737-800,25,4,32,4,5,31,,,,,7,6
2019-05-21 05:39,SYX ,5463,737-800,30,4,32,6,6,32,,,,,2,2
2019-05-21 05:38,KMG,5409,737-800,20,4,22,4,5,23,,,,,2,3
2019-05-21 05:37,PEK,5371,737-800,20,4,22,6,6,24,,,,,2,4
2019-05-21 05:08,URC,1322,737-800,20,7,28,4,4,26,,,,,8,6
2019-05-21 04:58,URC,1568,737-800,22,6,24,5,6,24,,,,,2,2
2019-05-21 04:57,URC,1785,737-800,20,4,25,5,6,24,,,,,5,4
2019-05-21 04:55,FOC,1351,737-800,21,4,30,4,5,26,,,,,9,5
2019-05-21 04:51,HHA,5428,737-800,22,4,25,4,4,26,,,,,3,4
2019-05-21 04:49,URC,5853,737-800,20,5,26,6,6,24,,,,,6,4
2019-05-21 04:49,URC,1323,737-800,22,4,26,3,3,22,,,,,4,0
2019-05-21 04:48,XIY,1903,737-800,11,2,24,2,2,26,,,,,13,15
2019-05-21 04:43,FOC,5480,737-800,22,2,28,4,2,22,,,,,6,0
2019-05-21 04:42,XIY,7639,737-800,16,6,28,6,6,24,,,,,12,8
2019-05-21 04:41,URC,5625,737-800,24,4,26,4,5,24,,,,,2,0
2019-05-21 04:34,SYX,1928,737-800,30,4,34,4,6,35,,,,,4,5
2019-05-21 04:32,FOC,5182,737-800,21,3,28,3,3,26,,,,,7,5
2019-05-21 04:18,HAK,5466,737-800,32,0,21,9,6,28,,,,,-11,-4
2019-05-21 04:11,XIY,7105,737-800,11,3,24,3,3,23,,,,,13,12
2019-05-21 04:10,XIY,5373,737-800,20,6,22,6,6,24,,,,,2,4
2019-05-21 04:09,HAK,5135,737-800,30,6,36,6,6,36,,,,,6,6
2019-05-21 04:06,PEK,5408,737-800,18,5,23,4,4,20,,,,,5,2
2019-05-21 04:06,HHA,7172,737-800,23,5,25,5,4,27,,,,,2,4
2019-05-21 03:55,CAN,1372,737-800,26,5,33,4,4,34,,,,,7,8
2019-05-21 03:49,XIY,5359,737-800,19,5,24,4,4,22,,,,,5,3
2019-05-21 03:45,HAK,1488,737-800,28,6,36,6,6,30,,,,,8,2
2019-05-21 03:45,SYX,5522,737-800,30,7,31,6,5,34,,,,,1,4
2019-05-21 03:44,DLC,6060,737-800,19,5,26,4,5,25,,,,,7,6
2019-05-21 03:42,XIY,7171,737-800,14,4,22,3,3,24,,,,,8,10
2019-05-21 03:40,HGH,5687,737-800,20,4,20,4,4,24,,,,,0,4
2019-05-21 03:37,HAK,5375,737-800,28,8,36,8,7,36,,,,,8,8
2019-05-21 03:34,HAK,7619,737-800,30,6,33,6,6,32,,,,,3,2
2019-05-21 03:31,HAK,5662,737-800,28,4,35,6,6,36,,,,,7,8
2019-05-21 03:31,ZGC,7175,737-800,10,5,24,4,4,20,,,,,14,10
2019-05-21 03:30,ZGC,5638,737-800,10,4,22,6,5,22,,,,,12,12
2019-05-21 03:29,ZGC,6062,737-800,10,4,16,8,9,22,,,,,6,12
2019-05-21 03:26,HGH,6061,737-800,21,4,25,5,5,26,,,,,4,5
2019-05-21 03:24,HGH,1786,737-800,20,4,26,4,4,25,,,,,6,5
2019-05-21 03:24,HGH,5687,737-800,20,4,20,4,4,24,,,,,0,4
2019-05-21 03:23,XIY,5712,737-800,20,2,20,8,3,24,,,,,0,4
2019-05-21 03:14,XIY,6103,737-800,20,6,26,6,6,26,,,,,6,6
2019-05-21 03:13,XIY,5116,737-800,18,4,22,4,4,22,,,,,4,4
2019-05-21 03:13,XIY,1161,737-800,17,5,24,4,5,24,,,,,7,7
2019-05-21 03:11,URC,7198,737-800,20,4,24,5,4,24,,,,,4,4
2019-05-21 03:09,HGH,1545,737-800,19,4,29,5,5,27,,,,,10,8
2019-05-21 03:08,HAK,1996,737-800,28,6,35,5,4,34,,,,,7,6
2019-05-21 03:04,TYN ,5090 ,737-800,15,2,22,2,2,22,,,,,7,7
2019-05-21 03:04,HAK,7377,737-800,28,7,37,6,6,36,1,,,1,9,8
2019-05-21 03:00,SYX,1498,737-800,30,6,36,5,5,35,,,,,6,5
2019-05-21 03:00,HRB,1559,737-800,16,4,22,3,2,26,,,,,6,10
2019-05-21 02:59,CAN,5462,737-800,28,4,30,4,4,32,,,,,2,4
2019-05-21 02:57,PEK,5539,737-800,20,5,26,4,4,26,,,,,6,6
2019-05-21 02:48,PEK,5153,737-800,22,4,26,4,4,30,,,,,4,8
2019-05-21 02:47,MIG,6015,737-800,20,4,30,4,4,25,,,,,10,5
2019-05-21 02:45,HAK,1793,737-800,30,4,36,4,4,36,,,,,6,6
2019-05-21 02:45,HRB,1562,737-800,5,5,28,4,3,21,,,,,23,16
2019-05-21 02:45,FOC,7113,737-800,23,4,27,4,5,28,,,,,4,5
2019-05-21 02:45,KMG,1588,737-800,20,4,25,4,4,24,,,,,5,4
2019-05-21 02:44,HAK,1131,737-800,28,5,36,5,4,37,,1,,1,8,9
2019-05-21 02:43,HHA,1542,737-800,22,4,24,4,4,22,,,,,2,0
2019-05-21 02:43,PEK,5482,737-800,21,1,25,5,5,25,,,,,4,4
2019-05-21 02:42,TYN,1493,737-800,19,8,24,6,6,20,,,,,5,1
2019-05-21 02:41,HAK,1503,737-800,29,3,36,4,4,34,,,,,7,5
2019-05-21 02:41,DLC,1787,737-800,20,2,26,1,2,26,,,,,6,6
2019-05-21 02:39,URC,5797,737-800,19,5,24,6,7,24,,,,,5,5
2019-05-21 02:38,HAK,1373,737-800,28,4,36,4,4,32,,,,,8,4
2019-05-21 02:37,YIH,1350,737-800,21,4,29,4,4,26,,,,,8,5
2019-05-21 02:35,URC,6268,737-800,20,3,25,3,3,24,,,,,5,4
2019-05-21 02:34,CAN,1783,737-800,27,4,28,5,4,32,,,,,1,5
2019-05-21 02:32,DLC,1787,737-800,15,2,16,3,2,24,,,,,1,9
2019-05-21 02:29,PEK,1505,737-800,18,3,24,3,3,23,,,,,6,5
2019-05-21 02:29,KMG,7988,737-800,20,5,27,5,4,26,,,,,7,6
2019-05-21 02:26,SZX,1995,737-800,26,6,30,6,6,32,,,,,4,6
2019-05-21 02:25,URC,1570,737-800,20,6,22,5,5,20,,,,,2,0
2019-05-21 02:24,CGO,1586,737-800,21,3,26,6,5,27,,,,,5,6
2019-05-21 02:22,XI?Y,5180,737-800,20,5,28,4,4,24,,,,,8,4
2019-05-21 02:20,URC,5636,737-800,23,4,25,5,4,25,,,,,2,2
2019-05-21 02:20,URC,5636,737-800,23,4,25,5,4,25,,,,,2,2
2019-05-21 02:19,DLC,1489,737-800,18,4,25,5,5,25,,,,,7,7
2019-05-21 02:15,DLC,7379,737-800,19,3,26,4,3,25,,,,,7,6
2019-05-21 02:14,XIY,5798,737-800,20,2,20,2,2,20,,,,,0,0
2019-05-21 02:12,SYX,206F,737-800,30,2,37,3,4,33,1,,,1,7,3
2019-05-21 02:05,URC,6995,737-800,20,4,26,6,7,25,,,,,6,5
2019-05-21 02:04,DLC,1141,737-800,19,6,30,6,6,28,,,,,11,9
2019-05-21 02:03,HAK,1929,737-800,30,4,36,4,3,32,,,,,6,2
2019-05-21 02:03,SZX,1799,737-800,27,4,34,5,4,30,,,,,7,3
2019-05-21 02:00,SZX,5465,737-800,27,3,30,3,3,33,,,,,3,6
2019-05-21 01:58,CKG,1733,737-800,20,2,26,2,2,24,,,,,6,4
2019-05-21 01:58,TYN,5139,737-800,15,4,22,5,4,24,,,,,7,9
2019-05-21 01:55,YIH,1435,737-800,22,6,30,5,5,28,,,,,8,6
2019-05-21 01:51,KMG,5449,737-800,20,4,24,4,4,24,,,,,4,4
2019-05-21 01:51,1386,HGH,737-800,21,3,26,4,4,22,,,,,5,1
2019-05-21 01:49,PEK,5483,737-800,18,4,26,4,6,25,,,,,8,7
2019-05-21 01:46,SYX,5481,737-800,30,8,36,8,7,37,,1,,1,6,7
2019-05-21 01:41,DLC,1490,737-800,18,5,26,5,4,23,,,,,8,5
2019-05-21 01:41,URC,1322,737-800,20,7,28,4,4,26,,,,,8,6
2019-05-21 01:39,HHA,5429,737-800,22,4,22,4,4,22,,,,,0,0
2019-05-21 01:39,URC,2159,737-800,24,8,20,2,2,22,,,,,-4,-2
2019-05-21 01:37,FOC,5503,737-800,25,3,26,3,3,26,,,,,1,1
2019-05-21 01:33,SYX,7886,737-800,30,5,37,5,4,36,1,,,1,7,6
2019-05-21 01:26,HHA,5428,737-800,25,4,26,4,4,28,,,,,1,3
2019-05-21 01:23,HAK,6063,737-800,28,6,35,6,6,36,,,,,7,8
2019-05-21 01:22,CAN,5478,737-800,27,3,32,5,4,30,,,,,5,3
2019-05-21 01:21,CAN,6808,737-800,29,4,34,5,4,29,,,,,5,0
2019-05-21 01:13,HHA,5852,737-800,23,4,26,5,4,24,,,,,3,1
2019-05-21 01:11,URC ,5346,737-800,23,5,25,5,5,22,,,,,2,-1
2019-05-21 01:08,CAN,5855,737-800,29,5,29,6,6,27,,,,,0,-2
2019-05-21 01:06,TYN,1549,737-800,20,3,22,3,4,23,,,,,2,3
2019-05-21 01:05,HAK,1487,737-800,26,4,36,4,4,34,1,,,1,10,8
2019-05-21 01:04,XIY,1927,737-800,20,2,20,6,2,21,,,,,0,1
2019-05-21 01:03,URC,5623,737-800,20,4,24,4,4,22,,,,,4,2
2019-05-21 01:03,HGH,5337,737-800,19,4,26,4,4,26,,,,,7,7
2019-05-21 01:02,CKG,1538,737-800,20,3,27,4,2,24,,,,,7,4
2019-05-21 01:01,XIY,5115,737-800,20,3,16,2,2,20,,,,,-4,0
2019-05-21 01:00,FOC,5430,737-800,22,6,30,6,6,29,,,,,8,7
2019-05-21 01:00,FOC,5430,737-800,21,6,33,6,6,32,,,,,12,11
2019-05-21 00:59,CAN,5417,737-800,29,5,30,5,4,30,,,,,1,1
2019-05-21 00:58,HAK,5520,737-800,30,4,36,4,4,36,,,,,6,6
2019-05-21 00:52,HAK,1497,737-800,30,4,34,4,4,36,,,,,4,6
2019-05-21 00:51,SZX,1795,737-800,26,4,33,4,4,32,,,,,7,6
2019-05-21 00:42,HHA,5733,737-800,23,5,30,5,6,30,,,,,7,7
2019-05-21 00:41,PEK,5439,737-800,21,4,20,4,4,22,,,,,-1,1
2019-05-21 00:36,CGO,6016,737-800,20,4,29,4,4,27,,,,,9,7
2019-05-21 00:35,CGO,6016,737-800,20,4,29,4,4,27,,,,,9,7
2019-05-21 00:29,CAN,5580,737-800,26,6,30,6,6,34,,,,,4,8
2019-05-21 00:27,HRB,1905,737-800,14,2,24,4,4,20,,,,,10,6
2019-05-21 00:23,HAK,1728,737-800,30,4,36,4,4,30,,,,,6,0
2019-05-21 00:20,KHG,205T,737-800,20,4,18,4,5,16,,,,,-2,-4
2019-05-21 00:18,URC,5138,737-800,22,4,25,5,4,28,,,,,3,6
2019-05-21 00:16,CAN,5418,737-800,28,5,26,4,4,30,,,,,-2,2
2019-05-21 00:14,CGO,6066,737-800,20,4,24,3,3,24,,,,,4,4
2019-05-21 00:14,HAK,5713,737-800,30,7,32,7,6,32,,,,,2,2
2019-05-21 00:10,SYX,1102,737-800,30,3,36,4,5,36,,,,,6,6
2019-05-21 00:09,URC ,1735,737-800,24,3,23,4,4,22,,,,,-1,-2
2019-05-21 00:07,NGB,5686,737-800,20,6,28,5,5,24,,,,,8,4
2019-05-21 00:04,SZX,1541,737-800,25,4,34,7,6,35,,,,,9,10
2019-05-21 00:02,URC,206P,737-800,20,3,22,4,5,22,,,,,2,2
2019-05-20 23:53,ZGC,5405,737-800,10,8,22,9,8,20,,,,,12,10
2019-05-20 23:52,HAK,7991,737-800,33,6,35,5,5,34,,,,,2,1
2019-05-20 23:50,URC,1569,737-800,22,4,26,3,4,26,,,,,4,4
2019-05-20 23:49,HAK,5089,737-800,30,7,31,1,1,37,,,,,1,7
2019-05-20 23:48,MIG,5732,737-800,20,3,24,3,2,24,,,,,4,4
2019-05-20 23:39,XIY,5338,737-800,20,2,22,3,2,22,,,,,2,2
2019-05-20 23:39,SZX,5620,737-800,25,4,34,3,4,31,,,,,9,6
2019-05-20 23:39,CAN,5137,737-800,27,3,32,2,3,30,,,,,5,3
2019-05-20 23:36,KMG,1208,737-800,18,4,26,3,3,24,,,,,8,6
2019-05-20 23:32,HGH,5581,737-800,19,4,20,5,4,26,,,,,1,7
2019-05-20 23:27,HAK,5579,737-800,29,8,36,8,8,36,,,,,7,7
2019-05-20 23:26,CKG,7616,737-800,20,4,20,4,4,25,,,,,0,5
2019-05-20 23:24,HAK,206H,737-800,29,8,36,3,3,33,,,,,7,4
2019-05-20 23:24,CGO,205U,737-800,22,4,26,4,4,26,,,,,4,4
2019-05-20 23:20,XIY,5136,737-800,20,4,25,2,2,25,,,,,5,5
2019-05-20 23:13,PEK,1997,737-800,21,5,25,3,3,23,,,,,4,2
2019-05-20 23:10,HHA,1347,737-800,22,4,30,3,4,26,,,,,8,4
2019-05-20 23:10,XNN,7399,737-800,15,4,22,4,4,18,,,,,7,3
2019-05-20 23:03,CGO,1587,737-800,22,4,28,4,2,22,,,,,6,0
2019-05-20 22:56,DLC ,1130,737-800,17,2,28,3,2,26,,,,,11,9
2019-05-20 22:53,URC,1325,737-800,24,6,20,4,4,24,,,,,-4,0
2019-05-20 22:27,TYN,1215,737-800,20,4,26,4,4,22,,,,,6,2
2019-05-20 22:26,URC,205V,737-800,20,3,27,4,4,26,,,,,7,6
2019-05-20 22:16,PEK,1796,737-800,24,4,26,5,5,24,,,,,2,0
2019-05-20 22:14,URC,1494,737-800,24,7,30,6,5,28,,,,,6,4
2019-05-20 22:04,SYX,7618,737-800,31,4,35,7,5,35,,,,,4,4
2019-05-20 21:46,HGH,5637,737-800,23,4,28,2,2,25,,,,,5,2
2019-05-20 21:33,HAK,206G,737-800,28,3,35,4,5,35,,,,,7,7
2019-05-20 21:23,DLC,1797,737-800,19,2,26,4,4,23,,,,,7,4
2019-05-20 21:14,HGH,1729,737-800,23,4,22,4,4,24,,,,,-1,1
2019-05-20 21:02,CGO,7992,737-800,25,5,25,6,6,25,,,,,0,0
2019-05-20 20:36,HAK,1215,737-800,28,6,34,4,4,33,,,,,6,5
2019-05-20 20:01,HAK,5479,737-800,30,4,34,8,7,35,,,,,4,5
2019-05-20 19:53,HRB,1435,737-800,10,5,18,4,4,18,,,,,8,8
2019-05-20 17:14,ÐìÖÝ,7167,737-800,25,7,28,7,7,26,,,,,3,1
2019-05-20 16:25,PEK,1103,737-800,25,4,28,4,4,26,,,,,3,1
2019-05-20 15:54,SZX,1375,737-800,30,3,32,4,4,30,,,,,2,0
2019-05-20 13:45,YIH,1906,737-800,23,5,30,6,7,18,,,,,7,-5
2019-05-20 12:57,ÃàÑô,1798,737-800,25,6,28,6,6,25,,,,,3,0
2019-05-20 10:33,ZGC,6062,737-800,10,4,18,4,4,18,,,,,8,8
2019-05-20 10:32,ZGC,5358,737-800,15,6,22,6,7,23,,,,,7,8
2019-05-20 10:32,ZGC,5638,737-800,10,4,18,4,4,18,,,,,8,8
2019-05-20 09:36,SZX,5465,737-800,28,6,36,7,6,36,,,,,8,8
2019-05-20 08:39,SZX,7377,737-800,30,5,36,5,5,36,,,,,6,6
2019-05-20 08:38,SZX,1928,737-800,30,6,26,7,7,34,,,,,-4,4
2019-05-20 08:36,SZX,1375,737-800,28,4,36,3,4,30,,,,,8,2
2019-05-20 08:29,PEK,5735,737-800,17,2,22,2,2,22,,,,,5,5
2019-05-20 08:23,PEK,5372,737-800,25,7,22,7,7,22,,,,,-3,-3
2019-05-20 08:05,XMN,1727,737-800,25,5,29,4,3,32,,,,,4,7
2019-05-20 08:05,XMN,7175,737-800,26,6,34,6,7,32,,,,,8,6
2019-05-20 08:04,XMN,5439,737-800,26,6,32,6,5,33,,,,,6,7
2019-05-20 08:03,XMN,5467,737-800,24,6,32,4,5,32,,,,,8,8
2019-05-20 07:50,CAN,5521,737-800,27,4,33,5,5,36,,,,,6,9
2019-05-20 07:49,CAN,1783,737-800,25,4,25,5,5,34,,,,,0,9
2019-05-20 07:47,SYX,5522,737-800,30,8,37,8,9,36,1,,,1,7,6
2019-05-20 07:16,PEK,5480,737-800,20,3,25,3,4,25,,,,,5,5
2019-05-20 06:59,SZX,1995,737-800,29,8,37,5,6,32,,,,,8,3
2019-05-20 06:55,SZX,1541,737-800,29,6,35,6,5,35,,,,,6,6
2019-05-20 06:34,XIY,1480,737-800,19,4,20,3,4,19,,,,,1,0
2019-05-20 06:00,HGH,5520,737-800,25,4,32,4,4,30,,,,,7,5
2019-05-20 05:40,PEK,1492,737-800,16,3,24,2,3,22,,,,,8,6
2019-05-20 05:31,FOC,5430,737-800,25,6,35,8,8,35,1,1,,11,10,10
2019-05-20 05:30,FOC,5430,737-800,25,6,37,8,8,37,,,,,12,12
2019-05-20 05:22,PEK,5538,737-800,20,30,3,3,3,28,,,,,-17,8
2019-05-20 05:18,CAN,1497,737-800,28,4,35,4,4,34,,,,,7,6
2019-05-20 05:17,CAN,5478,737-800,25,8,37,5,4,34,1,,,1,12,9
2019-05-20 05:16,PEK,5135,737-800,16,2,22,2,3,22,,,,,6,6
2019-05-20 05:14,URC,1996,737-800,20,3,20,6,6,24,,,,,0,4
2019-05-20 05:10,CGO,5709,737-800,18,5,30,8,6,26,,,,,12,8
2019-05-20 05:03,CGO,1386,737-800,21,3,25,3,3,19,,,,,4,-2
2019-05-20 04:58,CAN,5373,737-800,30,9,36,8,9,37,,1,,1,6,7
2019-05-20 04:27,TYN,5090,737-800,11,2,23,1,2,20,,,,,12,9
2019-05-20 04:26,KMG,7988,737-800,20,5,29,5,4,29,,,,,9,9
2019-05-20 04:18,SYX,5375,737-800,29,8,36,5,4,30,,,,,7,1
2019-05-20 04:14,Ö£ÖÝ,7992,737-800,16,6,26,7,7,24,,,,,10,8
2019-05-20 04:12,SZX,1799,737-800,29,4,36,5,5,33,,,,,7,4
2019-05-20 04:10,URC,1496,737-800,15,4,24,4,4,24,,,,,9,9
2019-05-20 04:07,HAK,5620,737-800,30,7,34,5,4,33,,,,,4,3
2019-05-20 04:04,CAN,5502,737-800,30,5,37,6,6,34,1,,,1,7,4
2019-05-20 04:01,CAN,5623,737-800,30,5,37,4,4,35,1,,,1,7,5
2019-05-20 03:54,XIY,1163,737-800,20,5,23,4,5,24,,,,,3,4
2019-05-20 03:52,FOC,1346,737-800,27,5,36,5,7,34,,,,,9,7
2019-05-20 03:52,URC,5625,737-800,20,6,24,4,4,20,,,,,4,0
2019-05-20 03:46,XIY,1903,737-800,21,1,24,2,2,25,,,,,3,4
2019-05-20 03:38,HGH,5337,737-800,26,5,27,6,7,27,,,,,1,1
2019-05-20 03:30,URC,5138,737-800,16,4,22,8,9,30,,,,,6,14
2019-05-20 03:29,HGH,1786,737-800,26,5,28,4,4,26,,,,,2,0
2019-05-20 03:28,HHA,7172,737-800,22,4,28,4,4,27,,,,,6,5
2019-05-20 03:18,HHA,5852,737-800,26,4,29,4,3,25,,,,,3,-1
2019-05-20 03:14,PEK,5539,737-800,17,4,26,4,4,26,,,,,9,9
2019-05-20 03:12,XIY,5418,737-800,22,4,16,4,4,23,,,,,-6,1
2019-05-20 03:09,HAK,5580,737-800,30,9,36,6,8,36,,,,,6,6
2019-05-20 03:07,XIY,7105,737-800,18,4,26,4,4,24,,,,,8,6
2019-05-20 03:02,XIY,1162,737-800,19,4,28,4,2,26,,,,,9,7
2019-05-20 02:58,FOC,7113,737-800,28,5,28,6,6,28,,,,,0,0
2019-05-20 02:57,HHA,6063,737-800,23,5,28,5,5,29,,,,,5,6
2019-05-20 02:56,SZX,1541,737-800,29,6,35,6,5,35,,,,,6,6
2019-05-20 02:56,MIG,5407,737-800,20,3,28,4,3,24,,,,,8,4
2019-05-20 02:55,CKG,7616,737-800,17,3,27,4,4,26,,,,,10,9
2019-05-20 02:53,À¥Ã÷,5409,737-800,21,6,24,4,4,25,,,,,3,4
2019-05-20 02:44,KMG,7993,737-800,20,9,30,6,6,25,,,,,10,5
2019-05-20 02:41,HAK,5580,737-800,30,9,38,6,8,36,,,,,8,6
2019-05-20 02:41,SYX,206F,737-800,28,2,34,2,3,32,,,,,6,4
2019-05-20 02:36,URC,205T,737-800,20,3,24,4,3,25,,,,,4,5
2019-05-20 02:34,PEK,5662,737-800,16,3,24,4,6,23,,,,,8,7
2019-05-20 02:33,PEK,1927,737-800,16,2,20,4,2,21,,,,,4,5
2019-05-20 02:32,URC,5686,737-800,20,4,24,4,4,24,,,,,4,4
2019-05-20 02:31,URC,6268,737-800,20,4,28,4,5,26,,,,,8,6
2019-05-20 02:29,HAK,1372,737-800,30,7,35,6,5,34,,,,,5,4
2019-05-20 02:26,KMG,1586,737-800,25,5,26,6,7,27,,,,,1,2
2019-05-20 02:25,URC,1569,737-800,20,2,22,2,2,24,,,,,2,4
2019-05-20 02:25,URC,5853,737-800,19,5,24,5,5,20,,,,,5,1
2019-05-20 02:18,HAK,5082,737-800,29,8,36,0,0,0,,,,,7,-29
2019-05-20 02:18,TYN,206G,737-800,18,4,24,4,4,22,,,,,6,4
2019-05-20 02:18,HAK,1213,737-800,28,7,36,6,6,36,,,,,8,8
2019-05-20 02:16,URC,1568,737-800,15,6,22,6,6,20,,,,,7,5
2019-05-20 02:12,PEK,1545,737-800,15,4,26,4,4,24,,,,,11,9
2019-05-20 02:12,URC,1496,737-800,17,4,24,4,4,24,,,,,7,7
2019-05-20 02:10,PEK,5540,737-800,20,5,28,6,4,24,,,,,8,4
2019-05-20 02:10,CGO,7989,737-800,22,6,28,6,5,26,,,,,6,4
2019-05-20 02:08,CGO,1587,737-800,24,2,24,4,4,22,,,,,0,-2
2019-05-20 02:07,URC,7198,737-800,17,4,18,4,4,22,,,,,1,5
2019-05-20 02:06,HRB,1562,737-800,11,3,26,4,4,24,,,,,15,13
2019-05-20 02:03,SYX,1102,737-800,30,3,36,5,4,37,,1,,1,6,7
2019-05-20 02:03,HGH,5520,737-800,25,4,32,4,4,30,,,,,7,5
2019-05-20 02:02,HGH,7379,737-800,27,5,28,3,3,26,,,,,1,-1
2019-05-20 02:01,XIY,1482,737-800,20,5,24,4,4,24,,,,,4,4
2019-05-20 02:00,HRB,1562,737-800,11,5,28,6,6,26,,,,,17,15
2019-05-20 02:00,XIY ,5115,737-800,23,3,20,4,3,24,,,,,-3,1
2019-05-20 01:59,XIY ,5115,737-800,23,3,20,4,3,24,,,,,-3,1
2019-05-20 01:57,HHA,6065,737-800,22,5,28,5,5,27,,,,,6,5
2019-05-20 01:56,HAK,5408,737-800,30,6,36,6,6,35,,,,,6,5
2019-05-20 01:55,CAN,5373,737-800,30,9,36,8,9,37,,,,,6,7
2019-05-20 01:54,CAN,7619,737-800,29,6,31,8,6,33,,,,,2,4
2019-05-20 01:53,CAN,7619,737-800,29,6,31,8,6,33,,,,,2,4
2019-05-20 01:52,FOC,5182,737-800,25,3,23,4,4,31,,,,,-2,6
2019-05-20 01:50,CAN,6808,737-800,30,4,36,6,5,34,,,,,6,4
2019-05-20 01:50,FOC,1348,737-800,27,4,35,6,5,34,,,,,8,7
2019-05-20 01:45,XIY,1161,737-800,18,3,24,4,4,24,,,,,6,6
2019-05-20 01:39,HAK,5479,737-800,28,7,36,6,6,36,,,,,8,8
2019-05-20 01:38,SZX,1488,737-800,28,6,36,6,6,31,,,,,8,3
2019-05-20 01:37,SYX,1493,737-800,30,5,32,5,5,30,,,,,2,0
2019-05-20 01:34,HAK,5687,737-800,30,6,32,5,5,35,,,,,2,5
2019-05-20 01:34,URC,6995,737-800,20,4,25,5,5,20,,,,,5,0
2019-05-20 01:33,XIY,5338,737-800,23,3,20,4,2,22,,,,,-3,-1
2019-05-20 01:32,URC,205V,737-800,15,4,22,4,4,20,,,,,7,5
2019-05-20 01:29,HHA,5733,737-800,23,6,31,6,6,30,,,,,8,7
2019-05-20 01:24,SYX,5416,737-800,29,8,36,8,8,37,,1,,1,7,8
2019-05-20 01:21,HAK,1733,737-800,28,5,35,7,7,34,,,,,7,6
2019-05-20 01:21,Ö£ÖÝ,6016,737-800,22,5,28,5,5,27,,,,,6,5
2019-05-20 01:15,CKG,7616,737-800,17,4,27,23,24,26,,,,,10,9
2019-05-20 01:09,URC,2159,737-800,20,9,20,3,4,20,,,,,0,0
2019-05-20 01:07,HHA,5581,737-800,23,4,24,4,4,28,,,,,1,5
2019-05-20 01:07,MIG,5732,737-800,25,4,27,3,4,27,,,,,2,2
2019-05-20 01:04,URC,5712,737-800,18,3,20,9,8,30,,,,,2,12
2019-05-20 01:01,HAK,6066,737-800,32,7,32,6,6,35,,,,,0,3
2019-05-20 01:00,DLC,1787,737-800,16,2,22,2,2,24,,,,,6,8
2019-05-20 01:00,HAK,1549,737-800,30,7,36,4,5,34,,,,,6,4
2019-05-20 00:59,SYX,1498,737-800,30,7,36,4,4,34,,,,,6,4
2019-05-20 00:58,YIH,7395,737-800,22,5,29,5,5,28,,,,,7,6
2019-05-20 00:57,´óÁ¬,1101,737-800,15,2,26,2,2,22,,,,,11,7
2019-05-20 00:55,URC,1725,737-800,20,6,28,5,5,30,,,,,8,10
2019-05-20 00:55,SYX,5416,737-800,29,8,36,10,8,37,,,,,7,8
2019-05-20 00:52,HAK,5611,737-800,30,10,40,6,6,34,,,,,10,4
2019-05-20 00:51,KMG,1208,737-800,24,3,27,4,3,25,,,,,3,1
2019-05-20 00:48,PEK,5636,737-800,15,4,22,3,4,22,,,,,7,7
2019-05-20 00:47,FOC,1433,737-800,28,2,32,3,3,28,,,,,4,0
2019-05-20 00:41,URC,5625,737-800,20,6,24,4,4,20,,,,,4,0
2019-05-20 00:41,HGH,6061,737-800,25,4,28,6,6,28,,,,,3,3
2019-05-20 00:40,FOC,1905,737-800,27,3,32,4,3,28,,,,,5,1
2019-05-20 00:39,URC,5797,737-800,19,5,18,8,8,25,,,,,-1,6
2019-05-20 00:39,XIY,5116,737-800,25,4,21,4,5,22,,,,,-4,-3
2019-05-20 00:37,,1548,737-800,15,7,18,5,5,18,,,,,3,3
2019-05-20 00:36,CAN,5855,737-800,30,8,33,8,8,30,,,,,3,0
2019-05-20 00:36,XNN,7399,737-800,14,6,19,7,7,20,,,,,5,6
2019-05-20 00:35,KHG,1325,737-800,18,3,22,4,3,23,,,,,4,5
2019-05-20 00:35,XNN,1797,737-800,15,4,17,5,5,21,,,,,2,6
2019-05-20 00:33,CAN,5855,737-800,30,33,8,8,8,30,,,,,-22,0
2019-05-20 00:30,XIY,7639,737-800,21,4,23,4,5,24,,,,,2,3
2019-05-20 00:28,HHA,5428,737-800,22,4,20,4,2,24,,,,,-2,2
2019-05-20 00:28,Ö£ÖÝ,205U,737-800,25,4,24,4,4,25,,,,,-1,0
2019-05-20 00:27,MIG,1798,737-800,20,6,28,6,6,24,,,,,8,4
2019-05-20 00:24,HGH,1729,737-800,24,4,24,3,4,27,,,,,0,3
2019-05-20 00:23,URC,7173,737-800,20,4,28,6,5,24,,,,,8,4
2019-05-20 00:22,HAK,6015,737-800,28,8,31,7,7,32,,,,,3,4
2019-05-20 00:08,URC,1570,737-800,15,5,23,6,6,20,,,,,8,5
2019-05-20 00:08,HRB,1351,737-800,14,4,28,5,5,20,,,,,14,6
2019-05-20 00:08,CKG,1538,737-800,17,2,26,2,2,26,,,,,9,9
2019-05-20 00:07,KMG ,1588,737-800,20,4,25,3,2,23,,,,,5,3
2019-05-20 00:06,HGH,7400,737-800,25,4,30,4,4,32,,,,,5,7
2019-05-20 00:05,XIY,5153,737-800,20,2,26,2,4,24,,,,,6,4
2019-05-20 00:04,XIY,7171,737-800,21,4,22,4,4,26,,,,,1,5
2019-05-20 00:02,DLC,1505,737-800,16,3,26,4,4,23,,,,,10,7
2019-05-20 00:02,DLC,1130,737-800,16,2,28,2,2,26,,,,,12,10
2019-05-19 23:59,104,5371,737-800,17,8,19,4,5,20,,,,,2,3
2019-05-19 23:59,SYX,5416,737-800,29,12,36,10,8,37,,,,,7,8
2019-05-19 23:59,HAK,1373,737-800,25,4,36,4,4,33,,,,,11,8
2019-05-19 23:58,PEK,1489,737-800,25,4,25,4,4,21,,,,,0,-4
2019-05-19 23:53,CTU,6800,737-800,20,4,26,4,4,23,,,,,6,3
2019-05-19 23:51,XIY,6103,737-800,20,6,24,6,6,24,,,,,4,4
2019-05-19 23:48,HRB,1435,737-800,13,6,29,5,5,25,,,,,16,12
2019-05-19 23:33,CAN,1503,737-800,32,2,36,4,4,36,,,,,4,4
2019-05-19 23:31,HAK,5579,737-800,29,8,32,8,7,33,,,,,3,4
2019-05-19 23:28,HAK,1793,737-800,28,6,34,8,5,33,,,,,6,5
2019-05-19 23:28,HAK,5082,737-800,29,10,38,6,6,34,,,,,9,5
2019-05-19 23:22,URC,1785,737-800,21,2,28,7,7,27,,,,,7,6
2019-05-19 23:16,103,5482,737-800,17,0,30,3,3,26,,,,,13,9
2019-05-19 23:16,DLC,1997,737-800,17,6,26,4,4,20,,,,,9,3
2019-05-19 23:11,CKG,5462,737-800,19,4,26,4,4,26,,,,,7,7
2019-05-19 23:06,HAK,1929,737-800,29,7,37,4,4,34,,,,,8,5
2019-05-19 23:04,URC,1323,737-800,20,4,24,4,4,24,,,,,4,4
2019-05-19 22:59,URC,1322,737-800,20,4,18,4,4,24,,,,,-2,4
2019-05-19 22:54,HHA,5429,737-800,23,3,28,4,3,30,,,,,5,7
2019-05-19 22:48,PEK,5483,737-800,16,5,23,4,5,26,,,,,7,10
2019-05-19 22:41,HAK,5798,737-800,29,4,33,3,3,33,,,,,4,4
2019-05-19 22:30,TYN,7886,737-800,15,3,20,5,3,19,,,,,5,4
2019-05-19 22:26,TYN,1495,737-800,15,7,26,7,7,25,,,,,11,10
2019-05-19 22:21,DLC,1141,737-800,17,4,28,6,6,26,,,,,11,9
2019-05-19 22:19,HAK,1487,737-800,28,3,32,4,4,32,,,,,4,4
2019-05-19 22:18,DLC,1490,737-800,17,5,26,4,5,24,,,,,9,7
2019-05-19 22:14,,1131,737-800,30,4,35,4,3,35,,,,,5,5
2019-05-19 22:06,MIG,6809,737-800,20,4,24,4,4,26,,,,,4,6
2019-05-19 22:01,HAK,1547,737-800,31,7,36,8,8,36,,,,,5,5
2019-05-19 21:58,PEK,6060,737-800,17,4,24,5,4,24,,,,,7,7
2019-05-19 21:57,SYX,7618,737-800,30,4,35,6,4,34,,,,,5,4
2019-05-19 21:57,HAK,5417,737-800,30,6,34,6,5,34,,,,,4,4
2019-05-19 21:52,HAK,206H,737-800,29,4,34,4,4,34,,,,,5,5
2019-05-19 21:50,URC,206P,737-800,22,4,24,4,4,22,,,,,2,0
2019-05-19 21:29,KMG,7167,737-800,25,6,24,5,5,25,,,,,-1,0
2019-05-19 21:12,´óÁ¬,7378,737-800,18,6,26,6,5,24,,,,,8,6
2019-05-19 21:07,Ö£ÖÝ,7990,737-800,25,4,24,4,3,26,,,,,-1,1
2019-05-19 20:56,HAK,5137,737-800,30,6,32,6,6,35,,,,,2,5
2019-05-19 20:46,DLC,5346,737-800,18,4,24,5,5,24,,,,,6,6
2019-05-19 20:24,HAK,5089,737-800,34,9,36,4,4,36,,,,,2,2
2019-05-19 19:40,HGH,5637,737-800,23,2,32,2,2,30,,,,,9,7
2019-05-19 18:42,XUZ,5449,737-800,30,4,26,4,4,30,,,,,-4,0
2019-05-19 17:35,KMG,7991,737-800,25,6,28,6,6,28,,,,,3,3
2019-05-19 16:45,KMG,1209,737-800,29,5,34,4,4,35,,,,,5,6
2019-05-19 15:14,SZX,5465,737-800,32,7,36,5,6,36,,,,,4,4
2019-05-19 15:02,YIH,1906,737-800,28,7,29,7,6,29,,,,,1,1
2019-05-19 14:55,HAK,1347,737-800,42,6,35,5,5,34,,,,,-7,-8
2019-05-19 14:53,XIY,1103,737-800,28,4,30,5,6,27,,,,,2,-1
2019-05-19 12:15,PEK,5481,737-800,23,6,26,7,6,24,,,,,3,1
2019-05-19 11:42,HAK,5709,737-800,37,8,35,8,8,36,,,,,-2,-1
2019-05-19 11:27,SZX,1795,737-800,30,3,36,5,4,36,,,,,6,6
2019-05-19 11:21,HAK,5709,737-800,37,8,35,8,8,36,,,,,-2,-1
2019-05-19 10:04,XMN,5428,737-800,27,7,36,8,5,36,,,,,9,9
2019-05-19 10:03,XMN,1545,737-800,25,3,25,2,3,26,,,,,0,1
2019-05-19 10:03,XMN,7398,737-800,25,3,25,6,6,24,,,,,0,-1
2019-05-19 10:02,XMN,5638,737-800,25,7,20,5,6,23,,,,,-5,-2
2019-05-19 10:01,XMN,5428,737-800,27,7,36,8,5,36,,,,,9,9
2019-05-19 09:22,XMN,5428,737-800,30,7,36,8,5,36,,,,,6,6
2019-05-19 08:46,HAK,5520,737-800,30,5,36,6,5,34,,,,,6,4
2019-05-19 08:13,,7377,737-800,29,8,36,5,6,34,,,,,7,5
2019-05-19 07:35,PEK,5371,737-800,20,9,26,6,6,28,,,,,6,8
2019-05-19 07:34,PEK ,5735,737-800,15,5,29,2,1,24,,,,,14,9
2019-05-19 07:15,HAK,7399,737-800,29,6,34,4,5,26,,,,,5,-3
2019-05-19 07:14,HAK,5713,737-800,29,8,16,7,7,22,,,,,-13,-7
2019-05-19 07:13,HAK,5089,737-800,28,9,35,4,5,33,,,,,7,5
2019-05-19 06:28,HAK,5082,737-800,27,5,32,6,6,36,,,,,5,9
2019-05-19 06:13,URC ,1569,737-800,13,3,22,3,4,23,,,,,9,10
2019-05-19 05:52,PEK,5482,737-800,15,2,29,2,2,28,,,,,14,13
2019-05-19 05:50,FOC,7113,737-800,24,4,29,5,5,28,,,,,5,4
2019-05-19 05:19,URC,5686,737-800,15,4,26,4,4,26,,,,,11,11
2019-05-19 05:08,HAK,5359,737-800,25,6,32,5,5,30,,,,,7,5
2019-05-19 05:06,URC,5636,737-800,15,4,26,4,4,26,,,,,11,11
2019-05-19 05:06,URC,5637,737-800,14,2,21,2,2,19,,,,,7,5
2019-05-19 05:06,URC,1726,737-800,15,2,24,4,4,20,,,,,9,5
2019-05-19 05:04,KMG,5449,737-800,22,5,27,5,5,26,,,,,5,4
2019-05-19 05:03,PEK ,5467,737-800,15,2,27,4,2,26,,,,,12,11
2019-05-19 05:02,URC,1725,737-800,14,5,23,6,6,27,,,,,9,13
2019-05-19 05:02,URC,5853,737-800,16,6,25,7,7,26,,,,,9,10
2019-05-19 05:01,URC,1725,737-800,14,5,23,6,6,27,,,,,9,13
2019-05-19 05:00,URC,5712,737-800,15,3,17,2,2,18,,,,,2,3
2019-05-19 05:00,URC,1570,737-800,15,4,26,4,6,24,,,,,11,9
2019-05-19 04:59,URC,7171,737-800,16,4,20,4,4,24,,,,,4,8
2019-05-19 04:58,URC,205V,737-800,15,6,23,4,4,22,,,,,8,7
2019-05-19 04:57,HHA,5581,737-800,25,6,26,5,5,32,,,,,1,7
2019-05-19 04:57,URC,1323,737-800,17,2,23,3,3,24,,,,,6,7
2019-05-19 04:50,XIY,5116,737-800,24,3,23,4,3,24,,,,,-1,0
2019-05-19 04:50,XIY,5180,737-800,22,6,28,7,7,27,,,,,6,5
2019-05-19 04:43,FOC,5480,737-800,24,5,32,5,4,28,,,,,8,4
2019-05-19 04:42,HAK,1928,737-800,30,5,30,8,8,34,,,,,0,4
2019-05-19 04:41,PEK,5538,737-800,18,4,37,4,4,24,,,,,19,6
2019-05-19 04:41,CBU,6800,737-800,22,4,31,3,4,28,,,,,9,6
2019-05-19 04:29,CTU,6800,737-800,22,4,31,3,4,28,,,,,9,6
2019-05-19 04:29,HGH,5540,737-800,20,6,33,6,6,30,1,,,1,13,10
2019-05-19 04:26,KMG,1588,737-800,20,5,20,4,4,20,,,,,0,0
2019-05-19 04:25,URC,1496,737-800,15,4,24,2,4,22,,,,,9,7
2019-05-19 04:24,URC,6268,737-800,10,6,25,4,7,26,,,,,15,16
2019-05-19 04:23,KMG,7167,737-800,20,5,26,5,5,25,,,,,6,5
2019-05-19 04:21,CAN,5479,737-800,30,8,36,8,8,36,,,,,6,6
2019-05-19 04:16,,5466,737-800,29,1,32,1,0,32,,,,,3,3
2019-05-19 04:15,DLC,1130,737-800,20,2,28,2,2,26,,,,,8,6
2019-05-19 04:11,DLC,5338,737-800,20,2,23,2,3,24,,,,,3,4
2019-05-19 04:08,XIY,1542,737-800,15,4,20,5,4,22,,,,,5,7
2019-05-19 04:07,XIY,1480,737-800,19,4,24,4,5,24,,,,,5,5
2019-05-19 04:04,HAK,5798,737-800,28,5,28,5,5,28,,,,,0,0
2019-05-19 04:01,HGH,5405,737-800,23,5,30,5,4,28,,,,,7,5
2019-05-19 04:00,URC,6995,737-800,10,4,22,4,5,18,,,,,12,8
2019-05-19 03:59,XIY,1162,737-800,23,2,32,2,2,28,,,,,9,5
2019-05-19 03:57,SZX,1733,737-800,30,6,35,6,6,34,,,,,5,4
2019-05-19 03:45,KMG,7990,737-800,22,3,26,4,4,24,,,,,4,2
2019-05-19 03:45,HAK,1793,737-800,32,4,35,5,5,32,,,,,3,0
2019-05-19 03:42,HAK,1799,737-800,32,4,36,6,5,33,,,,,4,1
2019-05-19 03:37,KMG,1208,737-800,19,3,25,4,4,24,,,,,6,5
2019-05-19 03:36,XIY,5153,737-800,23,2,28,2,2,26,,,,,5,3
2019-05-19 03:36,ZGC,5358,737-800,13,7,23,6,5,21,,,,,10,8
2019-05-19 03:35,HHA,5439,737-800,25,4,31,2,3,30,,,,,6,5
2019-05-19 03:34,XIY,1796,737-800,22,4,27,2,2,26,,,,,5,4
2019-05-19 03:33,HHA,7172,737-800,25,4,32,5,4,30,,,,,7,5
2019-05-19 03:32,DLC,7400,737-800,18,4,22,4,4,24,,,,,4,6
2019-05-19 03:31,CGO,1587,737-800,20,3,28,4,3,26,,,,,8,6
2019-05-19 03:31,SYX,7619,737-800,30,5,31,6,6,30,,,,,1,0
2019-05-19 03:29,XIY,1163,737-800,22,2,30,2,2,30,,,,,8,8
2019-05-19 03:28,XIY,1903,737-800,22,2,28,2,2,30,,,,,6,8
2019-05-19 03:27,DLC,5346,737-800,20,4,30,6,6,26,,,,,10,6
2019-05-19 03:24,ZGC,6063,737-800,13,6,22,6,5,21,,,,,9,8
2019-05-19 03:23,SYX,206F,737-800,31,4,34,4,4,32,,,,,3,1
2019-05-19 03:20,SYX,206F,737-800,31,4,34,4,4,32,,,,,3,1
2019-05-19 03:19,XIY,7105,737-800,15,4,22,5,4,24,,,,,7,9
2019-05-19 03:19,CAN,1497,737-800,29,4,36,4,4,34,,,,,7,5
2019-05-19 03:18,º£¿Ú,1131,737-800,29,2,36,4,4,32,,,,,7,3
2019-05-19 03:15,ZGC,1493,737-800,10,6,22,6,6,20,,,,,12,10
2019-05-19 03:14,FOC,1435,737-800,22,4,26,4,4,27,,,,,4,5
2019-05-19 03:14,FOC,1348,737-800,26,4,32,3,4,30,,,,,6,4
2019-05-19 03:10,URC,1570,737-800,15,4,26,4,6,24,,,,,11,9
2019-05-19 03:09,XIY,1902,737-800,18,5,28,5,4,24,,,,,10,6
2019-05-19 03:09,URC,7171,737-800,18,4,24,4,4,22,,,,,6,4
2019-05-19 03:07,CAN,5623,737-800,30,9,37,6,6,34,,,,,7,4
2019-05-19 03:06,XIY,7378,737-800,22,6,32,6,6,32,,,,,10,10
2019-05-19 03:01,SYX,1102,737-800,28,4,34,4,5,35,,,,,6,7
2019-05-19 02:56,DLC,1787,737-800,20,3,26,4,4,24,,,,,6,4
2019-05-19 02:50,DLC,1505,737-800,19,4,24,4,3,24,,,,,5,5
2019-05-19 02:46,FOC,7113,737-800,24,4,29,5,5,28,,,,,5,4
2019-05-19 02:44,KMG,6016,737-800,23,4,30,4,4,26,,,,,7,3
2019-05-19 02:43,SZX,1995,737-800,28,6,34,4,5,33,,,,,6,5
2019-05-19 02:38,URC,1996,737-800,20,2,20,4,4,24,,,,,0,4
2019-05-19 02:38,HHA,5429,737-800,25,3,30,4,4,30,,,,,5,5
2019-05-19 02:37,SZX,1541,737-800,25,8,36,6,6,36,1,1,,11,11,11
2019-05-19 02:37,FOC,5430,737-800,23,5,26,4,5,26,,,,,3,3
2019-05-19 02:36,CAN,5521,737-800,30,4,32,4,4,32,,,,,2,2
2019-05-19 02:35,PEK,5687,737-800,20,4,20,4,4,26,,,,,0,6
2019-05-19 02:32,KMG,1209,737-800,20,4,28,4,4,26,,,,,8,6
2019-05-19 02:26,URC,1325,737-800,18,2,18,2,2,20,,,,,0,2
2019-05-19 02:22,CAN,5373,737-800,29,6,33,6,6,34,,,,,4,5
2019-05-19 02:20,FOC,1905,737-800,24,4,30,4,4,26,,,,,6,2
2019-05-19 02:19,XIY,5139,737-800,22,4,26,4,4,28,,,,,4,6
2019-05-19 02:19,XIY,5139,737-800,22,4,26,4,4,28,,,,,4,6
2019-05-19 02:16,SYX,1386,737-800,29,4,35,4,4,33,,,,,6,4
2019-05-19 02:11,XIY,1482,737-800,21,5,27,5,6,25,,,,,6,4
2019-05-19 02:08,HHA,6065,737-800,25,5,29,4,4,22,,,,,4,-3
2019-05-19 02:06,HGH,1927,737-800,25,4,24,3,3,24,,,,,-1,-1
2019-05-19 01:59,HGH,7616,737-800,23,4,28,4,4,28,,,,,5,5
2019-05-19 01:55,DLC,5138,737-800,19,4,28,4,4,28,,,,,9,9
2019-05-19 01:53,HGH,5337,737-800,24,5,30,5,4,30,,,,,6,6
2019-05-19 01:53,CAN,5855,737-800,29,6,32,8,8,30,,,,,3,1
2019-05-19 01:52,HGH,5337,737-800,27,5,30,5,4,30,,,,,3,3
2019-05-19 01:50,CAN,6066,737-800,30,3,36,4,4,35,,,,,6,5
2019-05-19 01:44,HAK,1929,737-800,29,9,37,4,4,35,,,,,8,6
2019-05-19 01:44,SYX,7379,737-800,30,5,35,6,5,34,,,,,5,4
2019-05-19 01:43,HHA,5733,737-800,26,4,30,4,5,32,,,,,4,6
2019-05-19 01:41,XIY,1161,737-800,20,4,28,3,3,27,,,,,8,7
2019-05-19 01:39,PEK,5372,737-800,20,7,28,7,7,26,,,,,8,6
2019-05-19 01:36,Ì«Ô­,1488,737-800,19,5,25,4,4,24,,,,,6,5
2019-05-19 01:36,TYN,206G,737-800,19,3,20,4,4,21,,,,,1,2
2019-05-19 01:35,CGO,7989,737-800,25,5,28,4,4,29,,,,,3,4
2019-05-19 01:34,CAN,5478,737-800,29,8,36,5,4,34,,,,,7,5
2019-05-19 01:32,YIH,1350,737-800,23,4,31,4,4,29,,,,,8,6
2019-05-19 01:32,SYX,5463,737-800,30,6,35,6,6,35,,,,,5,5
2019-05-19 01:30,XIY,5136,737-800,20,4,28,5,4,29,,,,,8,9
2019-05-19 01:30,URC,5797,737-800,20,3,18,3,4,22,,,,,-2,2
2019-05-19 01:29,YIH,7395,737-800,22,6,30,6,6,30,,,,,8,8
2019-05-19 01:23,XIY,5115,737-800,18,4,20,4,4,18,,,,,2,0
2019-05-19 01:22,HAK,7886,737-800,32,4,36,4,4,36,,,,,4,4
2019-05-19 01:16,XIY,5483,737-800,20,5,28,4,4,26,,,,,8,6
2019-05-19 01:16,HGH,1997,737-800,25,8,32,4,4,26,,,,,7,1
2019-05-19 01:16,DLC,1141,737-800,20,5,28,8,8,30,,,,,8,10
2019-05-19 01:14,HAK,1347,737-800,30,7,37,4,4,34,,,,,7,4
2019-05-19 01:10,CKG,5522,737-800,24,6,30,7,6,30,,,,,6,6
2019-05-19 01:09,CAN,5662,737-800,31,8,36,5,8,36,,,,,5,5
2019-05-19 01:08,CKG,5462,737-800,30,4,28,4,4,28,,,,,-2,-2
2019-05-19 01:06,CGO,1498,737-800,22,4,28,4,4,26,,,,,6,4
2019-05-19 01:06,FOC,5182,737-800,24,3,28,5,6,28,,,,,4,4
2019-05-19 01:05,CGO,7993,737-800,21,6,28,6,6,26,,,,,7,5
2019-05-19 01:03,SZX,1785,737-800,30,6,37,9,9,36,,,,,7,6
2019-05-19 01:00,HAK,6060,737-800,29,5,36,6,5,33,,,,,7,4
2019-05-19 00:59,CGO,6103,737-800,20,5,27,6,6,28,,,,,7,8
2019-05-19 00:57,TYN,5090,737-800,19,4,26,4,4,24,,,,,7,5
2019-05-19 00:57,HAK,1503,737-800,28,4,35,4,4,35,,,,,7,7
2019-05-19 00:54,DLC,1101,737-800,20,4,26,4,4,22,,,,,6,2
2019-05-19 00:54,SZX,1375,737-800,29,4,32,4,4,30,,,,,3,1
2019-05-19 00:53,PEK,5539,737-800,20,5,31,6,6,31,,,,,11,11
2019-05-19 00:52,HHA,1215,737-800,26,3,30,4,4,34,,,,,4,8
2019-05-19 00:50,DLC,1797,737-800,20,3,26,4,4,25,,,,,6,5
2019-05-19 00:45,HHA,1492,737-800,25,4,30,3,3,30,,,,,5,5
2019-05-19 00:43,CGO,7992,737-800,25,4,24,4,4,24,,,,,-1,-1
2019-05-19 00:41,SZX,5465,737-800,28,7,36,5,6,37,,,,,8,9
2019-05-19 00:41,XIY,1346,737-800,25,6,34,6,4,28,,,,,9,3
2019-05-19 00:38,KHG,206P,737-800,15,3,22,3,4,21,,,,,7,6
2019-05-19 00:38,XIY,6061,737-800,23,6,29,4,4,26,,,,,6,3
2019-05-19 00:35,MIG,6809,737-800,21,5,28,6,5,29,,,,,7,8
2019-05-19 00:28,TYN,5418,737-800,15,4,20,4,4,20,,,,,5,5
2019-05-19 00:27,SYX,5375,737-800,31,7,36,6,5,34,,,,,5,3
2019-05-19 00:26,HRB,1562,737-800,12,4,21,4,4,21,,,,,9,9
2019-05-19 00:15,URC,1322,737-800,18,2,20,2,2,24,,,,,2,6
2019-05-19 00:10,MIG,5732,737-800,25,3,27,3,3,28,,,,,2,3
2019-05-19 00:07,HAK,1213,737-800,30,6,36,5,5,34,,,,,6,4
2019-05-19 00:05,SZX,1549,737-800,29,6,36,6,5,36,,,,,7,7
2019-05-19 00:02,HGH,1735,737-800,25,4,28,3,3,28,,,,,3,3
2019-05-18 23:56,URC,5625,737-800,16,4,4,4,4,18,,,,,-12,2
2019-05-18 23:55,HRB,1433,737-800,15,3,24,4,3,25,,,,,9,10
2019-05-18 23:53,XIY,1547,737-800,23,6,30,6,6,30,,,,,7,7
2019-05-18 23:39,HAK,1795,737-800,30,4,36,4,4,36,,,,,6,6
2019-05-18 23:38,CGO,1586,737-800,25,4,26,4,4,26,,,,,1,1
2019-05-18 23:35,URC,5611,737-800,16,6,26,6,6,22,,,,,10,6
2019-05-18 23:33,MIG,5407,737-800,21,4,29,4,5,29,,,,,8,8
2019-05-18 23:29,TYN,1495,737-800,20,4,25,3,3,26,,,,,5,6
2019-05-18 23:27,XIY,5416,737-800,24,6,28,6,8,28,,,,,4,4
2019-05-18 23:24,CGO,205U,737-800,22,4,28,4,4,29,,,,,6,7
2019-05-18 23:23,HAK,1793,737-800,32,9,37,5,5,32,,,,,5,0
2019-05-18 23:15,FOC,1435,737-800,24,5,28,5,5,29,,,,,4,5
2019-05-18 23:14,CKG,1538,737-800,25,3,26,4,3,25,,,,,1,0
2019-05-18 23:10,HAK,5135,737-800,32,9,37,6,6,36,,,,,5,4
2019-05-18 23:00,URC,2157,737-800,18,4,20,4,4,20,,,,,2,2
2019-05-18 22:56,HGH,1727,737-800,25,5,31,4,4,28,,,,,6,3
2019-05-18 22:54,HGH,1786,737-800,24,4,30,4,4,27,,,,,6,3
2019-05-18 22:51,HRB,1351,737-800,13,4,28,4,4,20,,,,,15,7
2019-05-18 22:50,HRB,1559,737-800,12,3,28,3,3,24,,,,,16,12
2019-05-18 22:34,SYX,7618,737-800,30,5,30,6,5,34,,,,,0,4
2019-05-18 22:34,URC,1323,737-800,17,2,23,3,3,24,,,,,6,7
2019-05-18 22:31,ZGC,7175,737-800,10,4,21,6,5,20,,,,,11,10
2019-05-18 22:29,SYX,6808,737-800,31,6,36,5,5,35,,,,,5,4
2019-05-18 22:28,SYX,6808,737-800,31,6,36,5,5,35,,,,,5,4
2019-05-18 22:18,PEK,5687,737-800,20,4,27,3,3,27,,,,,7,7
2019-05-18 22:09,HAK,5137,737-800,29,8,32,4,4,36,,,,,3,7
2019-05-18 22:04,XNN,1548,737-800,10,4,20,4,4,22,,,,,10,12
2019-05-18 21:53,MIG,5409,737-800,25,4,28,5,6,29,,,,,3,4
2019-05-18 21:50,PEK,1103,737-800,15,4,28,4,4,28,,,,,13,13
2019-05-18 21:45,PEK,1927,737-800,21,3,24,5,3,26,,,,,3,5
2019-05-18 21:37,XNN,5852,737-800,10,5,20,5,5,20,,,,,10,10
2019-05-18 20:34,HAK,5417,737-800,30,7,34,6,5,33,,,,,4,3
2019-05-18 20:18,HAK,206H,737-800,29,3,31,3,4,32,,,,,2,3
2019-05-18 20:15,HAK,1372,737-800,29,5,35,4,4,34,,,,,6,5
2019-05-18 19:37,URC,1568,737-800,20,6,24,6,6,22,,,,,4,2
2019-05-18 19:35,HAK,5359,737-800,32,10,40,5,5,34,,,,,8,2
2019-05-18 17:49,YIH,1906,737-800,22,8,30,5,6,30,,,,,8,8
2019-05-18 17:44,HRB,1351,737-800,13,5,30,4,5,21,,,,,17,8
2019-05-18 17:23,SZX,5620,737-800,32,6,34,5,5,34,,,,,2,2
2019-05-18 16:51,URC,2159,737-800,25,8,20,2,2,20,,,,,-5,-5
2019-05-18 16:39,PEK,5735,737-800,23,5,25,4,5,27,,,,,2,4
2019-05-18 14:36,CGO,1587,737-800,23,2,29,3,5,29,,,,,6,6
2019-05-18 13:40,ÐìÖÝ,7991,737-800,25,7,30,8,7,29,,,,,5,4
2019-05-18 09:43,HAK,5417,737-800,28,5,33,4,3,32,,,,,5,4
2019-05-18 09:37,HAK,5638,737-800,38,6,37,5,5,36,,,,,-1,-2
2019-05-18 09:11,HAK,5466,737-800,30,7,32,8,8,30,,,,,2,0
2019-05-18 08:57,SZX,5620,737-800,28,7,32,4,5,32,,,,,4,4
2019-05-18 08:39,CAN,1783,737-800,30,3,24,4,4,31,,,,,-6,1
2019-05-18 08:31,PEK,1492,737-800,20,3,28,3,3,29,,,,,8,9
2019-05-18 08:21,XIY,1163,737-800,23,2,26,2,2,27,,,,,3,4
2019-05-18 07:44,KMG,6016,737-800,20,4,28,4,4,27,,,,,8,7
2019-05-18 07:30,XMN,1545,737-800,20,7,26,5,4,25,,,,,6,5
2019-05-18 07:21,PEK,5371,737-800,22,6,26,5,6,28,,,,,4,6
2019-05-18 07:14,PEK,1489,737-800,20,4,28,4,4,28,,,,,8,8
2019-05-18 06:54,HGH,5405,737-800,26,4,26,5,4,30,,,,,0,4
2019-05-18 06:51,SYX,1997,737-800,29,6,30,4,4,32,,,,,1,3
2019-05-18 06:38,HAK,6103,737-800,28,6,36,6,6,36,,,,,8,8
2019-05-18 06:37,¹ãÖÝ,5502,737-800,29,8,36,6,6,34,,,,,7,5
2019-05-18 06:36,URC,2159,737-800,11,7,22,2,2,18,,,,,11,7
2019-05-18 06:10,HAK,5418,737-800,30,6,30,6,6,36,,,,,0,6
2019-05-18 06:06,FOC,7113,737-800,24,4,31,4,4,30,,,,,7,6
2019-05-18 05:58,URC,6268,737-800,11,3,28,4,5,22,,,,,17,11
2019-05-18 05:57,¹ãÖÝ,1215,737-800,28,4,34,5,5,35,,,,,6,7
2019-05-18 05:56,HAK,5623,737-800,30,6,34,6,6,34,,,,,4,4
2019-05-18 05:45,TYN,5090,737-800,22,3,24,3,2,23,,,,,2,1
2019-05-18 05:32,CAN,5713,737-800,30,6,28,7,7,32,,,,,-2,2
2019-05-18 05:14,HAK,1929,737-800,29,6,37,2,2,30,,,,,8,1
2019-05-18 05:14,HHA,5439,737-800,25,4,30,4,4,28,,,,,5,3
2019-05-18 05:14,KMG,7989,737-800,20,5,29,5,5,28,,,,,9,8
2019-05-18 05:08,URC,5636,737-800,7,6,24,7,8,27,,,,,17,20
2019-05-18 05:06,PEK,1130,737-800,20,3,30,3,3,25,,,,,10,5
2019-05-18 05:04,HAK,6060,737-800,27,6,36,6,5,34,,,,,9,7
2019-05-18 05:02,CTU,7992,737-800,25,7,29,6,6,32,,,,,4,7
2019-05-18 04:59,CKG,5709,737-800,20,6,34,9,8,34,1,1,,11,14,14
2019-05-18 04:59,CKG,5709,737-800,20,3,28,8,8,30,,,,,8,10
2019-05-18 04:58,URC,6995,737-800,9,4,20,5,5,21,,,,,11,12
2019-05-18 04:52,URC,2157,737-800,9,7,26,8,6,22,,,,,17,13
2019-05-18 04:44,CAN,5521,737-800,28,4,30,6,4,30,,,,,2,2
2019-05-18 04:43,XIY,5180,737-800,20,6,30,6,6,26,,,,,10,6
2019-05-18 04:29,URC,1323,737-800,10,4,22,3,3,23,,,,,12,13
2019-05-18 04:28,URC,1496,737-800,8,6,24,5,5,26,,,,,16,18
2019-05-18 04:23,URC,5712,737-800,13,2,18,4,2,18,,,,,5,5
2019-05-18 04:21,XIY,1902,737-800,22,4,26,4,4,26,,,,,4,4
2019-05-18 04:19,CGO,1372,737-800,25,5,29,4,4,28,,,,,4,3
2019-05-18 04:17,HAK,5483,737-800,29,8,36,5,5,35,,,,,7,6
2019-05-18 04:15,XIY,1348,737-800,22,4,28,3,4,29,,,,,6,7
2019-05-18 04:15,CKG,1538,737-800,25,3,32,2,2,30,,,,,7,5
2019-05-18 04:15,PEK,5428,737-800,20,4,28,4,5,29,,,,,8,9
2019-05-18 04:14,HAK,5465,737-800,29,8,36,6,7,36,,,,,7,7
2019-05-18 04:11,XIY,5115,737-800,20,4,21,4,4,18,,,,,1,-2
2019-05-18 04:09,PEK,5662,737-800,21,2,30,3,5,30,,,,,9,9
2019-05-18 04:08,DLC,1787,737-800,18,2,25,1,1,24,,,,,7,6
2019-05-18 04:05,ZGC,1493,737-800,15,6,22,7,7,21,,,,,7,6
2019-05-18 04:04,ZGC,1493,737-800,15,0,0,0,0,0,,,,,-15,-15
2019-05-18 04:03,DLC,1505,737-800,18,4,28,4,3,25,,,,,10,7
2019-05-18 04:03,À¼ÖÝ,5163,737-800,20,3,21,2,2,20,,,,,1,0
2019-05-18 03:57,TYN,1375,737-800,23,4,26,4,5,24,,,,,3,1
2019-05-18 03:55,CGO,7167,737-800,23,5,28,5,4,27,,,,,5,4
2019-05-18 03:54,FOC,1906,737-800,23,5,27,5,4,28,,,,,4,5
2019-05-18 03:53,XIY,1480,737-800,22,4,24,4,4,25,,,,,2,3
2019-05-18 03:53,DLC,1547,737-800,19,4,22,5,5,25,,,,,3,6
2019-05-18 03:50,DLC,1141,737-800,20,6,30,6,6,28,,,,,10,8
2019-05-18 03:50,CAN,1213,737-800,29,8,36,7,7,32,,,,,7,3
2019-05-18 03:48,FOC,6061,737-800,25,4,31,4,4,30,,,,,6,5
2019-05-18 03:47,ZGC,1568,737-800,15,5,26,6,6,24,,,,,11,9
2019-05-18 03:47,FOC,7105,737-800,25,5,28,5,5,26,,,,,3,1
2019-05-18 03:38,SHE,1491,737-800,20,6,28,5,5,28,,,,,8,8
2019-05-18 03:34,URC,5661,737-800,13,4,22,4,4,22,,,,,9,9
2019-05-18 03:32,SZX,1503,737-800,28,3,35,3,4,34,,,,,7,6
2019-05-18 03:31,XIY,5116,737-800,23,4,22,4,5,23,,,,,-1,0
2019-05-18 03:29,XIY,1903,737-800,24,2,26,2,3,28,,,,,2,4
2019-05-18 03:26,URC,1569,737-800,8,3,23,3,3,20,,,,,15,12
2019-05-18 03:24,HHA,5480,737-800,25,4,28,4,4,20,,,,,3,-5
2019-05-18 03:19,SZX,1541,737-800,29,6,36,7,6,37,,,,,7,8
2019-05-18 03:18,KMG,5732,737-800,20,2,24,3,3,22,,,,,4,2
2019-05-18 03:17,DLC,1346,737-800,25,6,30,4,6,25,,,,,5,0
2019-05-18 03:08,XMN,1545,737-800,20,7,28,4,4,25,,,,,8,5
2019-05-18 03:08,HHA,6066,737-800,25,4,28,2,3,30,,,,,3,5
2019-05-18 03:05,XMN,6062,737-800,26,4,37,5,4,36,,,,,11,10
2019-05-18 03:05,XMN,1490,737-800,20,5,28,6,4,29,,,,,8,9
2019-05-18 03:00,SZX,1733,737-800,30,4,34,4,4,32,,,,,4,2
2019-05-18 03:00,KMG,7988,737-800,20,5,27,6,6,26,,,,,7,6
2019-05-18 02:59,PEK,1927,737-800,20,4,24,6,4,26,,,,,4,6
2019-05-18 02:55,SHA,5481,737-800,23,6,28,6,5,29,,,,,5,6
2019-05-18 02:55,PEK,7377,737-800,21,6,27,6,5,28,,,,,6,7
2019-05-18 02:52,SZX,1549,737-800,28,6,37,6,6,32,,,,,9,4
2019-05-18 02:52,À¥Ã÷,1588,737-800,20,3,25,5,5,24,,,,,5,4
2019-05-18 02:46,HRB,1562,737-800,22,2,30,3,2,32,,,,,8,10
2019-05-18 02:46,URC,5611,737-800,10,6,20,5,6,20,,,,,10,10
2019-05-18 02:39,SYX,206F,737-800,30,4,34,4,3,31,,,,,4,1
2019-05-18 02:39,CGO,1208,737-800,24,3,28,6,7,20,,,,,4,-4
2019-05-18 02:36,CAN,5520,737-800,26,6,35,8,6,36,1,1,,11,9,10
2019-05-18 02:29,SYX,6808,737-800,30,4,36,6,4,34,,,,,6,4
2019-05-18 02:28,HHA,5733,737-800,22,6,30,6,6,31,,,,,8,9
2019-05-18 02:26,PEK,5467,737-800,21,1,30,3,1,24,,,,,9,3
2019-05-18 02:21,CAN,1497,737-800,28,4,34,4,4,34,,,,,6,6
2019-05-18 02:21,HHA,6065,737-800,25,4,30,5,5,32,,,,,5,7
2019-05-18 02:20,HHA,5581,737-800,25,5,24,6,4,30,,,,,-1,5
2019-05-18 02:18,HGH,5137,737-800,25,2,23,2,2,30,,,,,-2,5
2019-05-18 02:13,MIG,5409,737-800,20,4,27,5,5,28,,,,,7,8
2019-05-18 02:12,CAN,5853,737-800,28,4,34,4,5,34,,,,,6,6
2019-05-18 02:10,URC,205T,737-800,11,2,22,1,1,20,,,,,11,9
2019-05-18 02:03,CAN,5502,737-800,29,8,36,6,6,34,,,,,7,5
2019-05-18 02:02,HHA,5795,737-800,25,5,26,5,5,26,,,,,1,1
2019-05-18 02:00,XMN,6062,737-800,26,4,36,5,4,36,1,1,,11,10,10
2019-05-18 02:00,XMN,1490,737-800,20,5,28,6,4,29,,,,,8,9
2019-05-18 01:55,HHA,1347,737-800,27,4,32,4,4,30,,,,,5,3
2019-05-18 01:52,XIY,1161,737-800,24,3,30,4,3,26,,,,,6,2
2019-05-18 01:47,503,1102,737-800,29,2,34,4,4,37,,,,,5,8
2019-05-18 01:37,XIY,5375,737-800,24,0,22,4,4,26,,,,,-2,2
2019-05-18 01:36,SYX ,7618,737-800,29,6,34,6,6,34,,,,,5,5
2019-05-18 01:35,SYX,5337,737-800,30,6,36,8,6,36,,,,,6,6
2019-05-18 01:29,FOC,1905,737-800,24,4,30,4,4,26,,,,,6,2
2019-05-18 01:28,FOC,1905,737-800,24,4,32,4,4,27,,,,,8,3
2019-05-18 01:27,SZX,5687,737-800,29,3,30,3,3,35,,,,,1,6
2019-05-18 01:26,HHA,6063,737-800,25,5,30,5,6,25,,,,,5,0
2019-05-18 01:25,XIY,1797,737-800,23,5,24,4,4,26,,,,,1,3
2019-05-18 01:23,HAK,1727,737-800,29,4,36,4,5,33,,,,,7,4
2019-05-18 01:22,HAK,5465,737-800,29,7,38,6,7,36,,,,,9,7
2019-05-18 01:21,HGH,1729,737-800,28,3,24,4,4,25,,,,,-4,-3
2019-05-18 01:16,CAN,5408,737-800,29,8,36,4,5,32,,,,,7,3
2019-05-18 01:16,CAN,1215,737-800,28,4,34,5,5,35,,,,,6,7
2019-05-18 01:14,FOC,5430,737-800,26,6,36,6,6,37,,,,,10,11
2019-05-18 01:14,XIY,1482,737-800,22,4,30,6,6,26,,,,,8,4
2019-05-18 01:10,PEK,5372,737-800,22,8,28,8,8,26,,,,,6,4
2019-05-18 01:04,HAK,1793,737-800,29,6,36,6,6,33,,,,,7,4
2019-05-18 01:02,YIH,1435,737-800,29,6,35,7,6,29,,,,,6,0
2019-05-18 01:01,KMG,1798,737-800,27,7,27,8,7,23,,,,,0,-4
2019-05-18 00:59,SYX,1498,737-800,30,4,35,4,4,33,,,,,5,3
2019-05-18 00:55,HAK,1501,737-800,29,5,32,4,4,33,,,,,3,4
2019-05-18 00:55,XIY,7172,737-800,26,6,29,4,4,30,,,,,3,4
2019-05-18 00:54,FOC,5182,737-800,25,6,28,6,6,30,,,,,3,5
2019-05-18 00:51,HRB,1433,737-800,21,3,24,4,4,20,,,,,3,-1
2019-05-18 00:51,URC,5637,737-800,10,3,22,3,3,19,,,,,12,9
2019-05-18 00:49,XIY,5346,737-800,20,4,30,4,4,28,,,,,10,8
2019-05-18 00:44,URC,1996,737-800,9,4,20,5,5,22,,,,,11,13
2019-05-18 00:44,DLC,5338,737-800,20,2,18,2,3,23,,,,,-2,3
2019-05-18 00:44,PEK,1131,737-800,20,4,30,4,4,30,,,,,10,10
2019-05-18 00:42,KHG,206P,737-800,17,3,21,4,3,20,,,,,4,3
2019-05-18 00:39,HRB,1559,737-800,23,2,31,2,2,24,,,,,8,1
2019-05-18 00:35,ZGC,5358,737-800,15,6,24,6,7,25,,,,,9,10
2019-05-18 00:35,URC,7171,737-800,10,2,20,3,4,21,,,,,10,11
2019-05-18 00:34,DLC,1101,737-800,20,2,30,2,2,24,,,,,10,4
2019-05-18 00:33,XIY,1542,737-800,23,4,28,4,4,28,,,,,5,5
2019-05-18 00:32,TYN,206G,737-800,20,3,22,3,4,23,,,,,2,3
2019-05-18 00:31,CTU,1487,737-800,24,4,22,4,3,26,,,,,-2,2
2019-05-18 00:31,MIG,6809,737-800,20,5,28,6,6,28,,,,,8,8
2019-05-18 00:30,HAK,5429,737-800,29,8,37,9,9,37,,,,,8,8
2019-05-18 00:25,504,1728,737-800,29,4,37,5,5,29,,,,,8,0
2019-05-18 00:17,SZX,1785,737-800,29,3,35,7,7,36,,,,,6,7
2019-05-18 00:15,URC,1322,737-800,10,4,22,4,4,22,,,,,12,12
2019-05-18 00:14,CGO,5478,737-800,24,4,28,5,4,28,,,,,4,4
2019-05-18 00:13,SZX,5522,737-800,30,6,34,6,6,36,,,,,4,6
2019-05-18 00:09,DLC,B7173,737-800,20,4,30,6,5,28,,,,,10,8
2019-05-18 00:05,SZX,1995,737-800,28,6,34,5,4,33,,,,,6,5
2019-05-18 00:01,URC,1728,737-800,10,4,24,4,4,26,,,,,14,16
2019-05-18 00:00,HGH,7616,737-800,28,2,30,4,4,30,,,,,2,2
2019-05-17 23:56,CAN,5373,737-800,28,5,31,7,7,35,,,,,3,7
2019-05-17 23:54,URC,1726,737-800,11,3,15,4,4,21,,,,,4,10
2019-05-17 23:52,XIY,5136,737-800,20,4,22,4,6,25,,,,,2,5
2019-05-17 23:41,XIY,7378,737-800,25,4,24,2,2,22,,,,,-1,-3
2019-05-17 23:37,HGH,7175,737-800,25,5,30,6,5,30,,,,,5,5
2019-05-17 23:35,HAK,1501,737-800,5,32,0,4,4,33,,,,,-5,28
2019-05-17 23:34,SYX,7379,737-800,30,5,36,5,4,37,,,,,6,7
2019-05-17 23:29,XIY,5416,737-800,20,4,23,3,2,22,,,,,3,2
2019-05-17 23:28,CKG,5462,737-800,25,4,29,5,4,32,,,,,4,7
2019-05-17 23:27,BAR,1795,737-800,30,4,35,3,5,34,,,,,5,4
2019-05-17 23:23,HRB,1350,737-800,20,4,28,4,5,26,,,,,8,6
2019-05-17 23:18,URC,5625,737-800,11,3,22,2,2,20,,,,,11,9
2019-05-17 23:16,DLC,1505,737-800,18,4,28,4,3,25,,,,,10,7
2019-05-17 22:59,º£¿Ú,206H,737-800,30,3,26,3,3,32,,,,,-4,2
2019-05-17 22:55,XIY,5153,737-800,25,5,26,4,4,25,,,,,1,0
2019-05-17 22:46,CGO,205U,737-800,20,4,28,5,4,28,,,,,8,8
2019-05-17 22:45,SYX,7619,737-800,31,5,30,5,6,33,,,,,-1,2
2019-05-17 22:40,XNN,5852,737-800,16,7,21,5,5,21,,,,,5,5
2019-05-17 22:32,SZX,5580,737-800,25,6,35,7,7,36,,,,,10,11
2019-05-17 22:29,HAK,7399,737-800,30,4,32,3,4,31,,,,,2,1
2019-05-17 22:26,HAK,7886,737-800,29,4,35,4,4,37,,,,,6,8
2019-05-17 22:04,TYN,1488,737-800,23,6,26,4,4,24,,,,,3,1
2019-05-17 22:02,URC,1735,737-800,13,4,22,5,4,20,,,,,9,7
2019-05-17 21:57,URC,205V,737-800,12,2,29,1,2,22,,,,,17,10
2019-05-17 21:38,XNN,1548,737-800,17,7,19,5,5,18,,,,,2,1
2019-05-17 21:36,MIG,7990,737-800,20,2,28,3,4,28,,,,,8,8
2019-05-17 21:35,DLC,7400,737-800,19,5,27,5,5,28,,,,,8,9
2019-05-17 21:35,ZGC,5135,737-800,15,6,21,7,6,20,,,,,6,5
2019-05-17 21:18,TYN,1495,737-800,25,6,26,4,4,24,,,,,1,-1
2019-05-17 20:53,CGO,7993,737-800,27,5,29,4,5,25,,,,,2,-2
2019-05-17 20:31,FOC,7113,737-800,24,4,30,4,4,31,,,,,6,7
2019-05-17 20:18,HAK,5089,737-800,32,8,32,6,6,36,,,,,0,4
2019-05-17 19:48,FOC,1209,737-800,24,4,30,4,4,30,,,,,6,6
2019-05-17 19:34,URC,1325,737-800,15,4,22,4,4,20,,,,,7,5
2019-05-17 18:20,HAK,5405,737-800,33,8,37,6,6,36,,,,,4,3
2019-05-17 17:11,PEK ,5372,737-800,25,6,28,7,7,30,,,,,3,5
2019-05-17 16:48,XUZ,7991,737-800,23,6,32,6,6,30,,,,,9,7
2019-05-17 15:35,YIH,7395,737-800,33,6,26,8,7,29,,,,,-7,-4
2019-05-17 14:21,PEK,5539,737-800,31,4,27,4,4,24,,,,,-4,-7
2019-05-17 11:20,CTU,7992,737-800,25,7,20,8,7,30,,,,,-5,5
2019-05-17 11:13,XIY,5467,737-800,30,2,28,4,2,24,,,,,-2,-6
2019-05-17 10:57,HAK,1483,737-800,34,8,30,6,7,31,,,,,-4,-3
2019-05-17 10:26,PEK,5538,737-800,25,8,35,3,3,32,,,,,10,7
2019-05-17 09:29,SZX,1549,737-800,28,6,36,8,6,34,,,,,8,6
2019-05-17 09:03,PEK,5136,737-800,25,7,33,6,5,37,,,,,8,12
2019-05-17 08:00,KMG,7989,737-800,20,5,27,6,6,27,,,,,7,7
2019-05-17 07:59,KMG,7989,737-800,20,5,27,6,6,27,,,,,7,7
2019-05-17 07:52,ZGC ,5463,737-800,15,4,20,5,6,19,,,,,5,4
2019-05-17 07:46,KMG,5732,737-800,20,2,20,2,3,23,,,,,0,3
2019-05-17 07:39,XIY,5406,737-800,16,4,26,6,3,0,,,,,10,-16
2019-05-17 07:34,HAK,5405,737-800,29,8,36,6,5,35,,,,,7,6
2019-05-17 07:34,FOC,1559,737-800,22,4,31,3,3,30,,,,,9,8
2019-05-17 07:33,FOC,1559,737-800,22,4,34,3,3,30,,,,,12,8
2019-05-17 07:32,CGO,1208,737-800,23,3,28,3,3,26,,,,,5,3
2019-05-17 07:28,CAN,1102,737-800,30,4,36,4,5,34,,,,,6,4
2019-05-17 07:27,HAK,1386,737-800,28,3,28,3,3,28,,,,,0,0
2019-05-17 06:58,CAN,1727,737-800,28,5,35,4,4,34,,,,,7,6
2019-05-17 06:51,CAN,7886,737-800,28,4,36,4,3,36,,,,,8,8
2019-05-17 06:49,CAN,1491,737-800,30,6,36,6,6,35,,,,,6,5
2019-05-17 06:48,CAN,5521,737-800,29,4,32,4,6,30,,,,,3,1
2019-05-17 06:47,CAN,5373,737-800,29,3,33,6,6,36,,,,,4,7
2019-05-17 06:45,CAN,1373,737-800,30,4,34,4,4,33,,,,,4,3
2019-05-17 06:41,TYN,7172,737-800,23,5,28,5,4,22,,,,,5,-1
2019-05-17 06:21,XMN,5686,737-800,26,6,30,4,4,30,,,,,4,4
2019-05-17 06:20,XMN,5662,737-800,26,6,28,4,4,28,,,,,2,2
2019-05-17 06:19,XMN,5481,737-800,25,4,32,5,4,31,,,,,7,6
2019-05-17 06:19,PEK,7619,737-800,25,5,25,5,6,27,,,,,0,2
2019-05-17 06:19,XMN,6062,737-800,20,2,27,4,3,34,,,,,7,14
2019-05-17 06:11,HAK,6063,737-800,28,5,35,7,8,36,,,,,7,8
2019-05-17 05:52,PEK,6106,737-800,22,6,30,5,5,30,,,,,8,8
2019-05-17 05:47,FOC,7105,737-800,23,5,29,6,4,29,,,,,6,6
2019-05-17 05:47,PEK,5467,737-800,27,4,28,4,2,26,,,,,1,-1
2019-05-17 05:44,URC,1325,737-800,9,4,21,4,4,20,,,,,12,11
2019-05-17 05:39,XIY,5359,737-800,15,6,25,6,6,26,,,,,10,11
2019-05-17 05:30,XIY,1348,737-800,20,4,26,5,4,25,,,,,6,5
2019-05-17 05:28,HAK,5733,737-800,29,9,36,8,7,37,,,,,7,8
2019-05-17 05:27,XIY,1481,737-800,20,5,26,5,5,26,,,,,6,6
2019-05-17 05:19,PEK,5538,737-800,25,35,8,3,3,32,,,,,-17,7
2019-05-17 05:17,XIY,1480,737-800,16,4,17,3,4,16,,,,,1,0
2019-05-17 05:11,PEK,5428,737-800,26,4,29,4,3,30,,,,,3,4
2019-05-17 05:08,XIY,1163,737-800,16,2,30,3,2,28,,,,,14,12
2019-05-17 04:58,PEK,5428,737-800,23,4,29,4,3,30,,,,,6,7
2019-05-17 04:56,XIY ,1903,737-800,18,6,25,4,5,25,,,,,7,7
2019-05-17 04:54,CKG,5141,737-800,21,6,25,6,5,28,,,,,4,7
2019-05-17 04:53,PEK,5520,737-800,22,3,25,5,3,26,,,,,3,4
2019-05-17 04:51,XIY,1483,737-800,17,5,24,5,6,23,,,,,7,6
2019-05-17 04:51,FOC,1905,737-800,22,4,29,4,4,25,,,,,7,3
2019-05-17 04:46,XIY ,1482,737-800,18,6,25,4,5,25,,,,,7,7
2019-05-17 04:42,KMG,1209,737-800,20,4,28,4,4,25,,,,,8,5
2019-05-17 04:36,SYX,7618,737-800,30,6,34,6,4,34,,,,,4,4
2019-05-17 04:35,KMG,6809,737-800,20,5,23,6,6,24,,,,,3,4
2019-05-17 04:34,HAK,1487,737-800,25,3,34,3,2,32,,,,,9,7
2019-05-17 04:10,HAK,5371,737-800,30,8,36,7,8,36,,,,,6,6
2019-05-17 04:09,SYX,6808   ,737-800,28,6,34,7,8,30,,,,,6,2
2019-05-17 04:08,SYX,1372    ,737-800,28,4,36,4,4,32,,,,,8,4
2019-05-17 04:06,URC,5623,737-800,8,5,24,6,6,21,,,,,16,13
2019-05-17 04:05,FOC,1906,737-800,22,7,24,7,6,30,,,,,2,8
2019-05-17 04:03,XIY,1161,737-800,17,4,27,3,3,26,,,,,10,9
2019-05-17 04:00,CGO,7993,737-800,23,6,29,6,6,27,,,,,6,4
2019-05-17 03:59,SYX,1997,737-800,29,7,37,4,3,33,1,,,1,8,4
2019-05-17 03:55,URC,2157,737-800,11,4,21,8,9,20,,,,,10,9
2019-05-17 03:51,HHA,5581,737-800,22,6,23,5,5,27,,,,,1,5
2019-05-17 03:49,URC,1726,737-800,10,4,24,4,4,24,,,,,14,14
2019-05-17 03:48,HHA,1347,737-800,22,4,28,4,4,27,,,,,6,5
2019-05-17 03:48,URC,1929,737-800,10,4,24,4,4,24,,,,,14,14
2019-05-17 03:47,XIY,1482,737-800,17,6,30,6,6,26,,,,,13,9
2019-05-17 03:44,HGH,5540,737-800,23,5,34,5,4,30,1,,,1,11,7
2019-05-17 03:42,HGH,1729,737-800,25,4,23,4,4,24,,,,,-2,-1
2019-05-17 03:39,SZX,1995,737-800,28,6,36,6,6,36,,,,,8,8
2019-05-17 03:37,HAK,7639,737-800,28,6,36,8,7,36,,,,,8,8
2019-05-17 03:37,SZX,1733,737-800,28,2,32,3,3,31,,,,,4,3
2019-05-17 03:36,FOC,5430,737-800,23,5,31,6,6,31,,,,,8,8
2019-05-17 03:22,HAK,1793,737-800,28,4,37,4,4,32,1,,,1,9,4
2019-05-17 03:19,HRB,1562,737-800,16,4,26,3,4,26,,,,,10,10
2019-05-17 03:19,URC,5637,737-800,12,2,23,2,2,18,,,,,11,6
2019-05-17 03:18,Î÷°²,5116,737-800,16,3,22,3,4,23,,,,,6,7
2019-05-17 03:17,HRB,1350,737-800,17,4,28,4,4,24,,,,,11,7
2019-05-17 03:16,PEK,1489,737-800,30,4,28,4,4,27,,,,,-2,-3
2019-05-17 03:11,URC,5661,737-800,10,4,20,4,4,20,,,,,10,10
2019-05-17 03:11,URC,6268,737-800,11,2,26,4,5,22,,,,,15,11
2019-05-17 03:10,URC,205T,737-800,8,3,23,4,4,21,,,,,15,13
2019-05-17 03:09,FOC,5182,737-800,24,3,29,3,4,29,,,,,5,5
2019-05-17 03:08,FOC,5182,737-800,24,3,33,3,4,30,,,,,9,6
2019-05-17 03:05,HAK,5709,737-800,29,4,34,4,3,34,,,,,5,5
2019-05-17 03:04,HRB,1433,737-800,16,4,26,2,2,20,,,,,10,4
2019-05-17 03:04,XIY,5115,737-800,17,2,19,3,3,15,,,,,2,-2
2019-05-17 03:02,HAK,5429,737-800,30,4,34,6,6,36,,,,,4,6
2019-05-17 02:59,PEK,1103,737-800,30,4,30,4,5,28,,,,,0,-2
2019-05-17 02:58,KMG,1588,737-800,15,4,24,6,6,24,,,,,9,9
2019-05-17 02:57,KMG,1588,737-800,15,4,24,6,6,24,,,,,9,9
2019-05-17 02:55,CGO,7988,737-800,24,5,32,4,4,30,,,,,8,6
2019-05-17 02:53,ÃàÑô,5409,737-800,24,4,26,4,4,28,,,,,2,4
2019-05-17 02:51,º£¿Ú,1213,737-800,29,7,37,7,6,36,,,,,8,7
2019-05-17 02:50,HGH,1927,737-800,25,3,26,5,3,26,,,,,1,1
2019-05-17 02:50,HHA,6066,737-800,20,3,30,2,2,28,,,,,10,8
2019-05-17 02:50,SYX,206F,737-800,29,2,34,3,3,32,,,,,5,3
2019-05-17 02:47,HHA,5735,737-800,21,1,29,1,1,26,,,,,8,5
2019-05-17 02:45,HHA ,5480,737-800,21,4,26,5,4,17,,,,,5,-4
2019-05-17 02:44,URC,1725,737-800,10,4,26,4,4,26,,,,,16,16
2019-05-17 02:41,URC,1996,737-800,10,4,20,4,4,22,,,,,10,12
2019-05-17 02:39,SZX,1785,737-800,26,4,34,5,5,34,,,,,8,8
2019-05-17 02:38,HGH,1545,737-800,24,5,32,5,4,31,,,,,8,7
2019-05-17 02:38,FOC,7377,737-800,22,6,30,6,6,30,,,,,8,8
2019-05-17 02:34,SZX,5417,737-800,28,6,36,5,5,34,,,,,8,6
2019-05-17 02:28,URC ,1322,737-800,11,3,23,4,4,23,,,,,12,12
2019-05-17 02:22,SYX,5408,737-800,29,7,36,6,6,34,,,,,7,5
2019-05-17 02:19,104,1490,737-800,24,3,30,4,5,28,,,,,6,4
2019-05-17 02:18,HAK,5089,737-800,25,7,24,3,2,25,,,,,-1,0
2019-05-17 02:13,URC,6995,737-800,13,4,24,5,4,20,,,,,11,7
2019-05-17 02:10,XIY,1902,737-800,16,4,26,4,4,24,,,,,10,8
2019-05-17 02:06,HAK,5797,737-800,29,5,30,6,5,32,,,,,1,3
2019-05-17 02:06,KMG ,7911,737-800,18,5,26,5,4,25,,,,,8,7
2019-05-17 02:04,TYN,5099,737-800,20,2,25,2,2,22,,,,,5,2
2019-05-17 02:03,HAK,7616,737-800,28,4,34,4,5,34,,,,,6,6
2019-05-17 02:02,XIY,1542,737-800,15,2,28,4,2,30,,,,,13,15
2019-05-17 02:02,XIY,1797,737-800,15,4,30,2,2,26,,,,,15,11
2019-05-17 02:01,TYN,6060,737-800,20,5,26,6,6,25,,,,,6,5
2019-05-17 01:56,ÃàÑô,7990,737-800,24,3,28,3,3,27,,,,,4,3
2019-05-17 01:54,URC,5712,737-800,10,2,18,5,2,18,,,,,8,8
2019-05-17 01:53,XIY ,5416,737-800,18,7,26,6,6,24,,,,,8,6
2019-05-17 01:53,PEK,5439,737-800,24,4,28,4,4,28,,,,,4,4
2019-05-17 01:52,CGO,1587,737-800,25,3,29,3,4,29,,,,,4,4
2019-05-17 01:49,URC,5137,737-800,8,2,12,2,2,20,,,,,4,12
2019-05-17 01:45,PEK,5580,737-800,27,6,30,5,6,28,,,,,3,1
2019-05-17 01:44,HAK,5483,737-800,28,6,36,6,6,38,,1,,1,8,10
2019-05-17 01:43,XIY,5153,737-800,17,4,27,4,4,26,,,,,10,9
2019-05-17 01:42,ZGC,5135,737-800,15,7,25,4,3,22,,,,,10,7
2019-05-17 01:40,DLC,6061,737-800,21,4,26,4,4,26,,,,,5,5
2019-05-17 01:40,SYX,1215,737-800,28,3,33,2,2,35,,,,,5,7
2019-05-17 01:39,DLC,1141,737-800,22,6,27,6,6,26,,,,,5,4
2019-05-17 01:38,HAK,5479,737-800,29,8,34,6,8,36,,,,,5,7
2019-05-17 01:37,URC,6995,737-800,13,4,24,5,4,20,,,,,11,7
2019-05-17 01:35,HGH,5358,737-800,25,6,28,6,6,30,,,,,3,5
2019-05-17 01:35,HGH,7175,737-800,22,5,30,6,4,30,,,,,8,8
2019-05-17 01:31,HHA,5478,737-800,20,2,20,4,4,20,,,,,0,0
2019-05-17 01:25,HHA,1783,737-800,22,4,32,4,4,31,1,,,1,10,9
2019-05-17 01:19,HHA,5638,737-800,21,4,28,4,4,28,,,,,7,7
2019-05-17 01:14,HAK,5502,737-800,30,8,35,6,5,34,,,,,5,4
2019-05-17 01:14,SZX,5466,737-800,28,8,31,9,9,35,,,,,3,7
2019-05-17 01:13,103,5338,737-800,25,3,28,3,3,29,,,,,3,4
2019-05-17 01:12,SYX,7379,737-800,28,4,36,4,4,36,,,,,8,8
2019-05-17 01:11,URC,1496,737-800,8,5,26,5,5,25,,,,,18,17
2019-05-17 01:10,HGH,1501,737-800,23,4,31,4,3,27,,,,,8,4
2019-05-17 01:02,YIH,1351,737-800,24,4,30,4,4,30,,,,,6,6
2019-05-17 01:01,XIY,5180,737-800,18,6,30,6,6,28,,,,,12,10
2019-05-17 00:58,HAK,5853,737-800,29,6,34,6,6,30,,,,,5,1
2019-05-17 00:55,DLC,1375,737-800,17,4,26,4,4,24,,,,,9,7
2019-05-17 00:51,TYN,206G,737-800,20,4,26,4,4,25,,,,,6,5
2019-05-17 00:41,HAK,1130,737-800,30,2,37,4,3,36,1,,,1,7,6
2019-05-17 00:41,HAK,5687,737-800,30,6,32,8,7,32,,,,,2,2
2019-05-17 00:41,´óÁ¬,1787,737-800,17,3,26,4,4,26,,,,,9,9
2019-05-17 00:32,ÃàÑô,5449,737-800,25,5,28,5,5,27,,,,,3,2
2019-05-17 00:29,KHG,1570,737-800,17,4,21,4,5,19,,,,,4,2
2019-05-17 00:26,SZX,1541,737-800,28,5,35,6,5,36,,,,,7,8
2019-05-17 00:24,Î÷°²,7378,737-800,17,7,29,5,5,28,,,,,12,11
2019-05-17 00:18,URC,5625,737-800,10,4,24,4,4,20,,,,,14,10
2019-05-17 00:17,HAK,5855,737-800,28,6,32,4,4,30,,,,,4,2
2019-05-17 00:15,CGO,1586,737-800,24,4,28,4,6,28,,,,,4,4
2019-05-17 00:15,KMG,1798,737-800,25,6,25,6,7,26,,,,,0,1
2019-05-17 00:10,URC,5611,737-800,15,6,24,5,6,22,,,,,9,7
2019-05-17 00:09,URC,5636,737-800,9,5,22,5,4,23,,,,,13,14
2019-05-17 00:06,CAN,1795,737-800,30,4,34,5,5,34,,,,,4,4
2019-05-17 00:04,HAK,7167,737-800,29,6,34,7,6,34,,,,,5,5
2019-05-17 00:03,CKG,1538,737-800,23,2,28,3,3,28,,,,,5,5
2019-05-16 23:55,HAK,7399,737-800,29,4,34,5,3,31,,,,,5,2
2019-05-16 23:53,CGO,7398,737-800,25,5,30,4,4,30,,,,,5,5
2019-05-16 23:45,DLC,7400,737-800,21,6,26,4,4,26,,,,,5,5
2019-05-16 23:42,SYX,5337,737-800,28,4,36,5,5,35,,,,,8,7
2019-05-16 23:39,URC,1568,737-800,10,4,24,4,4,20,,,,,14,10
2019-05-16 23:38,PEK,7171,737-800,28,4,26,3,3,28,,,,,-2,0
2019-05-16 23:34,CGO,5522,737-800,25,5,30,9,9,30,,,,,5,5
2019-05-16 23:31,HGH,1786,737-800,24,4,30,4,4,28,,,,,6,4
2019-05-16 23:29,MIG,5407,737-800,25,4,28,5,4,28,,,,,3,3
2019-05-16 23:29,CAN,1497,737-800,31,4,36,4,4,35,,,,,5,4
2019-05-16 23:10,URC,7198,737-800,12,3,22,4,4,20,,,,,10,8
2019-05-16 22:53,XNN,5852,737-800,15,4,20,4,4,20,,,,,5,5
2019-05-16 22:51,DLC,1505,737-800,17,3,28,3,3,26,,,,,11,9
2019-05-16 22:46,XNN,1131,737-800,15,5,20,5,5,20,,,,,5,5
2019-05-16 22:31,HAK,206H,737-800,29,5,35,3,2,34,,,,,6,5
2019-05-16 22:29,XNN,5853,737-800,15,4,20,4,4,20,,,,,5,5
2019-05-16 22:28,CKG,5462,737-800,24,4,30,4,4,30,,,,,6,6
2019-05-16 22:16,PEK,1492,737-800,27,4,30,2,2,28,,,,,3,1
2019-05-16 22:13,HAK,1548,737-800,29,4,34,5,4,31,,,,,5,2
2019-05-16 22:05,DLC,5138,737-800,21,4,26,4,4,26,,,,,5,5
2019-05-16 21:54,URC,1323,737-800,10,2,22,2,2,22,,,,,12,12
2019-05-16 21:44,ZGC,1498,737-800,15,7,22,8,7,23,,,,,7,8
2019-05-16 21:43,URC,206P,737-800,10,4,22,5,5,20,,,,,12,10
2019-05-16 21:42,HAK,1503,737-800,30,3,36,4,5,32,,,,,6,2
2019-05-16 21:38,DLC,1346,737-800,21,6,27,4,6,26,,,,,6,5
2019-05-16 21:27,TYN,1495,737-800,25,4,24,4,5,24,,,,,-1,-1
2019-05-16 20:56,PEK,5579,737-800,28,6,34,6,6,30,,,,,6,2
2019-05-16 20:35,DLC,7173,737-800,22,6,28,4,4,26,,,,,6,4
2019-05-16 20:14,KMG,7989,737-800,33,5,27,6,6,27,,,,,-6,-6
2019-05-16 19:58,HAK,5082,737-800,32,9,37,8,8,36,1,,É¢ÈÈÆ÷À©É¢¹ÜÆÆËð,1É¢ÈÈÆ÷À©É¢¹ÜÆÆËð,5,4
2019-05-16 19:54,HAK,5465,737-800,31,7,36,7,6,37,,,,,5,6
2019-05-16 19:48,URC,205V,737-800,13,5,28,4,5,22,,,,,15,9
2019-05-16 19:47,HGH,1502,737-800,23,3,30,3,4,30,,,,,7,7
2019-05-16 17:30,URC,1569,737-800,13,2,24,2,2,22,,,,,11,9
2019-05-16 17:24,YIH,7395,737-800,26,6,30,6,6,30,,,,,4,4
2019-05-16 16:40,HHA,6066,737-800,23,3,28,4,3,27,,,,,5,4
2019-05-16 14:30,XUZ,6800,737-800,25,4,30,4,4,28,,,,,5,3
2019-05-16 11:43,XIY,5375,737-800,24,1,24,4,3,25,,,,,0,1
2019-05-16 11:05,CTU,7992,737-800,25,3,30,8,6,26,,,,,5,1
2019-05-16 08:22,ZGC ,1493,737-800,15,5,21,7,8,20,,,,,6,5
2019-05-16 08:20,ZGC ,5580,737-800,15,5,22,6,7,19,,,,,7,4
2019-05-16 08:15,HHA,5478,737-800,21,3,28,3,2,25,,,,,7,4
2019-05-16 08:10,PEK,5406,737-800,25,4,28,4,8,36,,1,,1,3,11
2019-05-16 08:08,DLC,5138,737-800,20,6,26,4,4,28,,,,,6,8
2019-05-16 08:07,CGO,5465,737-800,20,3,26,4,3,28,,,,,6,8
2019-05-16 07:46,HAK,1542,737-800,28,2,32,3,3,31,,,,,4,3
2019-05-16 07:31,XMN,5135,737-800,25,8,35,3,3,32,1,,,1,10,7
2019-05-16 07:30,XMN,5686,737-800,25,6,28,6,6,29,,,,,3,4
2019-05-16 07:30,XMN,1489,737-800,25,6,32,7,6,30,,,,,7,5
2019-05-16 07:29,XMN,1735,737-800,26,4,32,4,4,28,,,,,6,2
2019-05-16 06:59,PEK,1727,737-800,21,6,30,6,6,26,,,,,9,5
2019-05-16 06:57,FOC,1906,737-800,23,6,32,6,5,30,,,,,9,7
2019-05-16 06:57,HHA,5581,737-800,20,4,20,4,4,26,,,,,0,6
2019-05-16 06:56,FOC,1906,737-800,23,6,34,6,6,32,,,,,11,9
2019-05-16 06:56,CKG,5141,737-800,20,2,22,6,6,26,,,,,2,6
2019-05-16 06:33,KMG,7990,737-800,20,3,26,4,4,24,,,,,6,4
2019-05-16 06:29,PEK,7171,737-800,20,4,25,5,5,25,,,,,5,5
2019-05-16 06:20,HAK,206H,737-800,27,3,32,4,4,32,,,,,5,5
2019-05-16 06:14,SZC,1386,737-800,28,4,34,3,3,32,,,,,6,4
2019-05-16 05:39,URC,205T,737-800,10,3,24,3,3,25,,,,,14,15
2019-05-16 05:37,URC,6995,737-800,10,4,24,5,5,22,,,,,14,12
2019-05-16 05:37,URC,5636,737-800,12,6,28,8,6,27,,,,,16,15
2019-05-16 05:37,URC,1323,737-800,8,4,22,4,4,21,,,,,14,13
2019-05-16 05:36,URC,1325,737-800,11,4,14,5,7,19,,,,,3,8
2019-05-16 05:36,URC,5661,737-800,11,4,21,4,6,24,,,,,10,13
2019-05-16 05:35,URC,5797,737-800,11,4,24,4,6,24,,,,,13,13
2019-05-16 05:34,URC,1568,737-800,12,6,27,5,6,23,,,,,15,11
2019-05-16 05:32,HGH,1498,737-800,22,5,31,4,4,28,,,,,9,6
2019-05-16 05:26,XIY,5346,737-800,20,4,26,4,4,26,,,,,6,6
2019-05-16 05:09,HAK,5502,737-800,25,4,36,4,5,32,1,,,1,11,7
2019-05-16 05:04,HAK,5467,737-800,28,6,33,6,3,31,,,,,5,3
2019-05-16 04:44,PEK,5439,737-800,20,4,24,4,4,24,,,,,4,4
2019-05-16 04:43,CAN,1491,737-800,29,4,36,6,5,36,,,,,7,7
2019-05-16 04:34,TYN,6060,737-800,15,5,24,4,4,22,,,,,9,7
2019-05-16 04:31,PEK,5538,737-800,20,8,33,3,3,34,1,1,,11,13,14
2019-05-16 04:31,HHA,6066,737-800,19,3,28,2,2,27,,,,,9,8
2019-05-16 04:25,KMG,7167,737-800,19,5,26,6,6,25,,,,,7,6
2019-05-16 04:25,PEK,7619,737-800,20,4,26,4,4,24,,,,,6,4
2019-05-16 04:18,XIY,1797,737-800,24,3,23,4,3,25,,,,,-1,1
2019-05-16 04:11,XIY,1161,737-800,21,4,28,3,3,24,,,,,7,3
2019-05-16 04:10,XIY,5116,737-800,22,5,25,5,4,24,,,,,3,2
2019-05-16 04:08,FOC,5712,737-800,21,2,27,0,0,0,,,,,6,-21
2019-05-16 04:04,SYX,5522,737-800,30,6,36,6,6,35,,,,,6,5
2019-05-16 04:01,HAK,5429,737-800,26,4,30,7,6,33,,,,,4,7
2019-05-16 03:54,W112,5483,737-800,22,4,30,5,4,28,,,,,8,6
2019-05-16 03:53,FOC,5712,737-800,25,1,26,1,1,27,,,,,1,2
2019-05-16 03:51,ÃàÑô,6809,737-800,22,6,26,5,6,26,,,,,4,4
2019-05-16 03:40,HAK,1785,737-800,27,3,34,3,2,30,,,,,7,3
2019-05-16 03:39,XIY,1902,737-800,21,3,28,4,4,24,,,,,7,3
2019-05-16 03:38,KMG,1798,737-800,20,6,24,5,5,23,,,,,4,3
2019-05-16 03:34,XIY,5735,737-800,30,4,24,3,3,24,,,,,-6,-6
2019-05-16 03:34,XIY,5182,737-800,24,2,26,3,2,25,,,,,2,1
2019-05-16 03:33,XIY,1348,737-800,22,4,24,6,7,22,,,,,2,0
2019-05-16 03:31,KMG,7988,737-800,19,4,28,5,4,26,,,,,9,7
2019-05-16 03:26,FOC,1480,737-800,23,4,24,4,4,24,,,,,1,1
2019-05-16 03:16,SYX,1102,737-800,30,6,36,5,4,36,,,,,6,6
2019-05-16 03:12,SYX,206F,737-800,30,3,35,4,3,35,,,,,5,5
2019-05-16 03:02,HAK,1495,737-800,26,4,34,4,5,34,,,,,8,8
2019-05-16 02:55,URC,5611,737-800,15,6,24,4,5,22,,,,,9,7
2019-05-16 02:52,URC,2159,737-800,15,5,20,2,1,18,,,,,5,3
2019-05-16 02:51,SYX,1997,737-800,29,5,34,4,4,34,,,,,5,5
2019-05-16 02:50,HAK,1793,737-800,27,6,32,6,5,36,,,,,5,9
2019-05-16 02:48,CGO,5462,737-800,20,3,26,4,4,28,,,,,6,8
2019-05-16 02:47,HHA,1492,737-800,23,3,28,4,3,27,,,,,5,4
2019-05-16 02:47,CGO,1587,737-800,21,4,28,4,4,26,,,,,7,5
2019-05-16 02:44,HAK,5137,737-800,29,5,31,5,5,32,,,,,2,3
2019-05-16 02:44,SYX,7379,737-800,30,4,35,4,4,35,,,,,5,5
2019-05-16 02:43,SHA,5620,737-800,20,3,30,2,3,26,,,,,10,6
2019-05-16 02:41,ZGC,5580,737-800,15,5,22,6,7,19,,,,,7,4
2019-05-16 02:35,HHA,1347,737-800,25,4,30,3,3,28,,,,,5,3
2019-05-16 02:34,FOC,7395,737-800,23,6,30,6,6,30,,,,,7,7
2019-05-16 02:34,XIY,6062,737-800,15,4,18,5,4,25,,,,,3,10
2019-05-16 02:33,HAK,6103,737-800,30,7,36,5,5,36,,,,,6,6
2019-05-16 02:32,SYX,7618,737-800,28,5,32,6,5,34,,,,,4,6
2019-05-16 02:30,CAN,5853,737-800,28,5,33,6,6,30,,,,,5,2
2019-05-16 02:26,HGH,1505,737-800,23,4,30,4,4,26,,,,,7,3
2019-05-16 02:25,XIY,1483,737-800,22,4,26,5,5,24,,,,,4,2
2019-05-16 02:23,XIY,5139,737-800,25,4,26,8,6,28,,,,,1,3
2019-05-16 02:23,HAK,1372,737-800,27,5,32,5,6,32,,,,,5,5
2019-05-16 02:19,XIY,1162,737-800,25,4,23,3,4,24,,,,,-2,-1
2019-05-16 02:19,XIY,5180,737-800,23,6,30,6,6,26,,,,,7,3
2019-05-16 02:14,SZX,1733,737-800,28,3,34,4,4,31,,,,,6,3
2019-05-16 02:12,PEK,5579,737-800,23,6,29,6,6,28,,,,,6,5
2019-05-16 02:11,XMN,5135,737-800,25,8,35,3,3,32,,,,,10,7
2019-05-16 02:10,XMN,1498,737-800,25,6,32,7,5,30,,,,,7,5
2019-05-16 02:09,XIY,5153,737-800,23,4,26,4,6,28,,,,,3,5
2019-05-16 02:08,XMN,1735,737-800,26,4,32,4,4,28,,,,,6,2
2019-05-16 02:07,CKG,5733,737-800,21,6,30,6,5,30,,,,,9,9
2019-05-16 02:06,SHA,1501,737-800,20,6,32,6,6,28,1,,,1,12,8
2019-05-16 02:04,CAN,5371,737-800,29,9,36,8,9,36,,,,,7,7
2019-05-16 02:01,URC,1726,737-800,20,3,24,2,2,21,,,,,4,1
2019-05-16 02:01,XIY,1903,737-800,20,2,26,2,2,28,,,,,6,8
2019-05-16 01:59,PEK,1785,737-800,22,0,29,7,8,29,,,,,7,7
2019-05-16 01:57,CKG,1215,737-800,20,3,28,2,2,28,,,,,8,8
2019-05-16 01:55,DLC,7173,737-800,20,4,26,4,4,26,,,,,6,6
2019-05-16 01:53,DLC,1346,737-800,20,4,26,4,4,24,,,,,6,4
2019-05-16 01:52,SZX,5417,737-800,28,5,31,5,4,30,,,,,3,2
2019-05-16 01:43,URC,1929,737-800,11,4,22,4,4,22,,,,,11,11
2019-05-16 01:41,DLC,7400,737-800,20,5,28,6,6,28,,,,,8,8
2019-05-16 01:40,HAK,1728,737-800,27,5,32,6,6,30,,,,,5,3
2019-05-16 01:39,HGH,1927,737-800,22,4,24,2,4,26,,,,,2,4
2019-05-16 01:37,CAN,1487,737-800,30,3,35,2,3,34,,,,,5,4
2019-05-16 01:37,CGO,1586,737-800,22,3,22,4,4,23,,,,,0,1
2019-05-16 01:36,YIH,1435,737-800,27,5,32,6,5,27,,,,,5,0
2019-05-16 01:36,FOC,5430,737-800,21,8,32,6,6,34,1,1,,11,11,13
2019-05-16 01:36,YIH,1351,737-800,27,5,28,4,5,27,,,,,1,0
2019-05-16 01:34,DLC,5359,737-800,20,6,24,4,4,24,,,,,4,4
2019-05-16 01:33,HAK,5416,737-800,27,6,30,5,5,31,,,,,3,4
2019-05-16 01:28,XIY,1482,737-800,21,5,31,6,6,26,,,,,10,5
2019-05-16 01:22,URC,5623,737-800,12,6,24,6,6,22,,,,,12,10
2019-05-16 01:19,HHA,6065,737-800,20,5,23,5,5,29,,,,,3,9
2019-05-16 01:16,TYN,5090,737-800,20,2,22,2,2,20,,,,,2,0
2019-05-16 01:15,SZX,5709,737-800,28,9,36,6,8,36,,,,,8,8
2019-05-16 01:13,CAN,5521,737-800,29,4,35,5,5,33,,,,,6,4
2019-05-16 01:08,PEK,5428,737-800,25,6,36,6,4,32,1,,,1,11,7
2019-05-16 01:07,CAN,1497,737-800,28,3,33,4,4,34,,,,,5,6
2019-05-16 01:06,HHA,5480,737-800,24,3,29,3,2,20,,,,,5,-4
2019-05-16 01:04,XIY,5115,737-800,20,5,26,5,6,27,,,,,6,7
2019-05-16 01:04,KMG,7989,737-800,22,6,27,7,6,24,,,,,5,2
2019-05-16 01:01,KMG,6800,737-800,20,4,24,5,4,22,,,,,4,2
2019-05-16 01:01,HHA,5638,737-800,25,4,30,4,4,28,,,,,5,3
2019-05-16 01:01,PEK,6061,737-800,22,4,28,4,4,28,,,,,6,6
2019-05-16 01:00,CAN,5687,737-800,29,4,28,5,4,30,,,,,-1,1
2019-05-16 00:58,URC,5625,737-800,20,2,24,2,4,22,,,,,4,2
2019-05-16 00:56,HRB,1433,737-800,21,3,27,4,4,22,,,,,6,1
2019-05-16 00:49,PEK,5372,737-800,25,4,25,4,4,25,,,,,0,0
2019-05-16 00:49,XIY,7378,737-800,24,6,30,8,6,32,,,,,6,8
2019-05-16 00:46,HAK,7175,737-800,27,5,36,5,4,34,,,,,9,7
2019-05-16 00:43,URC,1322,737-800,17,4,26,4,4,24,,,,,9,7
2019-05-16 00:41,SYX,5358,737-800,31,6,35,6,6,35,,,,,4,4
2019-05-16 00:39,HAK,1541,737-800,27,7,35,8,8,31,,,,,8,4
2019-05-16 00:36,KHG,206P,737-800,18,4,20,3,4,21,,,,,2,3
2019-05-16 00:36,HAK,5855,737-800,27,4,31,4,4,30,,,,,4,3
2019-05-16 00:34,SZX,5418,737-800,28,6,32,6,6,31,,,,,4,3
2019-05-16 00:28,SZX,1549,737-800,28,6,35,6,5,34,,,,,7,6
2019-05-16 00:26,TYN,1995,737-800,20,5,22,5,5,24,,,,,2,4
2019-05-16 00:23,HAK,1548,737-800,27,4,32,4,5,31,,,,,5,4
2019-05-16 00:20,HGH,5637,737-800,21,2,30,2,2,28,,,,,9,7
2019-05-16 00:20,CAN,1795,737-800,29,4,36,5,4,36,,,,,7,7
2019-05-16 00:16,HAK,5466,737-800,26,3,32,4,3,32,,,,,6,6
2019-05-16 00:16,CGO,7991,737-800,25,6,30,6,6,28,,,,,5,3
2019-05-16 00:10,CKG,5479,737-800,30,8,27,9,8,30,,,,,-3,0
2019-05-16 00:09,ÃàÑô,5449,737-800,25,5,28,4,4,27,,,,,3,2
2019-05-16 00:08,DLC,1502,737-800,20,3,26,2,3,25,,,,,6,5
2019-05-16 00:02,CGO,205U,737-800,23,2,28,2,2,29,,,,,5,6
2019-05-15 23:58,HAK,1783,737-800,30,4,36,5,5,36,,,,,6,6
2019-05-15 23:57,FOC,1559,737-800,22,3,32,3,3,27,1,,,1,10,5
2019-05-15 23:56,HAK,7616,737-800,27,5,31,8,5,28,,,,,4,1
2019-05-15 23:54,KMG,1208,737-800,22,3,25,4,4,24,,,,,3,2
2019-05-15 23:50,CGO,5732,737-800,20,4,30,4,4,26,,,,,10,6
2019-05-15 23:46,Ì«Ô­,7172,737-800,20,5,22,4,4,23,,,,,2,3
2019-05-15 23:41,CAN,5373,737-800,29,8,34,8,8,35,,,,,5,6
2019-05-15 23:34,XIY,5338,737-800,23,3,22,4,5,24,,,,,-1,1
2019-05-15 23:29,PEK,5662,737-800,20,4,30,4,6,30,,,,,10,10
2019-05-15 23:29,XIY,1996,737-800,35,4,22,6,5,27,,,,,-13,-8
2019-05-15 23:26,HAK,5481,737-800,27,5,32,6,5,32,,,,,5,5
2019-05-15 23:24,KHG,1496,737-800,15,5,24,6,6,26,,,,,9,11
2019-05-15 23:24,KHG,1570,737-800,19,4,21,4,4,18,,,,,2,-1
2019-05-15 23:23,HAK,1209,737-800,25,3,35,8,8,30,1,,,1,10,5
2019-05-15 23:23,URC,1725,737-800,17,5,30,5,5,30,,,,,13,13
2019-05-15 23:22,XIY,1787,737-800,24,2,30,2,2,26,,,,,6,2
2019-05-15 23:15,HHA,1101,737-800,25,3,33,2,2,30,,,,,8,5
2019-05-15 23:09,HRB,1562,737-800,20,4,22,5,4,24,,,,,2,4
2019-05-15 23:08,HAK,1786,737-800,27,4,37,3,3,31,1,,,1,10,4
2019-05-15 23:06,SYX,5337,737-800,29,5,34,6,5,34,,,,,5,5
2019-05-15 23:02,HAK,5089,737-800,27,6,30,5,5,30,,,,,3,3
2019-05-15 22:59,HHA,7398,737-800,22,4,30,4,3,28,,,,,8,6
2019-05-15 22:58,URC,1569,737-800,17,5,26,7,6,24,,,,,9,7
2019-05-15 22:53,HAK,6063,737-800,26,6,32,6,7,33,,,,,6,7
2019-05-15 22:51,HRB,1350,737-800,23,5,28,5,5,26,,,,,5,3
2019-05-15 22:48,HAK,5082,737-800,25,4,35,6,5,30,,,,,10,5
2019-05-15 22:41,DLC,1547,737-800,18,6,26,3,4,25,,,,,8,7
2019-05-15 22:38,URC,1141,737-800,16,4,26,4,5,27,,,,,10,11
2019-05-15 22:28,ÃàÑô,5409,737-800,24,4,27,4,4,28,,,,,3,4
2019-05-15 22:25,ZGC,5463,737-800,15,4,20,4,4,22,,,,,5,7
2019-05-15 22:25,DLC,1375,737-800,19,4,24,4,4,22,,,,,5,3
2019-05-15 22:24,XNN,5852,737-800,16,4,21,4,5,21,,,,,5,5
2019-05-15 22:10,XIY,7377,737-800,24,8,28,6,6,26,,,,,4,2
2019-05-15 22:10,CGO,7993,737-800,22,5,28,6,6,26,,,,,6,4
2019-05-15 22:04,SYX,1538,737-800,30,2,36,3,3,34,,,,,6,4
2019-05-15 21:58,URC,205V,737-800,20,4,26,4,2,25,,,,,6,5
2019-05-15 21:50,ZGC,6808,737-800,15,5,24,7,6,21,,,,,9,6
2019-05-15 21:45,XNN,1131,737-800,15,6,18,7,6,20,,,,,3,5
2019-05-15 20:58,º¼ÖÝ,1545,737-800,20,5,20,4,4,21,,,,,0,1
2019-05-15 20:28,BAR,1130,737-800,29,2,36,2,2,36,,,,,7,7
2019-05-15 20:02,HAK, 1928,737-800,25,5,27,7,7,31,,,,,2,6
2019-05-15 19:50,FOC,1905,737-800,23,3,28,4,4,26,,,,,5,3
2019-05-15 19:17,HRB,7113,737-800,18,4,20,4,5,22,,,,,2,4
2019-05-15 17:22,XUZ,1588,737-800,25,4,26,4,4,28,,,,,1,3
2019-05-15 15:42,YIH,7105,737-800,28,3,29,3,4,28,,,,,1,0
2019-05-15 15:22,KMG,6016,737-800,25,4,25,6,5,26,,,,,0,1
2019-05-15 14:38,HAK,7399,737-800,40,5,30,4,3,0,,,,,-10,-40
2019-05-15 14:06,CAN,1795,737-800,32,4,33,4,4,34,,,,,1,2
2019-05-15 09:34,KMG,6016,737-800,20,4,27,4,4,26,,,,,7,6
2019-05-15 08:26,KMG,1586,737-800,20,4,26,4,4,24,,,,,6,4
2019-05-15 08:24,PEK,5538,737-800,22,3,25,3,2,28,,,,,3,6
2019-05-15 08:23,HGH,1548,737-800,18,3,26,3,2,24,,,,,8,6
2019-05-15 08:14,PEK,5661,737-800,21,4,28,4,4,28,,,,,7,7
2019-05-15 08:14,PEK,5661,737-800,21,4,28,4,4,28,,,,,7,7
2019-05-15 07:54,KMG,7988,737-800,21,6,26,5,4,26,,,,,5,5
2019-05-15 07:48,PEK,1103,737-800,20,4,30,4,4,27,,,,,10,7
2019-05-15 07:39,FOC,1562,737-800,23,5,31,5,4,31,,,,,8,8
2019-05-15 06:19,FOC,7379,737-800,20,5,24,4,4,26,,,,,4,6
2019-05-15 06:16,FOC,5430,737-800,20,4,22,4,4,22,,,,,2,2
2019-05-15 06:11,HAK,5481,737-800,26,6,33,4,4,32,,,,,7,6
2019-05-15 06:10,HAK,5481,737-800,26,5,33,6,6,32,,,,,7,6
2019-05-15 06:09,HAK,1786,737-800,26,6,33,4,6,32,,,,,7,6
2019-05-15 06:01,URC,5375,737-800,15,2,18,4,3,22,,,,,3,7
2019-05-15 05:59,HAK,1213,737-800,27,7,37,6,6,37,,1,,1,10,10
2019-05-15 05:45,,5687,737-800,27,6,34,5,5,34,,,,,7,7
2019-05-15 05:44,PEK,5136,737-800,26,4,26,4,4,28,,,,,0,2
2019-05-15 05:31,URC,5637,737-800,17,2,26,2,2,20,,,,,9,3
2019-05-15 05:21,PEK,7171,737-800,20,4,25,5,4,26,,,,,5,6
2019-05-15 05:18,HAK,5373,737-800,28,6,33,9,9,37,,,,,5,9
2019-05-15 05:14,XIY,1902,737-800,20,6,26,4,6,24,,,,,6,4
2019-05-15 04:54,PEK,5539,737-800,15,6,28,4,4,28,,,,,13,13
2019-05-15 04:53,SYX,5337,737-800,30,4,34,4,4,34,,,,,4,4
2019-05-15 04:51,SZX,1141,737-800,27,6,34,6,5,30,,,,,7,3
2019-05-15 04:44,XIY,5115,737-800,17,5,27,7,6,30,,,,,10,13
2019-05-15 04:32,FOC,1562,737-800,23,4,29,4,4,28,,,,,6,5
2019-05-15 04:25,KMG,1209,737-800,20,3,27,4,4,24,,,,,7,4
2019-05-15 04:25,XIY,5183,737-800,15,3,28,3,3,24,,,,,13,9
2019-05-15 04:23,SYX,5462,737-800,30,4,32,5,4,34,,,,,2,4
2019-05-15 04:20,XIY,5853,737-800,20,6,28,6,6,24,,,,,8,4
2019-05-15 04:19,XIY,1163,737-800,19,2,27,2,3,26,,,,,8,7
2019-05-15 04:12,KMG,7167,737-800,20,5,26,5,5,24,,,,,6,4
2019-05-15 04:11,ZGC,5580,737-800,15,6,20,6,7,21,,,,,5,6
2019-05-15 04:09,HAK,1372,737-800,27,5,35,5,4,35,,,,,8,8
2019-05-15 04:09,ZGC,5135,737-800,15,4,23,5,6,22,,,,,8,7
2019-05-15 04:07,HHA,5406,737-800,22,5,27,7,4,26,,,,,5,4
2019-05-15 04:07,ZGC,1493,737-800,15,6,22,8,6,20,,,,,7,5
2019-05-15 04:06,ZGC,5463,737-800,15,5,19,6,5,18,,,,,4,3
2019-05-15 04:05,¹ãÖÝ,7399,737-800,28,4,34,4,4,30,,,,,6,2
2019-05-15 04:05,URC,5465,737-800,16,3,20,3,3,23,,,,,4,7
2019-05-15 04:05,HAK,1928,737-800,30,4,32,6,6,34,,,,,2,4
2019-05-15 04:05,HAK,1372,737-800,27,5,35,5,4,35,,,,,8,8
2019-05-15 03:59,DLC,6060,737-800,17,4,26,4,4,24,,,,,9,7
2019-05-15 03:57,URC,5611,737-800,16,4,26,7,6,24,,,,,10,8
2019-05-15 03:56,DLC,7400,737-800,17,4,24,4,4,26,,,,,7,9
2019-05-15 03:52,HAK,6063,737-800,25,6,36,8,8,37,,,,,11,12
2019-05-15 03:47,HAK,1542,737-800,28,4,36,6,4,34,,,,,8,6
2019-05-15 03:37,HGH,1729,737-800,21,3,23,2,2,22,,,,,2,1
2019-05-15 03:36,HAK,1488,737-800,27,6,34,6,6,30,,,,,7,3
2019-05-15 03:32,PEK,5735,737-800,21,2,28,2,2,26,,,,,7,5
2019-05-15 03:32,CGO,7991,737-800,20,6,28,6,6,26,,,,,8,6
2019-05-15 03:32,XIY,1481,737-800,17,6,29,5,5,25,,,,,12,8
2019-05-15 03:16,CAN,5371,737-800,28,7,33,7,7,32,,,,,5,4
2019-05-15 03:15,URC,1568,737-800,16,6,22,5,5,22,,,,,6,6
2019-05-15 03:13,CGO,7993,737-800,21,4,24,4,4,23,,,,,3,2
2019-05-15 03:11,CAN,7399,737-800,28,4,34,4,4,30,,,,,6,2
2019-05-15 03:06,¹ãÖÝ,1783,737-800,28,4,34,6,5,35,,,,,6,7
2019-05-15 03:03,SZX,1386,737-800,28,3,34,4,4,31,,,,,6,3
2019-05-15 03:03,KMG,7989,737-800,20,5,28,5,5,28,,,,,8,8
2019-05-15 03:01,XIY,1903,737-800,18,2,22,1,2,24,,,,,4,6
2019-05-15 02:58,URC,5797,737-800,15,5,21,3,3,0,,,,,6,-15
2019-05-15 02:55,CAN,5855,737-800,28,7,30,8,7,29,,,,,2,1
2019-05-15 02:52,HHA,5638,737-800,24,4,24,4,5,24,,,,,0,0
2019-05-15 02:51,HHA,1541,737-800,25,5,24,4,4,24,,,,,-1,-1
2019-05-15 02:51,HHA,6065,737-800,24,5,25,5,4,24,,,,,1,0
2019-05-15 02:49,SYX,5359,737-800,30,6,34,6,6,34,,,,,4,4
2019-05-15 02:48,MIG,5409,737-800,23,3,26,4,4,25,,,,,3,2
2019-05-15 02:48,HGH,1505,737-800,20,3,28,3,3,24,,,,,8,4
2019-05-15 02:44,SZX,1373,737-800,27,4,34,4,4,30,,,,,7,3
2019-05-15 02:44,HAK,5713,737-800,27,6,29,7,8,34,,,,,2,7
2019-05-15 02:44,HAK,1487,737-800,30,2,34,2,2,30,,,,,4,0
2019-05-15 02:43,HGH,1548,737-800,19,3,26,3,2,24,,,,,7,5
2019-05-15 02:43,HAK,7175,737-800,27,6,37,4,4,34,,,,,10,7
2019-05-15 02:42,º£¿Ú,793,737-800,27,5,36,5,5,32,,,,,9,5
2019-05-15 02:41,DLC,7173,737-800,15,5,27,5,4,26,,,,,12,11
2019-05-15 02:41,º£¿Ú,1793,737-800,27,5,36,5,0,0,,,,,9,-27
2019-05-15 02:40,HGH,7616,737-800,25,4,28,4,4,27,,,,,3,2
2019-05-15 02:37,HHA,5480,737-800,22,2,26,2,2,20,,,,,4,-2
2019-05-15 02:36,URC,6995,737-800,16,4,24,5,5,22,,,,,8,6
2019-05-15 02:34,URC,205V,737-800,17,4,27,4,3,24,,,,,10,7
2019-05-15 02:31,XIY,1482,737-800,19,6,28,5,6,26,,,,,9,7
2019-05-15 02:29,HHA,1492,737-800,20,4,29,3,3,27,,,,,9,7
2019-05-15 02:27,URC,6268,737-800,19,3,24,3,4,22,,,,,5,3
2019-05-15 02:25,XIY,5180,737-800,18,6,26,7,8,24,,,,,8,6
2019-05-15 02:22,URC,1725,737-800,16,5,23,4,4,28,,,,,7,12
2019-05-15 02:21,CTU,7992,737-800,20,5,25,5,6,26,,,,,5,6
2019-05-15 02:20,PEK,1727,737-800,22,5,26,6,6,24,,,,,4,2
2019-05-15 02:20,YIH,1351,737-800,19,4,29,4,4,22,,,,,10,3
2019-05-15 02:18,HRB,1350,737-800,13,3,26,4,3,21,,,,,13,8
2019-05-15 02:17,HRB,1433,737-800,16,3,22,2,3,19,,,,,6,3
2019-05-15 02:17,XIY,5116,737-800,19,4,23,5,5,22,,,,,4,3
2019-05-15 02:16,XIY,5408,737-800,16,3,25,3,3,24,,,,,9,8
2019-05-15 02:15,HGH,5372,737-800,20,7,27,7,6,26,,,,,7,6
2019-05-15 02:11,TYN,5090,737-800,18,2,22,3,4,24,,,,,4,6
2019-05-15 02:09,HAK,5346,737-800,27,6,35,6,5,33,,,,,8,6
2019-05-15 02:07,XIY,1348,737-800,18,3,28,3,3,28,,,,,10,10
2019-05-15 02:06,PEK,5153,737-800,21,2,22,4,4,27,,,,,1,6
2019-05-15 02:04,XIY,5139,737-800,19,5,26,5,4,24,,,,,7,5
2019-05-15 01:57,HAK,1995,737-800,28,8,37,6,6,34,1,,,1,9,6
2019-05-15 01:56,CAN,1491,737-800,26,5,36,6,5,34,1,,,1,10,8
2019-05-15 01:56,KMG,5449,737-800,22,6,28,6,6,26,,,,,6,4
2019-05-15 01:54,URC,5623,737-800,15,4,25,3,3,22,,,,,10,7
2019-05-15 01:54,PEK,5416,737-800,21,8,30,8,8,28,,,,,9,7
2019-05-15 01:53,FOC,1559,737-800,20,2,22,3,3,27,,,,,2,7
2019-05-15 01:50,URC,5637,737-800,17,2,26,2,2,20,,,,,9,3
2019-05-15 01:50,PEK,5136,737-800,21,4,26,4,4,30,,,,,5,9
2019-05-15 01:50,SYX,1538,737-800,30,4,36,4,2,34,,,,,6,4
2019-05-15 01:44,º£¿Ú,1130,737-800,27,2,34,2,2,30,,,,,7,3
2019-05-15 01:43,CAN,7886,737-800,30,3,36,3,3,35,,,,,6,5
2019-05-15 01:43,URC,2159,737-800,11,3,23,2,2,22,,,,,12,11
2019-05-15 01:41,ÒË²ý,1435,737-800,19,6,28,5,5,26,,,,,9,7
2019-05-15 01:41,XIY,7377,737-800,19,6,26,6,6,26,,,,,7,7
2019-05-15 01:41,SYX,1997,737-800,29,5,32,4,5,31,,,,,3,2
2019-05-15 01:40,XIY,1797,737-800,19,4,23,3,3,24,,,,,4,5
2019-05-15 01:36,DLC,1545,737-800,15,4,24,2,4,22,,,,,9,7
2019-05-15 01:35,DLC,1375,737-800,15,3,23,3,2,20,,,,,8,5
2019-05-15 01:33,CGO,7991,737-800,20,6,28,6,6,26,,,,,8,6
2019-05-15 01:33,XIY,5852,737-800,20,4,25,5,4,22,,,,,5,2
2019-05-15 01:33,CKG,5479,737-800,25,5,26,6,6,31,,,,,1,6
2019-05-15 01:30,HAK,5581,737-800,28,9,32,6,6,36,,,,,4,8
2019-05-15 01:29,URC,5540,737-800,16,4,28,5,5,27,,,,,12,11
2019-05-15 01:22,CGO,6800,737-800,21,4,27,5,4,23,,,,,6,2
2019-05-15 01:22,HGH,6808,737-800,20,4,28,4,4,27,,,,,8,7
2019-05-15 01:22,SZX,1733,737-800,29,3,33,3,3,29,,,,,4,0
2019-05-15 01:21,CGO,205U,737-800,22,4,28,4,4,28,,,,,6,6
2019-05-15 01:21,SYX,206F,737-800,30,2,34,2,2,31,,,,,4,1
2019-05-15 01:17,SZX,7639,737-800,26,6,34,6,5,31,,,,,8,5
2019-05-15 01:17,CGO,5732,737-800,20,4,26,4,4,25,,,,,6,5
2019-05-15 01:14,HHA,1728,737-800,21,4,28,4,4,23,,,,,7,2
2019-05-15 01:13,FOC,7395,737-800,20,4,24,5,6,28,,,,,4,8
2019-05-15 01:12,HHA,6066,737-800,21,2,27,2,2,26,,,,,6,5
2019-05-15 01:09,HAK,5417,737-800,26,6,30,4,6,32,,,,,4,6
2019-05-15 01:08,KMG,1588,737-800,20,3,23,4,4,23,,,,,3,3
2019-05-15 01:04,CKG,6061,737-800,20,3,28,4,4,26,,,,,8,6
2019-05-15 01:01,TYN,206G,737-800,18,4,26,2,4,22,,,,,8,4
2019-05-15 01:01,TYN,7172,737-800,24,5,26,5,5,25,,,,,2,1
2019-05-15 00:57,CAN,1495,737-800,30,4,32,4,4,34,,,,,2,4
2019-05-15 00:57,URC,1929,737-800,18,2,23,3,3,22,,,,,5,4
2019-05-15 00:54,MIG,6809,737-800,25,5,27,5,6,28,,,,,2,3
2019-05-15 00:53,CKG,5137,737-800,20,3,20,3,3,28,,,,,0,8
2019-05-15 00:52,DLC,1787,737-800,15,1,26,1,1,23,,,,,11,8
2019-05-15 00:39,HAK,5502,737-800,30,6,34,6,4,32,,,,,4,2
2019-05-15 00:38,DLC,1346,737-800,14,5,26,4,6,24,,,,,12,10
2019-05-15 00:38,SZX,6103,737-800,25,6,34,6,6,36,,,,,9,11
2019-05-15 00:37,HAK,6063,737-800,28,18,50,9,9,41,,,,,22,13
2019-05-15 00:37,KHG,1569,737-800,18,4,23,4,3,24,,,,,5,6
2019-05-15 00:37,CGO,1587,737-800,23,2,26,2,1,22,,,,,3,-1
2019-05-15 00:31,URC,1726,737-800,17,4,26,3,3,21,,,,,9,4
2019-05-15 00:30,SZX,5405,737-800,30,5,36,6,4,35,,,,,6,5
2019-05-15 00:30,URC,5625,737-800,20,4,17,4,4,20,,,,,-3,0
2019-05-15 00:29,XIY,1347,737-800,16,3,30,3,3,28,,,,,14,12
2019-05-15 00:25,CAN,1497,737-800,28,3,33,4,4,34,,,,,5,6
2019-05-15 00:22,CKG,5479,737-800,20,5,20,6,6,31,,,,,0,11
2019-05-15 00:16,XIY,1547,737-800,21,6,26,7,8,27,,,,,5,6
2019-05-15 00:08,CGO,5418,737-800,25,4,23,3,3,25,,,,,-2,0
2019-05-15 00:00,URC,1570,737-800,17,6,22,5,5,20,,,,,5,3
2019-05-14 23:56,PEK,5439 ,737-800,23,4,28,4,4,29,,,,,5,6
2019-05-14 23:31,HGH,1927,737-800,20,4,24,6,3,26,,,,,4,6
2019-05-14 23:30,MIG,5407,737-800,30,4,30,4,3,30,,,,,0,0
2019-05-14 23:30,URC,206P,737-800,17,6,22,5,4,22,,,,,5,5
2019-05-14 23:28,HAK,5089,737-800,26,6,30,2,2,35,,,,,4,9
2019-05-14 23:14,URC,1323,737-800,18,4,27,3,3,26,,,,,9,8
2019-05-14 23:13,HAK,1501,737-800,27,4,36,5,4,32,,,,,9,5
2019-05-14 23:11,DLC,5636,737-800,14,6,26,6,4,25,,,,,12,11
2019-05-14 23:09,URC ,205T,737-800,18,3,25,3,3,25,,,,,7,7
2019-05-14 23:04,CAN,5521,737-800,29,4,28,5,3,30,,,,,-1,1
2019-05-14 23:02,HRB,7113,737-800,10,4,26,3,4,24,,,,,16,14
2019-05-14 22:59,XIY,5520,737-800,16,4,30,4,4,27,,,,,14,11
2019-05-14 22:59,HAK,1208,737-800,28,3,34,3,3,31,,,,,6,3
2019-05-14 22:58,HAK,5579,737-800,28,7,37,7,7,36,1,,,1,9,8
2019-05-14 22:56,XIY,1101,737-800,20,4,30,3,3,27,,,,,10,7
2019-05-14 22:48,URC,1325,737-800,18,4,21,4,5,22,,,,,3,4
2019-05-14 22:47,HHA,7398,737-800,22,4,30,3,3,28,,,,,8,6
2019-05-14 22:42,SYX,7619,737-800,30,6,34,6,5,32,,,,,4,2
2019-05-14 22:14,PEK,5712,737-800,22,2,24,1,4,25,,,,,2,3
2019-05-14 22:11,HGH,1502,737-800,20,3,24,2,2,23,,,,,4,3
2019-05-14 22:02,HGH,5733,737-800,18,5,28,5,5,28,,,,,10,10
2019-05-14 22:00,HAK,1785,737-800,28,0,34,9,9,35,,,,,6,7
2019-05-14 21:58,MIG,1798,737-800,23,5,26,5,6,26,,,,,3,3
2019-05-14 21:57,SYX,7618,737-800,30,4,34,7,6,32,,,,,4,2
2019-05-14 21:46,TYN,5467,737-800,21,5,25,4,3,19,,,,,4,-2
2019-05-14 21:38,XNN,1131,737-800,15,5,25,4,4,25,,,,,10,10
2019-05-14 21:28,TYN,6062,737-800,19,4,24,4,4,25,,,,,5,6
2019-05-14 20:29,HAK,1796,737-800,27,5,32,5,4,33,,,,,5,6
2019-05-14 20:25,URC,7198,737-800,20,4,23,3,4,21,,,,,3,1
2019-05-14 20:22,DLC,1102,737-800,17,3,28,4,3,26,,,,,11,9
2019-05-14 20:09,URC,1322,737-800,27,4,23,5,4,24,,,,,-4,-3
2019-05-14 20:04,HAK,5082,737-800,27,8,38,6,6,34,,,,,11,7
2019-05-14 19:39,SYX,5522,737-800,29,7,35,8,8,36,,,,,6,7
2019-05-14 19:09,FOC,1905,737-800,23,4,28,3,2,24,,,,,5,1
2019-05-14 18:48,HAK,5466,737-800,27,6,30,7,5,25,,,,,3,-2
2019-05-14 18:04,YIH,7105,737-800,19,5,30,5,5,29,,,,,11,10
2019-05-14 16:43,HAK,5478,737-800,35,8,38,4,4,34,1,,,1,3,-1
2019-05-14 16:35,XIY,1996,737-800,22,5,20,5,5,26,,,,,-2,4
2019-05-14 16:25,SZX,1373,737-800,25,4,30,4,5,31,,,,,5,6
2019-05-14 16:18,PEK,5428,737-800,29,3,29,4,3,32,,,,,0,3
2019-05-14 15:10,KMG,1588,737-800,30,4,24,6,5,23,,,,,-6,-7
2019-05-14 13:47,PEK,1490,737-800,26,6,26,6,6,24,,,,,0,-2
2019-05-14 10:29,HAK,5478,737-800,35,8,38,6,6,38,1,1,,11,3,3
2019-05-14 09:57,HAK,5337,737-800,27,4,36,6,5,35,,,,,9,8
2019-05-14 09:49,XIY,1547,737-800,20,7,26,7,6,26,,,,,6,6
2019-05-14 09:06,ZGC,5463,737-800,10,8,22,6,5,20,,,,,12,10
2019-05-14 09:04,ZGC,1141,737-800,15,5,22,7,6,23,,,,,7,8
2019-05-14 09:04,ZGC,7171,737-800,15,8,22,6,7,24,,,,,7,9
2019-05-14 08:36,´óÁ¬,5853,737-800,13,6,26,6,6,24,,,,,13,11
2019-05-14 08:07,SYX,7886,737-800,28,4,34,2,2,34,,,,,6,6
2019-05-14 08:02,SZX,1487,737-800,28,3,32,3,3,29,,,,,4,1
2019-05-14 07:56,TYN,5373,737-800,15,6,20,6,6,20,,,,,5,5
2019-05-14 07:53,SZX,1493,737-800,27,6,31,6,6,29,,,,,4,2
2019-05-14 07:45,PEK,5662,737-800,25,3,25,3,5,25,,,,,0,0
2019-05-14 07:34,URC,205U,737-800,13,4,25,2,2,30,,,,,12,17
2019-05-14 07:26,HAK,1497,737-800,27,4,34,5,4,34,,,,,7,7
2019-05-14 07:15,S?Z?X,7639,737-800,28,6,35,6,6,32,,,,,7,4
2019-05-14 06:55,PEK,1103,737-800,20,3,30,4,3,22,,,,,10,2
2019-05-14 06:50,XIY,5712,737-800,20,1,24,2,1,20,,,,,4,0
2019-05-14 06:38,PEK,5539,737-800,18,4,28,6,5,28,,,,,10,10
2019-05-14 05:50,CGO,6800,737-800,18,4,23,5,5,22,,,,,5,4
2019-05-14 05:48,HAK,1793,737-800,25,3,32,5,5,31,,,,,7,6
2019-05-14 05:48,HAK,7379,737-800,26,5,30,4,4,34,,,,,4,8
2019-05-14 05:11,FOC,7175,737-800,21,4,31,5,5,28,,,,,10,7
2019-05-14 05:10,FOC,7175,737-800,21,5,33,6,6,30,,,,,12,9
2019-05-14 05:05,XIY,1488,737-800,20,6,25,6,6,23,,,,,5,3
2019-05-14 05:04,XIY,1903,737-800,20,6,23,5,5,25,,,,,3,5
2019-05-14 04:58,CGO,6016,737-800,17,5,29,5,5,27,,,,,12,10
2019-05-14 04:56,CAN ,5520,737-800,27,5,33,5,6,33,,,,,6,6
2019-05-14 04:54,CAN ,1783,737-800,27,3,28,5,6,32,,,,,1,5
2019-05-14 04:51,HAK,5467,737-800,26,4,34,2,0,28,,,,,8,2
2019-05-14 04:45,FOC,1562,737-800,24,4,30,5,4,31,,,,,6,7
2019-05-14 04:44,PEK ,5538,737-800,17,2,30,2,2,27,,,,,13,10
2019-05-14 04:38,FOC,7105,737-800,24,4,30,4,4,30,,,,,6,6
2019-05-14 04:32,HAK,6103,737-800,26,7,36,6,6,36,,,,,10,10
2019-05-14 04:28,FOC,1480,737-800,28,4,26,4,4,24,,,,,-2,-4
2019-05-14 04:19,Ì«Ô­,5090,737-800,18,2,22,2,2,20,,,,,4,2
2019-05-14 04:08,XIY,1483,737-800,15,4,28,2,4,30,,,,,13,15
2019-05-14 04:08,XIY,1161,737-800,15,4,26,2,2,28,,,,,11,13
2019-05-14 03:50,XMN,5483,737-800,25,7,25,5,6,25,,,,,0,0
2019-05-14 03:49,XMN,5358,737-800,25,7,30,5,6,29,,,,,5,4
2019-05-14 03:49,XMN,5686,737-800,25,5,30,4,3,30,,,,,5,5
2019-05-14 03:48,XMN,5580,737-800,20,5,26,4,6,27,,,,,6,7
2019-05-14 03:47,XMN,1215,737-800,20,5,26,7,5,29,,,,,6,9
2019-05-14 03:43,HGH,5372,737-800,20,6,27,6,6,25,,,,,7,5
2019-05-14 03:43,CGO,5479,737-800,18,4,24,5,5,25,,,,,6,7
2019-05-14 03:36,XIY,1902,737-800,21,6,27,6,6,25,,,,,6,4
2019-05-14 03:36,XIY,5182,737-800,18,5,26,5,6,26,,,,,8,8
2019-05-14 03:35,XIY,1492,737-800,18,4,27,4,5,27,,,,,9,9
2019-05-14 03:34,SYX,206F,737-800,29,5,32,4,3,31,,,,,3,2
2019-05-14 03:27,URC,206P,737-800,18,4,26,4,3,20,,,,,8,2
2019-05-14 03:26,PEK ,5482,737-800,19,0,28,4,4,28,,,,,9,9
2019-05-14 03:25,URC,6268,737-800,15,4,28,4,5,24,,,,,13,9
2019-05-14 03:22,HAK,5089,737-800,25,3,15,1,1,32,,,,,-10,7
2019-05-14 03:21,HAK,5502,737-800,26,6,33,6,5,32,,,,,7,6
2019-05-14 03:19,CGO,1542,737-800,17,4,26,6,6,27,,,,,9,10
2019-05-14 03:17,URC,1568,737-800,18,6,22,4,4,22,,,,,4,4
2019-05-14 03:16,HAK,1213,737-800,27,6,36,6,6,36,,,,,9,9
2019-05-14 03:14,HHA,7398,737-800,20,3,28,4,4,26,,,,,8,6
2019-05-14 03:13,HGH,1372,737-800,19,5,27,4,3,25,,,,,8,6
2019-05-14 03:12,XIY,1162,737-800,19,4,28,4,4,24,,,,,9,5
2019-05-14 03:11,KMG,1588,737-800,21,4,24,5,4,23,,,,,3,2
2019-05-14 03:11,SYX,1996,737-800,28,4,27,5,5,32,,,,,-1,4
2019-05-14 03:05,KMG,7167,737-800,15,6,26,6,6,24,,,,,11,9
2019-05-14 03:04,SYX,BX5462,737-800,28,4,24,4,4,24,,,,,-4,-4
2019-05-14 03:02,XIY,1161,737-800,20,5,25,4,4,24,,,,,5,4
2019-05-14 02:57,URC,6995,737-800,12,4,24,4,4,20,,,,,12,8
2019-05-14 02:55,HAK,5581,737-800,29,5,32,4,4,30,,,,,3,1
2019-05-14 02:55,HAK,5581,737-800,29,5,32,4,4,30,,,,,3,1
2019-05-14 02:53,HHA,1541,737-800,20,5,28,6,5,28,,,,,8,8
2019-05-14 02:52,HHA,1490,737-800,25,5,24,4,4,24,,,,,-1,-1
2019-05-14 02:50,HHA,5480,737-800,20,3,27,4,3,20,,,,,7,0
2019-05-14 02:46,CKG,1131,737-800,20,4,30,4,4,30,,,,,10,10
2019-05-14 02:44,SYX,1997,737-800,28,6,36,5,4,30,,,,,8,2
2019-05-14 02:42,FOC,1559,737-800,25,4,32,4,4,28,,,,,7,3
2019-05-14 02:42,HGH,7616,737-800,30,4,26,3,4,26,,,,,-4,-4
2019-05-14 02:36,SHA,1729,737-800,18,4,24,4,3,22,,,,,6,4
2019-05-14 02:36,SHA,5408,737-800,18,5,27,3,4,22,,,,,9,4
2019-05-14 02:35,URC,1570,737-800,15,3,22,3,4,23,,,,,7,8
2019-05-14 02:35,XIY,1482,737-800,19,5,26,4,5,24,,,,,7,5
2019-05-14 02:33,XMN,5580,737-800,24,5,26,4,6,27,,,,,2,3
2019-05-14 02:33,URC,5540,737-800,15,6,30,6,5,26,,,,,15,11
2019-05-14 02:32,XMN,5358,737-800,25,7,30,5,6,29,,,,,5,4
2019-05-14 02:31,HGH,5733,737-800,20,6,30,6,6,28,,,,,10,8
2019-05-14 02:31,XMN,5686,737-800,25,5,30,4,3,30,,,,,5,5
2019-05-14 02:30,XMN,5483,737-800,20,7,25,6,5,26,,,,,5,6
2019-05-14 02:30,URC,2159,737-800,17,8,18,3,3,20,,,,,1,3
2019-05-14 02:27,HAK,5405,737-800,26,4,35,6,4,35,,,,,9,9
2019-05-14 02:26,KMG,5732,737-800,23,2,21,4,4,24,,,,,-2,1
2019-05-14 02:25,MIG,6809,737-800,25,5,26,6,6,28,,,,,1,3
2019-05-14 02:24,115,5538,737-800,17,2,13,2,2,27,,,,,-4,10
2019-05-14 02:23,CGO,1587,737-800,18,3,24,4,4,22,,,,,6,4
2019-05-14 02:22,URC,1796,737-800,10,6,24,4,4,24,,,,,14,14
2019-05-14 02:22,SYX,1538,737-800,29,3,36,2,3,32,,,,,7,3
2019-05-14 02:21,URC,5625,737-800,15,4,22,4,4,22,,,,,7,7
2019-05-14 02:15,XIY,1348,737-800,20,3,28,4,4,26,,,,,8,6
2019-05-14 02:15,PEK,1787,737-800,20,2,24,2,2,22,,,,,4,2
2019-05-14 02:12,SYX,5418,737-800,28,8,34,3,3,32,,,,,6,4
2019-05-14 02:08,URC,5637,737-800,18,2,26,3,3,22,,,,,8,4
2019-05-14 02:07,SYX,1548,737-800,29,4,32,4,4,31,,,,,3,2
2019-05-14 02:03,XIY,5139,737-800,20,4,28,6,4,24,,,,,8,4
2019-05-14 01:54,HAK,5346,737-800,29,4,30,4,6,32,,,,,1,3
2019-05-14 01:49,201,5713,737-800,25,6,34,6,6,34,,,,,9,9
2019-05-14 01:43,XIY,5116,737-800,20,6,22,4,4,22,,,,,2,2
2019-05-14 01:42,HGH,1502,737-800,20,3,23,4,3,26,,,,,3,6
2019-05-14 01:41,URC,1325,737-800,15,4,26,4,5,22,,,,,11,7
2019-05-14 01:39,PEK,1496,737-800,18,6,26,6,6,26,,,,,8,8
2019-05-14 01:36,PEK,5416,737-800,20,6,25,5,4,26,,,,,5,6
2019-05-14 01:34,YIH,1435,737-800,23,6,30,5,5,25,,,,,7,2
2019-05-14 01:33,YIH,1351,737-800,23,4,29,3,4,22,,,,,6,-1
2019-05-14 01:30,CAN,5521,737-800,27,5,30,4,2,28,,,,,3,1
2019-05-14 01:29,XIY,1163,737-800,20,2,28,3,2,28,,,,,8,8
2019-05-14 01:28,URC,5623,737-800,13,6,28,8,8,28,,,,,15,15
2019-05-14 01:26,HGH,5135,737-800,19,3,29,2,3,27,,,,,10,8
2019-05-14 01:15,HRB,1906,737-800,12,6,28,5,5,23,,,,,16,11
2019-05-14 01:14,PEK,5375,737-800,20,0,20,0,0,27,,,,,0,7
2019-05-14 01:12,CAN,5735,737-800,28,4,35,5,4,34,,,,,7,6
2019-05-14 01:10,FOC,5430,737-800,24,5,30,2,2,32,,,,,6,8
2019-05-14 01:03,HHA,6065,737-800,20,5,28,4,4,27,,,,,8,7
2019-05-14 01:00,XIY,5180,737-800,22,6,28,6,6,25,,,,,6,3
2019-05-14 00:58,KHG,1569,737-800,24,2,23,3,3,24,,,,,-1,0
2019-05-14 00:55,HRB,1350,737-800,12,2,24,4,4,22,,,,,12,10
2019-05-14 00:54,URC,2157,737-800,14,3,24,8,8,22,,,,,10,8
2019-05-14 00:48,º£¿Ú,5429,737-800,26,3,35,5,6,36,,,,,9,10
2019-05-14 00:48,HAK,1498,737-800,27,4,34,4,5,28,,,,,7,1
2019-05-14 00:43,´óÁ¬,1346,737-800,15,5,26,4,5,22,,,,,11,7
2019-05-14 00:39,CAN,1728,737-800,26,5,31,4,5,27,,,,,5,1
2019-05-14 00:39,SZX ,1130,737-800,25,2,32,3,2,30,,,,,7,5
2019-05-14 00:37,XIY,5687,737-800,20,4,24,5,4,25,,,,,4,5
2019-05-14 00:36,KMG,5409,737-800,23,4,20,5,5,26,,,,,-3,3
2019-05-14 00:36,CGO,7988,737-800,18,4,25,5,4,26,,,,,7,8
2019-05-14 00:32,URC,5611,737-800,12,5,26,5,5,24,,,,,14,12
2019-05-14 00:31,CKG,5522,737-800,20,4,23,4,3,22,,,,,3,2
2019-05-14 00:30,DLC,5636,737-800,11,4,23,4,4,24,,,,,12,13
2019-05-14 00:27,KMG,1209,737-800,24,3,29,4,4,22,,,,,5,-2
2019-05-14 00:21,MIG,5407,737-800,23,3,28,5,4,26,,,,,5,3
2019-05-14 00:16,TYN,206G,737-800,20,4,26,4,4,23,,,,,6,3
2019-05-14 00:15,URC,1726,737-800,20,4,26,4,4,22,,,,,6,2
2019-05-14 00:15,HGH,6808,737-800,19,5,28,5,6,26,,,,,9,7
2019-05-14 00:10,SZX,1386,737-800,28,4,32,4,3,30,,,,,4,2
2019-05-14 00:07,DLC,7173,737-800,20,4,26,4,4,24,,,,,6,4
2019-05-14 00:06,URC,1727,737-800,18,4,24,4,4,20,,,,,6,2
2019-05-14 00:05,XIY ,7619,737-800,20,4,23,5,5,26,,,,,3,6
2019-05-14 00:02,KMG,1209,737-800,24,3,29,4,4,22,,,,,5,-2
2019-05-13 23:49,HAK,7399,737-800,26,5,32,4,4,28,,,,,6,2
2019-05-13 23:48,XIY,1347,737-800,18,4,28,4,4,24,,,,,10,6
2019-05-13 23:40,PEK,5428,737-800,23,4,23,4,4,29,,,,,0,6
2019-05-13 23:35,URC,5620,737-800,18,2,24,2,4,20,,,,,6,2
2019-05-13 23:32,HAK,1495,737-800,26,34,4,5,5,35,,,,,-22,9
2019-05-13 23:31,URC,205T,737-800,15,4,26,4,4,26,,,,,11,11
2019-05-13 23:29,URC,5797,737-800,19,4,20,8,8,20,,,,,1,1
2019-05-13 23:26,HHA,1929,737-800,25,3,26,4,4,24,,,,,1,-1
2019-05-13 23:25,HAK,5481,737-800,25,5,32,6,6,32,,,,,7,7
2019-05-13 23:24,HHA,5406,737-800,20,4,28,5,4,26,,,,,8,6
2019-05-13 23:24,HAK,1208,737-800,28,5,33,4,4,30,,,,,5,2
2019-05-13 23:21,KMG,7989,737-800,19,4,27,5,7,24,,,,,8,5
2019-05-13 23:20,HRB,7113,737-800,13,4,28,4,4,20,,,,,15,7
2019-05-13 23:17,XIY,7378,737-800,19,6,26,6,6,26,,,,,7,7
2019-05-13 23:12,PEK,5661,737-800,20,4,18,4,4,24,,,,,-2,4
2019-05-13 23:05,HAK,5082,737-800,27,5,36,5,4,33,,,,,9,6
2019-05-13 23:03,´óÁ¬,1375,737-800,12,4,22,4,3,20,,,,,10,8
2019-05-13 23:03,URC,1323,737-800,19,3,28,3,2,26,,,,,9,7
2019-05-13 23:03,HAK,1733,737-800,27,4,32,4,3,29,,,,,5,2
2019-05-13 23:02,SYX,1491,737-800,29,6,36,6,5,35,,,,,7,6
2019-05-13 22:52,DLC,1102,737-800,16,3,26,4,4,24,,,,,10,8
2019-05-13 22:51,PEK,5439,737-800,22,4,24,4,4,23,,,,,2,1
2019-05-13 22:46,SYX,5359,737-800,28,8,35,4,4,32,,,,,7,4
2019-05-13 22:44,SYX,7618,737-800,29,6,34,5,4,30,,,,,5,1
2019-05-13 22:39,HGH,1489,737-800,30,4,26,4,4,26,,,,,-4,-4
2019-05-13 22:26,º£¿Ú,206H,737-800,27,3,23,3,3,22,,,,,-4,-5
2019-05-13 22:16,XNN,7377,737-800,16,4,21,6,6,24,,,,,5,8
2019-05-13 22:14,MIG,5449,737-800,23,3,28,3,3,27,,,,,5,4
2019-05-13 22:14,XNN,5153,737-800,16,7,19,6,6,21,,,,,3,5
2019-05-13 22:09,HAK,5579,737-800,28,6,36,6,6,34,,,,,8,6
2019-05-13 21:38,TYN,7172,737-800,15,6,26,6,6,26,,,,,11,11
2019-05-13 21:38,DLC,1545,737-800,20,4,24,4,5,22,,,,,4,2
2019-05-13 21:27,XMN,1215,737-800,20,5,26,7,5,29,,,,,6,9
2019-05-13 21:07,CGO,7993,737-800,20,5,26,6,6,23,,,,,6,3
2019-05-13 20:54,DLC,5138,737-800,14,3,26,3,4,24,,,,,12,10
2019-05-13 20:47,HAK,1927,737-800,28,4,30,8,4,30,,,,,2,2
2019-05-13 20:33,FOC,7395,737-800,23,6,30,7,7,30,,,,,7,7
2019-05-13 20:23,URC,5465,737-800,20,2,26,2,2,26,,,,,6,6
2019-05-13 20:23,URC,5465,737-800,20,2,26,2,2,26,,,,,6,6
2019-05-13 20:06,SYX,5466,737-800,29,2,25,9,2,30,,,,,-4,1
2019-05-13 19:53,HAK,1785,737-800,27,3,30,8,9,31,,,,,3,4
2019-05-13 19:39,HAK,5137,737-800,27,6,28,4,4,37,,1,,1,1,10
2019-05-13 19:37,HHA,5638,737-800,20,4,28,4,4,27,,,,,8,7
2019-05-13 19:34,º£¿Ú,1795,737-800,28,4,28,2,4,28,,,,,0,0
2019-05-13 19:21,URC,205V,737-800,15,3,24,3,5,24,,,,,9,9
2019-05-13 18:55,HAK,1501,737-800,28,3,36,4,4,32,,,,,8,4
2019-05-13 18:50,HGH,1505,737-800,19,3,25,3,4,24,,,,,6,5
2019-05-13 18:17,YIH,1905,737-800,21,4,26,5,4,22,,,,,5,1
2019-05-13 18:08,KMG,7990,737-800,35,4,20,5,4,24,,,,,-15,-11
2019-05-13 17:31,XUZ,1586,737-800,30,4,28,4,4,30,,,,,-2,0
2019-05-13 16:58,URC,5661,737-800,20,4,19,5,5,25,,,,,-1,5
2019-05-13 16:14,ÃàÑô,1798,737-800,28,6,28,6,6,28,,,,,0,0
2019-05-13 15:57,HAK,1735,737-800,31,5,34,5,5,31,,,,,3,0
2019-05-13 15:16,SYX ,5372,737-800,33,8,32,8,7,33,,,,,-1,0
2019-05-13 15:11,DLC,1488,737-800,20,5,26,5,5,27,,,,,6,7
2019-05-13 13:59,YIH,1906,737-800,22,7,28,6,7,29,,,,,6,7
2019-05-13 12:29,HRB,1433,737-800,13,3,20,2,2,20,,,,,7,7
2019-05-13 10:52,CTU,7992,737-800,25,6,22,7,7,22,,,,,-3,-3
2019-05-13 10:42,ZGC,1141,737-800,10,5,22,5,5,22,,,,,12,12
2019-05-13 10:41,ZGC,5709,737-800,10,7,27,8,9,30,,,,,17,20
2019-05-13 10:40,ZGC,7171,737-800,10,5,21,5,6,24,,,,,11,14
2019-05-13 09:14,SYX,1997,737-800,29,6,35,4,3,32,,,,,6,3
2019-05-13 08:53,HHA,5638,737-800,21,5,28,4,4,30,,,,,7,9
2019-05-13 08:26,KMG,6809,737-800,20,5,23,6,6,22,,,,,3,2
2019-05-13 07:28,HAK,1131,737-800,26,4,36,4,4,36,1,1,,11,10,10
2019-05-13 06:52,PEK,5539,737-800,15,4,26,4,4,26,,,,,11,11
2019-05-13 06:41,XMN,5855,737-800,25,8,28,6,7,26,,,,,3,1
2019-05-13 06:41,XMN,1548,737-800,25,4,30,4,4,28,,,,,5,3
2019-05-13 06:40,XMN,5408,737-800,20,5,31,4,3,28,,,,,11,8
2019-05-13 06:40,XMN,1215,737-800,25,3,31,4,3,28,,,,,6,3
2019-05-13 06:39,XMN,5483,737-800,22,5,33,4,2,26,,,,,11,4
2019-05-13 06:20,PEK,5662,737-800,15,4,24,4,8,22,,,,,9,7
2019-05-13 06:15,FOC,7113,737-800,24,4,28,5,5,26,,,,,4,2
2019-05-13 06:10,FOC,1559,737-800,24,2,28,2,3,26,,,,,4,2
2019-05-13 06:07,HAK,5502,737-800,27,6,32,7,6,32,,,,,5,5
2019-05-13 06:05,HAK,1793,737-800,28,5,35,5,5,32,,,,,7,4
2019-05-13 05:57,HHA,1795,737-800,21,4,26,4,4,27,,,,,5,6
2019-05-13 05:47,CGO,1588,737-800,23,4,26,4,4,23,,,,,3,0
2019-05-13 05:44,HHA,1929,737-800,22,3,30,3,3,24,,,,,8,2
2019-05-13 05:43,FOC,1348,737-800,24,4,32,4,4,30,,,,,8,6
2019-05-13 05:42,HAK,5082,737-800,28,6,35,6,6,32,,,,,7,4
2019-05-13 05:26,HHA,1490,737-800,24,5,28,4,4,26,,,,,4,2
2019-05-13 05:23,DLC,7378,737-800,17,4,23,5,5,25,,,,,6,8
2019-05-13 05:22,DLC,7175,737-800,16,4,22,5,4,26,,,,,6,10
2019-05-13 05:21,DLC,6062,737-800,19,4,26,3,3,25,,,,,7,6
2019-05-13 05:10,FOC,1729,737-800,24,4,28,5,5,25,,,,,4,1
2019-05-13 05:09,URC,1570,737-800,18,4,15,6,6,26,,,,,-3,8
2019-05-13 05:09,URC,1325,737-800,20,4,20,4,4,20,,,,,0,0
2019-05-13 05:08,URC,1727,737-800,19,4,22,4,4,22,,,,,3,3
2019-05-13 05:07,URC,2159,737-800,19,8,24,2,2,22,,,,,5,3
2019-05-13 04:55,SYX,5479,737-800,27,6,30,5,5,31,,,,,3,4
2019-05-13 04:53,TYN,5090,737-800,5,8,22,6,8,22,,,,,17,17
2019-05-13 04:40,KMG,1208,737-800,20,2,24,2,2,22,,,,,4,2
2019-05-13 04:37,FOC,1569,737-800,24,2,28,2,3,26,,,,,4,2
2019-05-13 04:36,KMG,1209,737-800,22,4,28,4,4,25,,,,,6,3
2019-05-13 04:31,XIY,5115,737-800,14,4,18,6,6,28,,,,,4,14
2019-05-13 04:27,URC,6268,737-800,18,4,24,5,4,24,,,,,6,6
2019-05-13 04:26,XIY,5182,737-800,20,4,26,4,4,24,,,,,6,4
2019-05-13 04:25,XIY,5182,737-800,20,4,26,4,4,24,,,,,6,4
2019-05-13 04:18,XIY,1101,737-800,20,2,16,2,2,20,,,,,-4,0
2019-05-13 04:14,FOC,7395,737-800,27,6,26,6,6,26,,,,,-1,-1
2019-05-13 04:06,KMG,1586,737-800,20,4,26,6,4,28,,,,,6,8
2019-05-13 04:03,HAK,5462,737-800,28,4,34,4,4,34,,,,,6,6
2019-05-13 03:51,HAK,1787,737-800,27,4,34,6,6,35,,,,,7,8
2019-05-13 03:45,HAK,5623,737-800,28,5,35,5,5,31,,,,,7,3
2019-05-13 03:43,DLC,6062,737-800,19,4,26,3,3,25,,,,,7,6
2019-05-13 03:40,FOC,5430,737-800,26,7,30,8,6,29,,,,,4,3
2019-05-13 03:38,DLC,5853,737-800,19,6,28,6,6,26,,,,,9,7
2019-05-13 03:36,URC,205V,737-800,15,2,24,5,6,26,,,,,9,11
2019-05-13 03:35,URC,1569,737-800,15,2,24,1,0,22,,,,,9,7
2019-05-13 03:23,PEK,5482,737-800,15,5,28,5,4,26,,,,,13,11
2019-05-13 03:18,URC,205T,737-800,18,2,21,2,2,22,,,,,3,4
2019-05-13 03:15,URC,205U,737-800,18,4,23,4,4,23,,,,,5,5
2019-05-13 03:15,XIY,1163,737-800,14,2,28,4,4,24,,,,,14,10
2019-05-13 03:15,FOC,7105,737-800,25,5,32,6,5,30,,,,,7,5
2019-05-13 03:09,MIG,5449,737-800,16,5,27,5,5,26,,,,,11,10
2019-05-13 03:03,URC,1796,737-800,20,4,24,4,4,24,,,,,4,4
2019-05-13 03:01,XIY,5116,737-800,16,4,20,4,4,22,,,,,4,6
2019-05-13 03:00,HGH,5733,737-800,25,7,30,7,6,30,,,,,5,5
2019-05-13 02:59,HGH,1372,737-800,23,5,30,4,4,28,,,,,7,5
2019-05-13 02:54,URC,1725,737-800,19,4,27,4,5,27,,,,,8,8
2019-05-13 02:53,URC,5637,737-800,18,2,23,2,3,21,,,,,5,3
2019-05-13 02:53,CAN,1728,737-800,28,4,30,4,4,28,,,,,2,0
2019-05-13 02:51,XIY,5139,737-800,20,4,20,6,4,25,,,,,0,5
2019-05-13 02:49,KMG,7993,737-800,22,6,26,3,4,24,,,,,4,2
2019-05-13 02:47,HAK,5611,737-800,27,8,36,7,6,33,,,,,9,6
2019-05-13 02:47,HGH,5135,737-800,22,4,23,4,3,22,,,,,1,0
2019-05-13 02:43,SYX,206F,737-800,28,4,35,4,4,30,,,,,7,2
2019-05-13 02:39,KMG,7991,737-800,20,6,26,6,6,25,,,,,6,5
2019-05-13 02:39,KMG,7991,737-800,20,6,26,6,6,25,,,,,6,5
2019-05-13 02:38,XIY,1162,737-800,17,3,27,3,3,22,,,,,10,5
2019-05-13 02:36,MIG,1798,737-800,14,6,28,5,4,27,,,,,14,13
2019-05-13 02:36,URC,1568,737-800,20,4,24,6,6,20,,,,,4,0
2019-05-13 02:34,URC,206P,737-800,19,4,22,4,3,23,,,,,3,4
2019-05-13 02:34,URC,6995,737-800,20,2,20,5,4,22,,,,,0,2
2019-05-13 02:30,TYN,7616,737-800,14,4,20,4,4,20,,,,,6,6
2019-05-13 02:30,XIY,1482,737-800,20,5,26,5,6,27,,,,,6,7
2019-05-13 02:30,URC,5540,737-800,20,5,28,5,5,26,,,,,8,6
2019-05-13 02:26,º£¿Ú,1785,737-800,27,1,37,9,8,36,,,,,10,9
2019-05-13 02:25,HAK,1497,737-800,28,3,35,3,3,35,,,,,7,7
2019-05-13 02:25,SZX,1373,737-800,25,4,30,4,4,28,,,,,5,3
2019-05-13 02:24,XIY,1903,737-800,15,2,24,2,3,24,,,,,9,9
2019-05-13 02:19,KMG,1587,737-800,20,3,26,4,2,22,,,,,6,2
2019-05-13 02:19,XIY,1902,737-800,16,5,26,4,4,22,,,,,10,6
2019-05-13 02:18,SYX,5466,737-800,28,4,28,6,4,30,,,,,0,2
2019-05-13 02:18,CAN,5686,737-800,28,5,32,5,5,30,,,,,4,2
2019-05-13 02:15,XIY,1161,737-800,20,4,24,4,4,24,,,,,4,4
2019-05-13 02:14,SZX,1786,737-800,26,4,31,4,4,28,,,,,5,2
2019-05-13 02:11,SYX,1996,737-800,26,5,30,6,6,32,,,,,4,6
2019-05-13 02:08,URC,5797,737-800,20,6,19,6,5,20,,,,,-1,0
2019-05-13 02:06,HGH,1547,737-800,22,6,32,6,5,30,1,,,1,10,8
2019-05-13 02:05,SZX,7639,737-800,27,6,36,6,6,32,,,,,9,5
2019-05-13 01:59,HAK,5137,737-800,26,7,29,5,4,35,,,,,3,9
2019-05-13 01:57,SYX,1213,737-800,27,6,34,6,7,33,,,,,7,6
2019-05-13 01:55,HAK,1797,737-800,26,4,34,4,4,30,,,,,8,4
2019-05-13 01:54,XIY,1480,737-800,10,4,15,5,4,18,,,,,5,8
2019-05-13 01:54,HAK,1491,737-800,28,4,36,6,5,36,,,,,8,8
2019-05-13 01:52,HHA,6065,737-800,25,4,30,4,4,28,,,,,5,3
2019-05-13 01:52,TYN,206G,737-800,12,4,20,3,3,20,,,,,8,8
2019-05-13 01:52,PEK,5538,737-800,15,4,30,3,3,26,,,,,15,11
2019-05-13 01:51,CGO,7990,737-800,22,3,25,4,3,25,,,,,3,3
2019-05-13 01:51,HAK,7989,737-800,28,5,32,6,6,36,,,,,4,8
2019-05-13 01:50,HHA,1541,737-800,21,4,29,5,4,29,,,,,8,8
2019-05-13 01:49,ÒË²ý,1435,737-800,20,5,30,6,5,25,,,,,10,5
2019-05-13 01:47,HAK,5520,737-800,27,5,36,6,6,36,,,,,9,9
2019-05-13 01:47,CKG,1502,737-800,21,2,29,8,8,28,,,,,8,7
2019-05-13 01:45,CKG,7378,737-800,21,8,28,6,4,24,,,,,7,3
2019-05-13 01:42,ÒË²ý,1906,737-800,19,6,30,8,7,30,,,,,11,11
2019-05-13 01:37,CAN,5153,737-800,27,4,35,5,4,35,,,,,8,8
2019-05-13 01:37,HAK,1495,737-800,25,4,36,4,4,35,,,,,11,10
2019-05-13 01:35,DLC,1102,737-800,18,5,22,4,4,24,,,,,4,6
2019-05-13 01:35,CAN,1928,737-800,28,4,27,8,7,31,,,,,-1,3
2019-05-13 01:34,PEK,5465,737-800,10,3,22,3,3,24,,,,,12,14
2019-05-13 01:30,XIY,1487,737-800,16,4,24,2,4,24,,,,,8,8
2019-05-13 01:30,CAN,5406,737-800,25,4,26,4,5,27,,,,,1,2
2019-05-13 01:20,SZX,1501,737-800,25,4,35,4,5,30,,,,,10,5
2019-05-13 01:20,CAN,5735,737-800,30,6,34,5,6,34,,,,,4,4
2019-05-13 01:18,HGH,6808,737-800,23,6,28,4,4,26,,,,,5,3
2019-05-13 01:15,HRB,1350,737-800,18,3,22,4,5,25,,,,,4,7
2019-05-13 01:14,XIY,6103,737-800,16,6,26,6,6,26,,,,,10,10
2019-05-13 01:12,XIY,1103,737-800,16,4,30,4,4,24,,,,,14,8
2019-05-13 01:10,HHA,7398,737-800,25,4,28,3,3,27,,,,,3,2
2019-05-13 01:07,TYN,5405,737-800,20,4,24,2,2,20,,,,,4,0
2019-05-13 01:07,SZX,1501,737-800,25,4,38,4,5,30,,,,,13,5
2019-05-13 01:06,URC,5713,737-800,20,6,28,8,8,24,,,,,8,4
2019-05-13 01:05,SYX,5712,737-800,28,2,30,6,4,30,,,,,2,2
2019-05-13 01:04,CAN,5521,737-800,29,4,28,2,1,26,,,,,-1,-3
2019-05-13 01:00,HAK,5337,737-800,25,7,36,6,5,34,,,,,11,9
2019-05-13 00:56,URC,1726,737-800,23,4,24,4,4,24,,,,,1,1
2019-05-13 00:56,HGH,1505,737-800,25,4,30,4,4,26,,,,,5,1
2019-05-13 00:46,CGO,5418,737-800,23,3,18,5,5,22,,,,,-5,-1
2019-05-13 00:46,PEK,5428,737-800,18,4,22,4,4,21,,,,,4,3
2019-05-13 00:45,XIY,5375,737-800,20,0,16,6,5,22,,,,,-4,2
2019-05-13 00:38,TYN,5636,737-800,20,5,20,5,4,22,,,,,0,2
2019-05-13 00:35,CAN,5417,737-800,28,4,30,4,4,32,,,,,2,4
2019-05-13 00:30,KMG,5409,737-800,20,4,21,4,4,23,,,,,1,3
2019-05-13 00:29,XIY,7619,737-800,20,4,24,5,5,22,,,,,4,2
2019-05-13 00:25,CAN,1492,737-800,26,4,32,4,5,30,,,,,6,4
2019-05-13 00:23,CGO,1322,737-800,22,4,25,4,4,25,,,,,3,3
2019-05-13 00:19,CAN,5429,737-800,28,4,30,4,4,31,,,,,2,3
2019-05-13 00:13,CKG,5522,737-800,22,5,28,7,6,27,,,,,6,5
2019-05-13 00:07,URC,5625,737-800,21,4,22,4,4,21,,,,,1,0
2019-05-12 23:58,HGH,1496,737-800,25,6,32,6,6,32,,,,,7,7
2019-05-12 23:53,PEK,5338,737-800,16,4,20,3,4,22,,,,,4,6
2019-05-12 23:47,HHA,5480,737-800,20,4,28,4,2,29,,,,,8,9
2019-05-12 23:46,HAK,5852,737-800,27,5,31,6,5,30,,,,,4,3
2019-05-12 23:44,XNN,7377,737-800,10,5,20,5,5,22,,,,,10,12
2019-05-12 23:44,SZX,1386,737-800,27,4,30,4,4,28,,,,,3,1
2019-05-12 23:41,PEK,1346,737-800,20,5,28,3,5,21,,,,,8,1
2019-05-12 23:39,PEK,5136,737-800,17,4,22,5,5,30,,,,,5,13
2019-05-12 23:36,HRB,1905,737-800,15,3,22,3,4,21,,,,,7,6
2019-05-12 23:30,SYX,5467,737-800,27,7,36,5,3,30,,,,,9,3
2019-05-12 23:27,XIY,5687,737-800,20,4,18,4,6,24,,,,,-2,4
2019-05-12 23:15,HAK,1927,737-800,28,2,28,5,3,28,,,,,0,0
2019-05-12 23:08,SYX,6061,737-800,28,4,33,5,4,30,,,,,5,2
2019-05-12 23:08,HAK,1549,737-800,26,6,34,5,6,36,,,,,8,10
2019-05-12 23:04,KMG,5407,737-800,23,4,24,6,4,24,,,,,1,1
2019-05-12 22:59,CGO,1542,737-800,20,4,25,4,4,22,,,,,5,2
2019-05-12 22:57,URC,2157,737-800,21,5,22,6,6,18,,,,,1,-3
2019-05-12 22:56,SYX,1538,737-800,28,3,34,4,3,31,,,,,6,3
2019-05-12 22:53,DLC,7400,737-800,18,4,22,4,4,26,,,,,4,8
2019-05-12 22:50,XIY,5372,737-800,16,8,26,8,8,22,,,,,10,6
2019-05-12 22:49,HAK,1783,737-800,25,4,24,5,4,36,,1,,1,-1,11
2019-05-12 22:45,CGO,5620,737-800,20,4,24,3,6,24,,,,,4,4
2019-05-12 22:42,DLC,1545,737-800,15,5,24,4,5,22,,,,,9,7
2019-05-12 22:40,URC,7198,737-800,24,4,22,4,2,22,,,,,-2,-2
2019-05-12 22:40,SZX,1493,737-800,27,6,29,7,7,27,,,,,2,0
2019-05-12 22:30,XIY,5371,737-800,18,8,22,6,7,23,,,,,4,5
2019-05-12 22:27,HRB,1562,737-800,22,6,26,5,4,26,,,,,4,4
2019-05-12 22:27,DLC,1375,737-800,20,4,26,4,4,25,,,,,6,5
2019-05-12 22:23,CGO,7988,737-800,23,4,27,4,4,24,,,,,4,1
2019-05-12 22:12,CGO,6800,737-800,20,2,22,4,4,24,,,,,2,4
2019-05-12 22:08,URC,5581,737-800,23,4,18,5,4,24,,,,,-5,1
2019-05-12 21:58,HAK,1733,737-800,28,3,33,3,3,28,,,,,5,0
2019-05-12 21:41,MIG,5732,737-800,15,2,26,2,2,27,,,,,11,12
2019-05-12 21:36,XNN,1735,737-800,10,5,20,5,5,18,,,,,10,8
2019-05-12 20:54,SYX,7886,737-800,25,4,32,4,6,32,,,,,7,7
2019-05-12 20:47,HAK,206H,737-800,30,4,28,3,3,30,,,,,-2,0
2019-05-12 20:03,HAK,7399,737-800,29,4,33,4,4,28,,,,,4,-1
2019-05-12 19:58,HGH,5478,737-800,24,4,32,4,4,30,,,,,8,6
2019-05-12 19:52,HAK,5439,737-800,28,8,35,4,4,34,,,,,7,6
2019-05-12 19:13,HRB,1351,737-800,26,3,26,4,4,21,,,,,0,-5
2019-05-12 18:34,HAK,1995,737-800,30,9,36,5,5,32,,,,,6,2
2019-05-12 18:31,XIY,5138,737-800,21,4,22,4,4,26,,,,,1,5
2019-05-12 18:29,XIY,6063,737-800,24,5,30,5,5,28,,,,,6,4
2019-05-12 16:50,SZX,1130,737-800,32,2,33,3,3,30,,,,,1,-2
2019-05-12 16:48,HGH,5463,737-800,30,5,25,4,4,24,,,,,-5,-6
2019-05-12 14:33,XIY,7173,737-800,20,4,28,5,4,24,,,,,8,4
2019-05-12 14:33,SYX,7618,737-800,31,6,34,7,6,34,,,,,3,3
2019-05-12 13:41,Î÷°²,5180,737-800,27,2,27,6,6,26,,,,,0,-1
2019-05-12 13:35,YIH,1433,737-800,22,3,28,3,3,24,,,,,6,2
2019-05-12 13:08,HGH,5540,737-800,32,6,36,6,6,33,,,,,4,1
2019-05-12 12:36,HAK,5358,737-800,34,8,36,8,9,36,,,,,2,2
2019-05-12 10:31,ÐìÖÝ,7167,737-800,20,6,30,8,7,28,,,,,10,8
2019-05-12 09:56,HGH,5709,737-800,24,6,28,6,7,28,,,,,4,4
2019-05-12 09:54,HGH,5416,737-800,24,7,24,6,7,28,,,,,0,4
2019-05-12 08:38,ZGC,5408,737-800,10,4,22,4,4,18,,,,,12,8
2019-05-12 08:37,ZGC,1141,737-800,15,8,28,4,6,20,,,,,13,5
2019-05-12 08:21,PEK,5346,737-800,21,4,27,5,5,26,,,,,6,5
2019-05-12 08:13,PEK,7173,737-800,22,4,27,5,4,27,,,,,5,5
2019-05-12 08:05,XMN,7171,737-800,24,4,27,3,4,32,,,,,3,8
2019-05-12 08:04,XMN,1798,737-800,24,3,26,3,4,21,,,,,2,-3
2019-05-12 08:03,XMN,1215,737-800,24,4,29,4,4,30,,,,,5,6
2019-05-12 08:03,XMN,1548,737-800,24,4,28,5,6,26,,,,,4,2
2019-05-12 08:02,XMN,5855,737-800,24,6,31,6,5,24,,,,,7,0
2019-05-12 07:46,HAK,5733,737-800,27,4,33,5,4,33,,,,,6,6
2019-05-12 07:28,PEK,5713,737-800,21,7,25,6,6,24,,,,,4,3
2019-05-12 07:24,SZX,5137,737-800,25,2,20,3,2,28,,,,,-5,3
2019-05-12 07:14,PEK,5338,737-800,20,3,22,2,4,26,,,,,2,6
2019-05-12 06:57,KMG,5409,737-800,20,2,22,3,3,24,,,,,2,4
2019-05-12 06:26,KMG,6809,737-800,23,4,28,6,6,24,,,,,5,1
2019-05-12 06:05,URC,5463,737-800,17,5,18,5,5,18,,,,,1,1
2019-05-12 05:58,XIY,6103,737-800,20,6,26,6,6,27,,,,,6,7
2019-05-12 05:33,CKG,1549,737-800,20,6,32,7,7,30,,,,,12,10
2019-05-12 05:31,CGO,6016,737-800,21,4,28,4,4,26,,,,,7,5
2019-05-12 05:20,PEK,5539,737-800,20,4,32,5,4,30,,,,,12,10
2019-05-12 05:08,CAN,1131,737-800,28,4,35,4,4,35,,,,,7,7
2019-05-12 04:49,URC,1929,737-800,18,4,20,4,4,22,,,,,2,4
2019-05-12 04:43,PEK,5482,737-800,21,3,28,4,4,29,,,,,7,8
2019-05-12 04:40,KMG,7991,737-800,20,6,24,7,7,25,,,,,4,5
2019-05-12 04:30,URC,5797,737-800,15,5,18,4,5,20,,,,,3,5
2019-05-12 04:23,CGO,7988,737-800,21,5,28,5,6,28,,,,,7,7
2019-05-12 04:21,CGO,1588,737-800,21,4,26,4,5,28,,,,,5,7
2019-05-12 04:18,URC,5636,737-800,17,5,22,5,4,22,,,,,5,5
2019-05-12 04:16,CAN,5686,737-800,29,4,30,4,4,28,,,,,1,-1
2019-05-12 04:03,HAK,1726,737-800,25,6,35,6,6,32,1,,,1,10,7
2019-05-12 03:56,KMG,1587,737-800,19,3,23,3,3,21,,,,,4,2
2019-05-12 03:47,FOC,5662,737-800,21,2,27,3,6,27,,,,,6,6
2019-05-12 03:43,HAK,1783,737-800,26,8,31,8,8,30,,,,,5,4
2019-05-12 03:37,HRB,1562,737-800,21,4,24,6,6,24,,,,,3,3
2019-05-12 03:36,HRB,1562,737-800,21,4,24,20,20,40,,,,,3,19
2019-05-12 03:34,HGH,5139,737-800,25,7,22,6,4,28,,,,,-3,3
2019-05-12 03:29,FOC,5430,737-800,21,4,28,4,4,30,,,,,7,9
2019-05-12 03:25,URC,5611,737-800,17,5,24,3,3,23,,,,,7,6
2019-05-12 03:23,URC,1346,737-800,16,5,27,4,5,20,,,,,11,4
2019-05-12 03:21,URC,7198,737-800,16,6,23,6,5,22,,,,,7,6
2019-05-12 03:19,SZX,5540,737-800,26,6,35,5,5,30,,,,,9,4
2019-05-12 03:07,URC,6268,737-800,21,4,25,4,4,24,,,,,4,3
2019-05-12 03:07,URC,6995,737-800,19,4,24,7,8,22,,,,,5,3
2019-05-12 03:02,CAN,B1728,737-800,27,4,30,5,5,26,,,,,3,-1
2019-05-12 02:58,URC,1725,737-800,15,4,25,4,3,25,,,,,10,10
2019-05-12 02:58,CAN,5623,737-800,25,6,28,6,6,30,,,,,3,5
2019-05-12 02:55,PEK,5538,737-800,21,3,34,2,2,30,,,,,13,9
2019-05-12 02:55,PEK,5136,737-800,28,4,28,3,2,28,,,,,0,0
2019-05-12 02:54,PEK,5539,737-800,21,3,34,2,2,30,,,,,13,9
2019-05-12 02:52,URC,1325,737-800,21,4,25,4,4,23,,,,,4,2
2019-05-12 02:51,KMG,7993,737-800,20,4,24,5,4,22,,,,,4,2
2019-05-12 02:50,HAK,1373,737-800,25,4,33,4,4,30,,,,,8,5
2019-05-12 02:49,DLC,5853,737-800,15,6,25,2,4,22,,,,,10,7
2019-05-12 02:48,SYX,1996,737-800,27,3,29,6,6,30,,,,,2,3
2019-05-12 02:46,SYX,1505,737-800,28,4,34,3,4,34,,,,,6,6
2019-05-12 02:45,HHA,1491,737-800,25,5,30,5,5,30,,,,,5,5
2019-05-12 02:44,URC,206P,737-800,17,4,20,5,5,20,,,,,3,3
2019-05-12 02:43,CGO,5466,737-800,22,2,22,8,2,25,,,,,0,3
2019-05-12 02:42,XIY,1163,737-800,20,4,22,4,4,24,,,,,2,4
2019-05-12 02:40,HAK,5520,737-800,25,4,35,4,4,34,1,,,1,10,9
2019-05-12 02:39,XIY,1502,737-800,20,2,22,3,2,21,,,,,2,1
2019-05-12 02:39,URC,1995,737-800,17,6,22,5,6,22,,,,,5,5
2019-05-12 02:38,XIY,5182,737-800,20,3,30,3,3,25,,,,,10,5
2019-05-12 02:34,XIY,1903,737-800,22,2,26,2,2,26,,,,,4,4
2019-05-12 02:32,DLC,6062,737-800,14,4,24,2,4,24,,,,,10,10
2019-05-12 02:30,SZX,6808,737-800,24,3,29,4,4,30,,,,,5,6
2019-05-12 02:28,URC,1569,737-800,17,3,25,3,2,23,,,,,8,6
2019-05-12 02:28,URC,5661,737-800,17,4,20,4,4,22,,,,,3,5
2019-05-12 02:27,XIY,5115,737-800,20,3,19,5,6,26,,,,,-1,6
2019-05-12 02:26,XIY,5138,737-800,21,4,25,8,9,26,,,,,4,5
2019-05-12 02:24,XIY,1483,737-800,25,5,26,6,5,24,,,,,1,-1
2019-05-12 02:21,URC,2159,737-800,17,3,20,1,2,21,,,,,3,4
2019-05-12 02:21,KMG,1288,737-800,20,4,26,4,4,22,,,,,6,2
2019-05-12 02:21,HAK,1492,737-800,25,3,32,2,2,30,,,,,7,5
2019-05-12 02:20,DLC,7175,737-800,15,5,28,3,4,22,,,,,13,7
2019-05-12 02:16,TYN,7378,737-800,20,3,22,3,4,24,,,,,2,4
2019-05-12 02:09,KMG,7167,737-800,25,6,25,6,6,24,,,,,0,-1
2019-05-12 02:03,SYX,1542,737-800,29,4,34,5,4,31,,,,,5,2
2019-05-12 02:02,HHA,1490,737-800,25,4,27,4,5,28,,,,,2,3
2019-05-12 02:02,FOC,1559,737-800,25,3,18,3,3,26,,,,,-7,1
2019-05-12 01:58,XIY,1103,737-800,24,4,28,5,5,28,,,,,4,4
2019-05-12 01:57,XIY,1902,737-800,21,4,26,6,6,25,,,,,5,4
2019-05-12 01:56,XIY,7400,737-800,20,4,26,4,4,26,,,,,6,6
2019-05-12 01:52,XIY,6063,737-800,21,6,32,6,6,29,,,,,11,8
2019-05-12 01:52,HAK,7619,737-800,27,5,30,5,6,32,,,,,3,5
2019-05-12 01:50,HHA,1787,737-800,25,5,23,4,4,23,,,,,-2,-2
2019-05-12 01:45,HAK,5480,737-800,26,6,34,5,3,32,,,,,8,6
2019-05-12 01:42,SYX,5479,737-800,27,3,32,5,6,31,,,,,5,4
2019-05-12 01:39,DLC,1375,737-800,20,4,24,4,3,22,,,,,4,2
2019-05-12 01:39,HAK,5373,737-800,27,6,32,9,9,33,,,,,5,6
2019-05-12 01:38,CGO,1586,737-800,21,4,29,4,4,29,,,,,8,8
2019-05-12 01:38,HAK,5852,737-800,25,4,30,5,4,30,,,,,5,5
2019-05-12 01:37,YIH,1906,737-800,35,6,32,7,7,30,,,,,-3,-5
2019-05-12 01:37,SYX,1213,737-800,28,6,36,6,6,36,,,,,8,8
2019-05-12 01:37,CGO,1322,737-800,21,4,27,4,3,26,,,,,6,5
2019-05-12 01:37,SYX,5712,737-800,28,2,28,9,2,29,,,,,0,1
2019-05-12 01:35,HGH,1796,737-800,26,4,28,4,4,24,,,,,2,-2
2019-05-12 01:32,DLC,1102,737-800,14,4,26,4,4,26,,,,,12,12
2019-05-12 01:32,ZGC,5359,737-800,10,4,20,4,4,20,,,,,10,10
2019-05-12 01:30,SZX,1501,737-800,26,3,33,3,4,30,,,,,7,4
2019-05-12 01:29,CAN,5481,737-800,29,5,30,6,5,30,,,,,1,1
2019-05-12 01:27,XIY,5180,737-800,20,5,20,4,4,22,,,,,0,2
2019-05-12 01:26,DLC,6060,737-800,15,4,26,4,4,24,,,,,11,9
2019-05-12 01:23,XIY,1348,737-800,22,3,26,3,3,25,,,,,4,3
2019-05-12 01:20,HAK,1928,737-800,26,6,30,6,6,31,,,,,4,5
2019-05-12 01:18,HAK,1785,737-800,28,2,34,9,9,33,,,,,6,5
2019-05-12 01:16,CAN,1733,737-800,28,3,30,3,3,28,,,,,2,0
2019-05-12 01:16,XIY,1482,737-800,23,6,30,6,5,24,,,,,7,1
2019-05-12 01:14,TYN,5502,737-800,15,4,20,5,5,20,,,,,5,5
2019-05-12 01:14,DLC,5687,737-800,15,5,23,5,5,22,,,,,8,7
2019-05-12 01:11,CHO,6800,737-800,22,4,26,4,4,26,,,,,4,4
2019-05-12 01:07,MIG,5449,737-800,20,4,28,4,4,28,,,,,8,8
2019-05-12 00:59,XIY,1162,737-800,23,4,28,2,3,26,,,,,5,3
2019-05-12 00:57,XIY,7618,737-800,22,4,26,5,5,26,,,,,4,4
2019-05-12 00:54,HAK,5406,737-800,27,4,32,7,4,33,,,,,5,6
2019-05-12 00:53,URC,5637,737-800,21,3,22,2,2,22,,,,,1,1
2019-05-12 00:53,URC,5637,737-800,18,3,22,2,2,22,,,,,4,4
2019-05-12 00:53,HGH,5478,737-800,25,3,30,4,3,28,,,,,5,3
2019-05-12 00:52,XIY,5372,737-800,24,7,30,7,8,34,,,,,6,10
2019-05-12 00:50,TYN,5090,737-800,20,2,22,4,4,24,,,,,2,4
2019-05-12 00:49,HHA,5483,737-800,25,4,24,4,4,26,,,,,-1,1
2019-05-12 00:46,FOC,1905,737-800,22,4,28,4,4,25,,,,,6,3
2019-05-12 00:45,MIG,5732,737-800,16,2,28,3,2,26,,,,,12,10
2019-05-12 00:44,PEK,1545,737-800,22,4,28,5,5,27,,,,,6,5
2019-05-12 00:40,KHG,1323,737-800,24,4,23,4,4,24,,,,,-1,0
2019-05-12 00:35,CKG,7379,737-800,25,4,33,4,4,32,,,,,8,7
2019-05-12 00:33,CAN,1347,737-800,27,4,34,4,4,31,,,,,7,4
2019-05-12 00:33,HHA,6065,737-800,25,5,25,5,4,24,,,,,0,-1
2019-05-12 00:33,SZX,1493,737-800,26,6,28,6,6,26,,,,,2,0
2019-05-12 00:31,SZX,5358,737-800,25,7,30,6,6,31,,,,,5,6
2019-05-12 00:29,TYN,5625,737-800,23,4,26,5,5,23,,,,,3,0
2019-05-12 00:28,KMF,7990,737-800,25,4,24,1,4,24,,,,,-1,-1
2019-05-12 00:27,CAN,5417,737-800,25,5,30,4,5,30,,,,,5,5
2019-05-12 00:22,URC,1570,737-800,16,5,22,8,8,24,,,,,6,8
2019-05-12 00:22,CAN,1489,737-800,37,4,30,5,4,30,,,,,-7,-7
2019-05-12 00:20,URC,1727,737-800,15,4,22,5,4,18,,,,,7,3
2019-05-12 00:19,FOC,1480,737-800,22,6,26,4,4,24,,,,,4,2
2019-05-12 00:18,HRB,7105,737-800,19,4,25,4,5,25,,,,,6,6
2019-05-12 00:17,FOC,7395,737-800,23,6,28,6,6,28,,,,,5,5
2019-05-12 00:17,SYX,1538,737-800,28,2,32,3,2,30,,,,,4,2
2019-05-12 00:15,YIH,1433,737-800,35,3,29,3,2,22,,,,,-6,-13
2019-05-12 00:14,URC,5580,737-800,18,6,22,6,6,26,,,,,4,8
2019-05-12 00:10,HGH,1547,737-800,20,6,30,6,6,30,,,,,10,10
2019-05-12 00:08,HAK,1209,737-800,28,4,35,4,4,34,,,,,7,6
2019-05-12 00:08,SZX,7639,737-800,25,6,34,3,3,30,,,,,9,5
2019-05-12 00:03,HAK,1541,737-800,25,6,34,4,4,33,,,,,9,8
2019-05-12 00:00,FOC,205V,737-800,21,4,30,4,4,29,,,,,9,8
2019-05-11 23:58,HAK,7992,737-800,26,7,31,8,8,32,,,,,5,6
2019-05-11 23:58,CKG,5522,737-800,25,7,30,9,9,31,,,,,5,6
2019-05-11 23:56,DLC,1488,737-800,20,6,27,6,5,24,,,,,7,4
2019-05-11 23:55,SYX,7399,737-800,28,4,33,4,4,34,,,,,5,6
2019-05-11 23:54,SZX,1130,737-800,26,2,31,2,2,30,,,,,5,4
2019-05-11 23:54,XIY,5371,737-800,22,5,20,5,6,22,,,,,-2,0
2019-05-11 23:53,HAK,1497,737-800,25,3,33,4,4,34,,,,,8,9
2019-05-11 23:50,MIG,5407,737-800,18,4,28,5,3,28,,,,,10,10
2019-05-11 23:29,URC,205T,737-800,19,3,24,3,3,25,,,,,5,6
2019-05-11 23:28,HAK,5462,737-800,25,5,34,5,5,34,,,,,9,9
2019-05-11 23:23,XIY,7616,737-800,25,2,23,2,3,23,,,,,-2,-2
2019-05-11 23:23,PEK,5136,737-800,23,4,28,4,4,30,,,,,5,7
2019-05-11 23:21,SYX,1538,737-800,28,3,36,3,2,32,,,,,8,4
2019-05-11 23:19,HAK,1793,737-800,28,4,34,4,4,30,,,,,6,2
2019-05-11 23:13,DLC,1487,737-800,16,4,24,3,2,22,,,,,8,6
2019-05-11 23:09,PEK,5465,737-800,23,6,29,4,4,28,,,,,6,5
2019-05-11 23:07,CAN,6061,737-800,28,4,32,5,4,30,,,,,4,2
2019-05-11 23:05,HAK,5579,737-800,25,6,36,7,7,35,,,,,11,10
2019-05-11 22:48,HAK,5153,737-800,26,4,30,4,4,34,,,,,4,8
2019-05-11 22:48,HAK,1386,737-800,28,4,32,3,4,30,,,,,4,2
2019-05-11 22:47,HRB,1351,737-800,23,4,25,4,4,24,,,,,2,1
2019-05-11 22:38,HGH,1496,737-800,27,4,28,2,2,27,,,,,1,0
2019-05-11 22:30,HAK,1786,737-800,25,6,35,4,2,33,1,,,1,10,8
2019-05-11 22:19,CAN,5521,737-800,29,6,28,3,2,27,,,,,-1,-2
2019-05-11 22:15,SYX,1101,737-800,29,4,34,4,3,36,,,,,5,7
2019-05-11 21:49,URC,1568,737-800,20,4,21,5,4,22,,,,,1,2
2019-05-11 21:33,MIG,1798,737-800,20,6,28,6,6,28,,,,,8,8
2019-05-11 21:30,DLC,7175,737-800,15,5,28,3,4,22,,,,,13,7
2019-05-11 21:29,HAK,206H,737-800,28,3,33,9,8,25,,,,,5,-3
2019-05-11 21:26,HAK,1797,737-800,26,4,32,4,4,30,,,,,6,4
2019-05-11 21:26,DLC,5620,737-800,17,2,26,2,5,23,,,,,9,6
2019-05-11 20:53,FOC,7113,737-800,22,4,28,5,5,26,,,,,6,4
2019-05-11 20:51,HAK,5082,737-800,26,6,35,4,4,32,,,,,9,6
2019-05-11 20:12,HAK,1498,737-800,27,4,34,4,4,28,,,,,7,1
2019-05-11 20:12,HAK,1498,737-800,27,4,34,4,4,28,,,,,7,1
2019-05-11 20:00,HAK,5089,737-800,29,6,30,2,2,34,,,,,1,5
2019-05-11 19:21,SYX,7886,737-800,30,4,35,3,3,34,,,,,5,4
2019-05-11 19:16,SYX,1997,737-800,28,5,36,4,5,30,,,,,8,2
2019-05-11 18:52,URC,205U,737-800,25,4,21,4,3,22,,,,,-4,-3
2019-05-11 17:16,YIH,1435,737-800,30,6,29,6,6,28,,,,,-1,-2
2019-05-11 17:09,URC,5580,737-800,24,4,20,6,5,22,,,,,-4,-2
2019-05-11 16:11,CGO,5375,737-800,28,2,22,5,4,27,,,,,-6,-1
2019-05-11 15:29,TYN,5429,737-800,30,6,26,6,5,25,,,,,-4,-5
2019-05-11 15:20,URC,1795,737-800,20,6,24,4,5,22,,,,,4,2
2019-05-11 14:50,HHA,5638,737-800,30,4,25,4,4,30,,,,,-5,0
2019-05-11 14:43,XIY,1927,737-800,30,2,22,9,3,26,,,,,-8,-4
2019-05-11 13:07,XUZ,7989,737-800,30,4,34,6,6,30,,,,,4,0
2019-05-11 11:07,CTU,7992,737-800,27,7,28,7,6,27,,,,,1,0
2019-05-11 10:08,HAK,7172,737-800,32,5,34,6,5,33,,,,,2,1
2019-05-11 09:24,PEK,1726,737-800,21,4,24,3,4,24,,,,,3,3
2019-05-11 09:21,ZGC,5416,737-800,10,8,26,9,9,30,,,,,16,20
2019-05-11 09:09,HAK,7377,737-800,26,4,33,6,6,33,,,,,7,7
2019-05-11 09:08,HAK,5408,737-800,26,4,30,5,6,32,,,,,4,6
2019-05-11 09:01,XIY ,1161,737-800,21,3,26,3,4,26,,,,,5,5
2019-05-11 09:00,CAN,1215,737-800,25,5,35,3,4,30,,,,,10,5
2019-05-11 08:55,CAN,1538,737-800,25,2,32,4,3,30,,,,,7,5
2019-05-11 08:54,CAN,1541,737-800,25,5,30,6,5,32,,,,,5,7
2019-05-11 08:45,FOC ,1559,737-800,20,3,20,2,3,22,,,,,0,2
2019-05-11 07:31,PEK,5712,737-800,20,3,22,3,3,18,,,,,2,-2
2019-05-11 07:12,FOC,7395,737-800,22,6,28,6,6,29,,,,,6,7
2019-05-11 07:07,CAN,1733,737-800,27,3,30,4,4,26,,,,,3,-1
2019-05-11 07:06,PEK,7173,737-800,22,4,30,5,5,26,,,,,8,4
2019-05-11 06:54,SZX ,7639,737-800,25,6,34,6,6,30,,,,,9,5
2019-05-11 06:26,HAK,5733,737-800,26,6,34,6,6,34,,,,,8,8
2019-05-11 06:25,HAK,1489,737-800,26,4,32,4,4,32,,,,,6,6
2019-05-11 06:07,XIY,1163,737-800,21,2,20,2,3,21,,,,,-1,0
2019-05-11 05:52,URC,205V,737-800,14,8,26,6,8,24,,,,,12,10
2019-05-11 05:12,KMG,5449,737-800,22,5,25,3,4,26,,,,,3,4
2019-05-11 05:02,HHA,1491,737-800,20,4,24,4,4,24,,,,,4,4
2019-05-11 04:52,PEK,5539,737-800,19,5,29,5,5,28,,,,,10,9
2019-05-11 04:50,URC,7198,737-800,19,3,22,3,24,23,1,,,1,3,4
2019-05-11 04:42,KMG,6809,737-800,15,5,22,5,6,26,,,,,7,11
2019-05-11 04:29,KMG,7167,737-800,20,6,26,6,6,24,,,,,6,4
2019-05-11 04:29,CKG,1997,737-800,22,5,27,3,3,24,,,,,5,2
2019-05-11 04:24,HGH,5141,737-800,22,5,25,4,5,27,,,,,3,5
2019-05-11 04:14,XIY,1902,737-800,20,4,20,5,5,24,,,,,0,4
2019-05-11 04:05,HAK,1373,737-800,26,4,33,4,4,28,,,,,7,2
2019-05-11 04:03,HAK,1502,737-800,25,3,34,4,4,32,,,,,9,7
2019-05-11 04:01,HAK,5417,737-800,27,4,32,4,4,32,,,,,5,5
2019-05-11 03:55,URC,6268,737-800,21,4,28,4,5,26,,,,,7,5
2019-05-11 03:48,CKG,5406,737-800,21,5,27,4,4,26,,,,,6,5
2019-05-11 03:47,ZGC,5522,737-800,15,3,20,1,2,18,,,,,5,3
2019-05-11 03:45,KMG,6016,737-800,20,4,26,2,2,26,,,,,6,6
2019-05-11 03:35,URC,1570,737-800,20,6,22,6,6,20,,,,,2,0
2019-05-11 03:35,HAK,1785,737-800,26,5,34,8,7,33,,,,,8,7
2019-05-11 03:33,HAK,5375,737-800,27,6,32,8,9,34,,,,,5,7
2019-05-11 03:31,SYX,5467,737-800,26,4,36,4,2,28,1,,,1,10,2
2019-05-11 03:30,XIY,1501,737-800,21,3,28,4,4,26,,,,,7,5
2019-05-11 03:30,XIY,5116,737-800,20,4,24,4,4,24,,,,,4,4
2019-05-11 03:28,URC,2157,737-800,20,4,22,8,2,20,,,,,2,0
2019-05-11 03:23,URC,5463,737-800,23,5,20,5,5,20,,,,,-3,-3
2019-05-11 03:23,CAN,1541,737-800,25,5,30,6,5,32,,,,,5,7
2019-05-11 03:21,FOC,1435,737-800,22,6,28,5,5,25,,,,,6,3
2019-05-11 03:19,URC,1569,737-800,20,4,25,4,4,28,,,,,5,8
2019-05-11 03:13,PEK,5482,737-800,21,2,30,4,3,30,,,,,9,9
2019-05-11 03:11,ZGC,5358,737-800,15,6,22,6,5,23,,,,,7,8
2019-05-11 03:09,SZX,7171,737-800,24,5,30,4,4,30,,,,,6,6
2019-05-11 03:05,XIY,5620,737-800,19,4,29,4,4,24,,,,,10,5
2019-05-11 03:05,CAN,1538,737-800,25,2,32,4,3,30,,,,,7,5
2019-05-11 03:04,HAK,5359,737-800,25,7,30,4,5,32,,,,,5,7
2019-05-11 03:02,SYX,5735,737-800,25,1,30,1,1,30,,,,,5,5
2019-05-11 03:00,HHA,6066,737-800,21,2,28,2,2,25,,,,,7,4
2019-05-11 02:55,URC,206P,737-800,20,4,24,4,4,24,,,,,4,4
2019-05-11 02:52,PEK,5713,737-800,18,7,26,6,6,26,,,,,8,8
2019-05-11 02:48,URC,1325,737-800,20,6,20,4,4,22,,,,,0,2
2019-05-11 02:48,SYX,5479,737-800,27,6,35,6,7,36,,,,,8,9
2019-05-11 02:45,HGH,1372,737-800,23,6,26,5,4,27,,,,,3,4
2019-05-11 02:45,PEK,5538,737-800,25,3,23,3,3,30,,,,,-2,5
2019-05-11 02:41,URC,1346,737-800,20,8,26,6,6,22,,,,,6,2
2019-05-11 02:40,XIY,1162,737-800,15,2,28,2,4,30,,,,,13,15
2019-05-11 02:36,URC,5611,737-800,20,5,25,6,5,23,,,,,5,3
2019-05-11 02:34,CAN,5623,737-800,26,6,33,6,6,30,,,,,7,4
2019-05-11 02:32,HHA,6065,737-800,21,4,29,4,4,28,,,,,8,7
2019-05-11 02:29,HGH,5153,737-800,25,3,30,3,3,30,,,,,5,5
2019-05-11 02:27,HHA,1386,737-800,22,2,26,2,2,24,,,,,4,2
2019-05-11 02:24,CGO,7988,737-800,21,5,26,5,4,26,,,,,5,5
2019-05-11 02:19,SZX,5540,737-800,24,5,0,5,5,32,,,,,-24,8
2019-05-11 02:18,HGH,5439,737-800,22,4,25,4,4,25,,,,,3,3
2019-05-11 02:16,SYX,1101,737-800,26,4,36,2,2,34,1,,,1,10,8
2019-05-11 02:14,FOC,1480,737-800,20,4,23,4,4,23,,,,,3,3
2019-05-11 02:14,CGO,7886,737-800,23,4,27,4,4,27,,,,,4,4
2019-05-11 02:13,FOC,1480,737-800,19,4,24,5,4,24,,,,,5,5
2019-05-11 02:13,TYN,1488,737-800,15,6,28,6,5,23,,,,,13,8
2019-05-11 02:10,HGH,1547,737-800,25,6,30,6,6,30,,,,,5,5
2019-05-11 02:08,TYN,5852,737-800,12,4,24,4,4,23,,,,,12,11
2019-05-11 02:06,URC,2159,737-800,22,6,24,4,4,24,,,,,2,2
2019-05-11 02:03,SZX,5137,737-800,24,3,29,2,2,28,,,,,5,4
2019-05-11 02:02,108,5482,737-800,21,2,30,5,4,30,,,,,9,9
2019-05-11 02:01,CGO,6800,737-800,20,4,25,5,4,24,,,,,5,4
2019-05-11 02:00,XIY,1348,737-800,21,4,28,4,4,27,,,,,7,6
2019-05-11 02:00,HHA,5346,737-800,22,6,26,4,4,24,,,,,4,2
2019-05-11 01:59,CAN,5686,737-800,27,5,30,4,5,29,,,,,3,2
2019-05-11 01:59,HAK,1783,737-800,30,2,30,4,4,34,,,,,0,4
2019-05-11 01:56,HAK,5429,737-800,26,3,30,4,4,31,,,,,4,5
2019-05-11 01:56,FOC,5136,737-800,25,4,29,5,5,32,,,,,4,7
2019-05-11 01:54,HHA,7398,737-800,25,4,30,3,4,26,,,,,5,1
2019-05-11 01:53,SYX,1796,737-800,27,4,36,4,4,30,,,,,9,3
2019-05-11 01:53,HGH,5478,737-800,30,5,28,5,4,28,,,,,-2,-2
2019-05-11 01:52,PEK,1495,737-800,20,4,24,4,4,25,,,,,4,5
2019-05-11 01:52,URC,205T,737-800,15,4,24,4,4,24,,,,,9,9
2019-05-11 01:50,DLC,6062,737-800,17,4,26,4,4,26,,,,,9,9
2019-05-11 01:49,XMN,1347,737-800,20,2,28,3,4,26,,,,,8,6
2019-05-11 01:47,XMN,5855,737-800,20,6,28,7,6,30,,,,,8,10
2019-05-11 01:47,CAN,6061,737-800,26,4,32,5,5,30,,,,,6,4
2019-05-11 01:46,XMN,5581,737-800,20,5,15,2,3,15,,,,,-5,-5
2019-05-11 01:46,CGO,205U,737-800,20,4,26,4,4,27,,,,,6,7
2019-05-11 01:45,XMN,1542,737-800,20,2,30,4,4,26,,,,,10,6
2019-05-11 01:44,URC,1568,737-800,15,6,24,6,6,24,,,,,9,9
2019-05-11 01:42,YIH,1350,737-800,22,4,28,4,4,24,,,,,6,2
2019-05-11 01:40,XIY,1482,737-800,21,6,30,6,6,28,,,,,9,7
2019-05-11 01:39,XIY,1482,737-800,21,6,30,6,6,28,,,,,9,7
2019-05-11 01:35,XIY,5115,737-800,20,4,20,5,5,18,,,,,0,-2
2019-05-11 01:31,SYX,1549,737-800,27,3,34,4,4,32,,,,,7,5
2019-05-11 01:30,FOC,5430,737-800,20,6,28,5,5,26,,,,,8,6
2019-05-11 01:28,XIY,1348,737-800,21,4,28,4,4,27,,,,,7,6
2019-05-11 01:26,HRB,1562,737-800,20,5,24,4,4,25,,,,,4,5
2019-05-11 01:25,HHA,1787,737-800,26,1,26,1,1,24,,,,,0,-2
2019-05-11 01:22,HAK,206F,737-800,26,4,32,2,2,29,,,,,6,3
2019-05-11 01:19,CAN,5709,737-800,25,4,32,6,7,33,,,,,7,8
2019-05-11 01:19,KMG,7993,737-800,20,5,26,6,6,24,,,,,6,4
2019-05-11 01:14,YIH,7113,737-800,20,5,28,5,4,26,,,,,8,6
2019-05-11 01:12,MIG,5732,737-800,20,4,27,4,4,25,,,,,7,5
2019-05-11 01:12,URC,5661,737-800,20,4,20,5,4,22,,,,,0,2
2019-05-11 01:10,DLC,5853,737-800,13,6,27,6,5,24,,,,,14,11
2019-05-11 01:05,TYN,1995,737-800,20,5,25,6,6,23,,,,,5,3
2019-05-11 01:02,CAN,5521,737-800,27,5,28,2,2,26,,,,,1,-1
2019-05-11 01:01,CAN,1728,737-800,24,5,28,4,3,24,,,,,4,0
2019-05-11 01:01,KMG,1208,737-800,20,3,22,3,2,24,,,,,2,4
2019-05-11 01:00,SYX,5580,737-800,25,6,37,6,6,36,1,1,,11,12,11
2019-05-11 01:00,URC,7619,737-800,23,6,25,5,5,25,,,,,2,2
2019-05-11 00:57,HAK,5662,737-800,26,4,35,2,4,35,,,,,9,9
2019-05-11 00:56,103,1548,737-800,23,3,24,3,3,22,,,,,1,-1
2019-05-11 00:55,TYN,5090,737-800,15,2,22,2,2,21,,,,,7,6
2019-05-11 00:55,URC,5797,737-800,15,4,16,5,5,20,,,,,1,5
2019-05-11 00:54,KHG,1323,737-800,18,4,25,4,4,26,,,,,7,8
2019-05-11 00:48,KMG,7990,737-800,20,4,23,3,4,22,,,,,3,2
2019-05-11 00:48,´óÁ¬,6060,737-800,13,5,25,4,4,25,,,,,12,12
2019-05-11 00:45,XIY,5180,737-800,21,6,28,6,6,26,,,,,7,5
2019-05-11 00:44,HAK,1130,737-800,28,3,30,3,3,30,,,,,2,2
2019-05-11 00:43,HRB,1351,737-800,21,4,26,4,4,20,,,,,5,-1
2019-05-11 00:38,HAK,5466,737-800,25,0,17,7,0,21,,,,,-8,-4
2019-05-11 00:36,XIY,7616,737-800,21,5,20,6,5,21,,,,,-1,0
2019-05-11 00:35,PEK,5462,737-800,24,4,24,4,4,26,,,,,0,2
2019-05-11 00:33,HGH,1141,737-800,22,6,30,7,7,29,,,,,8,7
2019-05-11 00:32,CGO,5372,737-800,22,8,20,8,8,25,,,,,-2,3
2019-05-11 00:31,HAK,206G,737-800,26,5,35,5,6,32,,,,,9,6
2019-05-11 00:26,TYN,5625,737-800,19,4,27,6,5,22,,,,,8,3
2019-05-11 00:22,YIH,1906,737-800,20,6,30,6,6,28,,,,,10,8
2019-05-11 00:11,PEK,5465,737-800,23,2,28,2,3,28,,,,,5,5
2019-05-11 00:10,ÃàÑô,1798,737-800,23,6,28,6,6,24,,,,,5,1
2019-05-11 00:09,URC,1322,737-800,2252,4,24,4,4,25,,,,,-2228,-2227
2019-05-11 00:06,º£¿Ú,1587,737-800,27,4,28,4,4,28,,,,,1,1
2019-05-11 00:00,HAK,1786,737-800,25,4,35,4,5,33,,,,,10,8
2019-05-10 23:53,DLC,7175,737-800,15,5,26,5,4,24,,,,,11,9
2019-05-10 23:48,CGO,7991,737-800,23,6,28,6,6,28,,,,,5,5
2019-05-10 23:47,TYN,1493,737-800,20,6,24,6,6,20,,,,,4,0
2019-05-10 23:38,HAK,1793,737-800,27,5,35,5,5,31,,,,,8,4
2019-05-10 23:37,XIY,6103,737-800,22,6,28,6,6,28,,,,,6,6
2019-05-10 23:35,S?Z?X,7172,737-800,26,5,30,6,6,30,,,,,4,4
2019-05-10 23:34,HHA,1490,737-800,24,5,27,5,5,26,,,,,3,2
2019-05-10 23:34,HAK,206H,737-800,25,3,30,3,3,30,,,,,5,5
2019-05-10 23:33,CKG,7379,737-800,25,4,30,4,4,30,,,,,5,5
2019-05-10 23:27,CGO,7991,737-800,23,6,28,6,6,28,,,,,5,5
2019-05-10 23:21,HRB,1433,737-800,23,2,28,2,2,21,,,,,5,-2
2019-05-10 23:21,XNN,1797,737-800,10,3,20,3,3,20,,,,,10,10
2019-05-10 23:20,SYX,1213,737-800,27,7,36,6,6,36,,,,,9,9
2019-05-10 23:18,DLC,1102,737-800,17,4,26,4,4,26,,,,,9,9
2019-05-10 23:17,HGH,5139,737-800,23,4,23,4,6,28,,,,,0,5
2019-05-10 23:13,HAK,5481,737-800,26,6,32,6,6,31,,,,,6,5
2019-05-10 23:09,HAK,5418,737-800,26,8,33,4,4,33,,,,,7,7
2019-05-10 23:09,HAK,5089,737-800,27,4,30,2,2,33,,,,,3,6
2019-05-10 23:03,DLC,1375,737-800,16,4,25,4,5,24,,,,,9,8
2019-05-10 23:02,HAK,5502,737-800,26,4,36,6,5,28,1,,,1,10,2
2019-05-10 22:54,FOC,1905,737-800,21,3,23,3,4,22,,,,,2,1
2019-05-10 22:42,URC,5637,737-800,23,2,25,2,2,22,,,,,2,-1
2019-05-10 22:31,DLC,6063,737-800,15,6,26,4,5,27,,,,,11,12
2019-05-10 22:28,CAN,1131,737-800,27,4,35,4,4,34,,,,,8,7
2019-05-10 22:28,XIY,7400,737-800,23,6,27,6,6,27,,,,,4,4
2019-05-10 22:18,ÃàÑô,5409,737-800,21,4,25,4,3,27,,,,,4,6
2019-05-10 22:18,PEK,1487,737-800,26,2,24,4,3,24,,,,,-2,-2
2019-05-10 22:14,SYX,7399,737-800,28,4,34,4,4,34,,,,,6,6
2019-05-10 22:13,HAK,1545,737-800,26,5,35,4,5,32,,,,,9,6
2019-05-10 22:02,URC,6995,737-800,22,4,26,6,6,22,,,,,4,0
2019-05-10 21:43,URC,1727,737-800,24,4,24,6,6,20,,,,,0,-4
2019-05-10 21:35,SYX,1505,737-800,26,4,36,4,4,31,1,,,1,10,5
2019-05-10 21:25,XNN,1735,737-800,10,4,20,5,5,18,,,,,10,8
2019-05-10 20:38,´óÁ¬,7378,737-800,16,6,28,6,6,28,,,,,12,12
2019-05-10 20:32,CGO,1586,737-800,28,4,29,5,4,29,,,,,1,1
2019-05-10 19:56,HRB,7105,737-800,28,4,29,5,5,24,,,,,1,-4
2019-05-10 19:38,PEK,5428,737-800,29,3,26,4,4,30,,,,,-3,1
2019-05-10 19:28,HAK,5579,737-800,30,5,36,6,6,34,,,,,6,4
2019-05-10 19:27,HGH,1496,737-800,26,5,32,5,6,31,,,,,6,5
2019-05-10 19:19,HRB,7113,737-800,29,4,23,4,4,24,,,,,-6,-5
2019-05-10 18:12,HAK,1492,737-800,28,4,30,3,3,28,,,,,2,0
2019-05-10 18:07,KMG,1588,737-800,20,4,24,6,5,22,,,,,4,2
2019-05-10 17:34,SZX,7639,737-800,26,8,36,6,6,32,,,,,10,6
2019-05-10 16:34,HAK,1929,737-800,30,3,31,3,3,30,,,,,1,0
2019-05-10 15:54,XIY,1927,737-800,30,4,25,8,6,20,,,,,-5,-10
2019-05-10 15:18,XIY,1487,737-800,18,2,22,2,3,23,,,,,4,5
2019-05-10 14:11,HAK,1498,737-800,30,4,35,4,4,24,,,,,5,-6
2019-05-10 14:05,HRB,7113,737-800,30,5,25,6,6,26,,,,,-5,-4
2019-05-10 13:36,SYX,5467,737-800,36,6,36,4,2,32,,,,,0,-4
2019-05-10 12:40,CTU,7992,737-800,30,7,28,6,6,26,,,,,-2,-4
2019-05-10 11:12,XUZ,7989,737-800,30,6,30,6,6,30,,,,,0,0
2019-05-10 08:54,HAK,1793,737-800,25,4,32,5,4,30,,,,,7,5
2019-05-10 08:22,PEK,5249,737-800,22,2,28,3,2,26,,,,,6,4
2019-05-10 08:18,CGO,5138,737-800,20,4,26,6,6,28,,,,,6,8
2019-05-10 07:33,KMG,1586,737-800,20,4,25,4,4,25,,,,,5,5
2019-05-10 07:26,XMN,1548,737-800,22,5,27,4,6,28,,,,,5,6
2019-05-10 07:25,XMN,1787,737-800,20,5,27,6,4,28,,,,,7,8
2019-05-10 07:25,XMN,5416,737-800,20,7,25,6,7,28,,,,,5,8
2019-05-10 07:24,XMN,5479,737-800,22,3,28,4,4,30,,,,,6,8
2019-05-10 06:57,PEK,5712,737-800,19,2,22,6,2,22,,,,,3,3
2019-05-10 06:52,SZX,1783,737-800,24,4,30,6,5,32,,,,,6,8
2019-05-10 06:23,HRB,7105,737-800,12,4,24,4,4,16,,,,,12,4
2019-05-10 05:52,KMG,6016,737-800,25,4,26,6,5,24,,,,,1,-1
2019-05-10 05:48,URC,1570,737-800,22,5,23,4,5,21,,,,,1,-1
2019-05-10 05:36,KMG,6809,737-800,16,5,22,6,6,23,,,,,6,7
2019-05-10 05:35,FOC,1559,737-800,21,3,28,2,2,24,,,,,7,3
2019-05-10 05:08,CGO,5138,737-800,23,4,26,4,4,28,,,,,3,5
2019-05-10 05:01,XIY,1163,737-800,18,2,26,3,3,22,,,,,8,4
2019-05-10 05:00,URC,5636,737-800,17,4,21,5,4,22,,,,,4,5
2019-05-10 04:55,HAK,6015,737-800,27,4,30,4,4,29,,,,,3,2
2019-05-10 04:53,HRB,1433,737-800,16,4,20,3,4,18,,,,,4,2
2019-05-10 04:52,FOC,1351,737-800,21,4,28,4,4,24,,,,,7,3
2019-05-10 04:49,URC,7198,737-800,20,4,24,6,4,24,,,,,4,4
2019-05-10 04:42,URC,1322,737-800,20,4,24,4,4,24,,,,,4,4
2019-05-10 04:41,URC,1996,737-800,18,5,18,5,6,24,,,,,0,6
2019-05-10 04:40,URC,205V,737-800,20,2,25,4,4,26,,,,,5,6
2019-05-10 04:39,URC ,1323,737-800,20,4,25,3,4,22,,,,,5,2
2019-05-10 04:35,CGO,5467,737-800,22,2,26,4,3,24,,,,,4,2
2019-05-10 04:32,SZC,7171,737-800,23,4,30,4,4,30,,,,,7,7
2019-05-10 04:24,FOC,5430,737-800,24,4,32,4,4,32,,,,,8,8
2019-05-10 04:17,XIY,5709,737-800,17,6,28,6,6,26,,,,,11,9
2019-05-10 04:16,HAK,5428,737-800,28,7,30,6,4,26,,,,,2,-2
2019-05-10 04:10,HRB,7105,737-800,13,16,32,10,10,28,,,,,19,15
2019-05-10 04:08,HRB,7105,737-800,13,19,35,14,14,29,,,,,22,16
2019-05-10 04:00,XIY,5180,737-800,18,5,27,6,6,25,,,,,9,7
2019-05-10 03:48,XIY,5625,737-800,18,4,24,5,4,24,,,,,6,6
2019-05-10 03:38,HAK,6808,737-800,25,3,32,4,4,30,,,,,7,5
2019-05-10 03:38,DLC,5853,737-800,18,4,26,4,4,25,,,,,8,7
2019-05-10 03:37,HGH,1375,737-800,22,4,25,4,3,24,,,,,3,2
2019-05-10 03:35,KMG,1587,737-800,16,3,25,5,4,23,,,,,9,7
2019-05-10 03:35,PEK,5136,737-800,15,4,23,5,5,28,,,,,8,13
2019-05-10 03:34,XIY,1733,737-800,19,4,24,2,2,22,,,,,5,3
2019-05-10 03:33,XIY,1480,737-800,16,5,21,5,4,22,,,,,5,6
2019-05-10 03:24,DLC,6060,737-800,18,4,23,4,4,20,,,,,5,2
2019-05-10 03:21,URC ,5713,737-800,19,2,22,6,6,24,,,,,3,5
2019-05-10 03:20,URC,5661,737-800,20,5,18,5,4,25,,,,,-2,5
2019-05-10 03:19,URC,2159,737-800,20,6,20,2,2,24,,,,,0,4
2019-05-10 03:18,URC,5637,737-800,21,0,24,2,2,20,,,,,3,-1
2019-05-10 03:17,XMN,5416,737-800,20,7,25,6,7,28,,,,,5,8
2019-05-10 03:17,HRB,7395,737-800,16,6,23,7,7,22,,,,,7,6
2019-05-10 03:16,HRB,7392,737-800,16,6,23,7,7,22,,,,,7,6
2019-05-10 03:15,XMN,1548,737-800,22,5,27,4,6,24,,,,,5,2
2019-05-10 03:15,HRB,7395,737-800,16,6,23,7,7,23,,,,,7,7
2019-05-10 03:11,URC,206P,737-800,15,4,22,3,5,20,,,,,7,5
2019-05-10 03:11,XIY,5115,737-800,25,4,20,6,5,26,,,,,-5,1
2019-05-10 03:07,XMN,1787,737-800,20,5,27,6,4,28,,,,,7,8
2019-05-10 03:07,XMN,5416,737-800,20,7,25,6,7,28,,,,,5,8
2019-05-10 03:05,XMN,5479,737-800,22,3,28,4,4,30,,,,,6,8
2019-05-10 03:05,FOC,1348,737-800,21,4,27,5,5,27,,,,,6,6
2019-05-10 03:04,SHA,5463,737-800,19,9,22,5,5,22,,,,,3,3
2019-05-10 03:04,SYX,1101,737-800,27,2,34,2,3,35,,,,,7,8
2019-05-10 03:04,SYX,1796,737-800,26,4,32,6,5,30,,,,,6,4
2019-05-10 03:03,KMG,1798,737-800,20,2,28,5,6,22,,,,,8,2
2019-05-10 03:03,HAK,5579,737-800,24,7,36,6,6,32,,,,,12,8
2019-05-10 02:58,MIG,5449,737-800,20,5,27,5,5,26,,,,,7,6
2019-05-10 02:58,FOC,1905,737-800,21,4,27,5,5,28,,,,,6,7
2019-05-10 02:58,XIY,5182,737-800,21,4,27,4,4,24,,,,,6,3
2019-05-10 02:57,HHA,5638,737-800,24,4,28,4,4,27,,,,,4,3
2019-05-10 02:55,HHA,7173,737-800,20,3,30,5,4,25,,,,,10,5
2019-05-10 02:55,216,7172,737-800,24,4,34,6,4,31,,,,,10,7
2019-05-10 02:52,URC,6268,737-800,20,4,26,4,5,27,,,,,6,7
2019-05-10 02:47,HHA,5581,737-800,21,4,22,5,5,26,,,,,1,5
2019-05-10 02:43,HAK,7619,737-800,25,5,30,5,4,31,,,,,5,6
2019-05-10 02:43,HHA,5483,737-800,21,4,28,4,4,25,,,,,7,4
2019-05-10 02:40,HAK,5466,737-800,24,4,28,8,2,24,,,,,4,0
2019-05-10 02:40,URC,1929,737-800,20,4,24,4,5,24,,,,,4,4
2019-05-10 02:39,HAK,206F,737-800,24,4,32,4,4,29,,,,,8,5
2019-05-10 02:38,SZX,5520,737-800,25,4,34,6,6,32,,,,,9,7
2019-05-10 02:32,URC,1795,737-800,29,4,26,4,4,26,,,,,-3,-3
2019-05-10 02:29,URC,1325,737-800,20,5,27,4,4,22,,,,,7,2
2019-05-10 02:24,CGO,1209,737-800,20,4,28,3,3,26,,,,,8,6
2019-05-10 02:17,HGH,1493,737-800,21,5,25,6,7,24,,,,,4,3
2019-05-10 02:13,CAN,5623,737-800,26,4,34,5,5,28,,,,,8,2
2019-05-10 02:13,XIY,1902,737-800,18,5,25,5,5,25,,,,,7,7
2019-05-10 02:10,SZX,5137,737-800,24,2,22,2,2,30,,,,,-2,6
2019-05-10 02:05,PEK,5482,737-800,20,4,28,4,4,28,,,,,8,8
2019-05-10 02:03,CAN,7377,737-800,23,6,31,6,6,31,,,,,8,8
2019-05-10 02:02,SYX,1492,737-800,26,3,32,3,3,30,,,,,6,4
2019-05-10 02:02,XIY,5116,737-800,18,4,22,4,4,22,,,,,4,4
2019-05-10 01:56,TYN,5090,737-800,20,2,24,2,2,22,,,,,4,2
2019-05-10 01:54,HAK,7618,737-800,26,4,22,4,4,24,,,,,-4,-2
2019-05-10 01:52,CKG,1997,737-800,22,6,28,5,4,24,,,,,6,2
2019-05-10 01:51,KMG,7989,737-800,15,5,26,7,6,25,,,,,11,10
2019-05-10 01:51,HGH,5358,737-800,22,5,26,6,5,28,,,,,4,6
2019-05-10 01:51,XIY,5480,737-800,18,2,26,4,3,20,,,,,8,2
2019-05-10 01:50,FOC,5337,737-800,22,0,28,4,4,30,,,,,6,8
2019-05-10 01:49,HGH,1490,737-800,22,5,27,6,6,25,,,,,5,3
2019-05-10 01:46,DLC,7378,737-800,20,5,25,5,5,26,,,,,5,6
2019-05-10 01:45,PEK,1725,737-800,25,4,28,6,5,30,,,,,3,5
2019-05-10 01:45,URC,1346,737-800,20,6,28,4,6,25,,,,,8,5
2019-05-10 01:41,CGO,7167,737-800,20,6,24,6,5,25,,,,,4,5
2019-05-10 01:40,XIY,206G,737-800,20,3,27,3,3,24,,,,,7,4
2019-05-10 01:40,XIY,206G,737-800,20,3,27,3,3,24,,,,,7,4
2019-05-10 01:40,CGO,1588,737-800,20,4,26,4,4,22,,,,,6,2
2019-05-10 01:39,YIH,1350,737-800,20,6,28,6,6,28,,,,,8,8
2019-05-10 01:36,SYX,7399,737-800,26,5,34,4,4,0,,,,,8,-26
2019-05-10 01:36,DLC,6062,737-800,19,5,24,4,5,22,,,,,5,3
2019-05-10 01:35,CAN,1538,737-800,26,4,31,4,3,30,,,,,5,4
2019-05-10 01:34,HAK,5733,737-800,24,5,34,5,5,33,,,,,10,9
2019-05-10 01:33,ZGC,5580,737-800,9,6,22,6,6,25,,,,,13,16
2019-05-10 01:33,HAK,5439,737-800,25,5,34,4,4,30,,,,,9,5
2019-05-10 01:31,URC,1727,737-800,20,5,24,2,4,20,,,,,4,0
2019-05-10 01:31,URC,5797,737-800,20,5,18,4,3,15,,,,,-2,-5
2019-05-10 01:30,HAK,7639,737-800,25,6,36,6,6,34,1,,,1,11,9
2019-05-10 01:28,HHA,7398,737-800,20,4,28,4,4,25,,,,,8,5
2019-05-10 01:26,ÖØÇì,7379,737-800,21,4,26,4,3,28,,,,,5,7
2019-05-10 01:25,HHA,1386,737-800,22,4,26,3,4,22,,,,,4,0
2019-05-10 01:25,XIY,1483,737-800,17,5,22,5,5,23,,,,,5,6
2019-05-10 01:20,URC,5611,737-800,20,5,26,4,5,24,,,,,6,4
2019-05-10 01:18,CAN,1728,737-800,29,4,28,4,4,26,,,,,-1,-3
2019-05-10 01:18,HAK,5139,737-800,25,6,28,7,4,32,,,,,3,7
2019-05-10 01:11,SYX,1213,737-800,27,6,35,6,6,34,,,,,8,7
2019-05-10 01:10,TYN,1488,737-800,20,6,26,5,5,24,,,,,6,4
2019-05-10 01:09,URC,1995,737-800,19,5,26,5,5,26,,,,,7,7
2019-05-10 01:09,CGO,7991,737-800,20,6,28,4,4,25,,,,,8,5
2019-05-10 01:05,DLC,1102,737-800,20,4,26,3,4,24,,,,,6,4
2019-05-10 01:04,SYX,1347,737-800,26,4,32,3,3,31,,,,,6,5
2019-05-10 01:04,HGH,6065,737-800,20,5,28,4,4,27,,,,,8,7
2019-05-10 01:02,PEK,5538,737-800,24,3,30,4,3,29,,,,,6,5
2019-05-10 01:01,SZX,1928,737-800,24,5,28,5,6,27,,,,,4,3
2019-05-10 00:54,SZX,5141,737-800,26,6,30,6,6,28,,,,,4,2
2019-05-10 00:53,PEK,5462,737-800,26,2,21,3,2,22,,,,,-5,-4
2019-05-10 00:51,KHG,1569,737-800,18,2,23,2,2,24,,,,,5,6
2019-05-10 00:49,HAK,5502,737-800,25,5,32,6,5,30,,,,,7,5
2019-05-10 00:48,HHA,6066,737-800,25,5,27,3,4,24,,,,,2,-1
2019-05-10 00:42,XIY,1161,737-800,20,4,26,4,3,22,,,,,6,2
2019-05-10 00:41,SZX,1786,737-800,24,4,32,4,4,26,,,,,8,2
2019-05-10 00:40,CGO,205U,737-800,21,3,24,3,3,24,,,,,3,3
2019-05-10 00:38,PEK,5539,737-800,24,6,26,4,6,28,,,,,2,4
2019-05-10 00:38,KMG,6800,737-800,14,6,21,5,6,22,,,,,7,8
2019-05-10 00:37,PEK,1542,737-800,23,4,26,6,4,22,,,,,3,-1
2019-05-10 00:37,Ì«Ô­,5687,737-800,20,4,18,4,4,19,,,,,-2,-1
2019-05-10 00:36,CAN,5481,737-800,26,5,30,5,5,30,,,,,4,4
2019-05-10 00:31,SYX,1141,737-800,26,3,34,6,6,31,,,,,8,5
2019-05-10 00:30,TYN,1785,737-800,22,2,24,6,6,26,,,,,2,4
2019-05-10 00:25,YIH,1906,737-800,26,6,29,7,7,28,,,,,3,2
2019-05-10 00:23,CAN,1131,737-800,26,4,34,4,4,34,,,,,8,8
2019-05-10 00:21,ÃàÑô,5409,737-800,20,3,25,4,4,27,,,,,5,7
2019-05-10 00:18,DLC,6063,737-800,20,5,22,4,6,24,,,,,2,4
2019-05-10 00:17,PEK,1726,737-800,26,4,26,4,4,24,,,,,0,-2
2019-05-10 00:13,CAN,1215,737-800,26,4,30,4,4,30,,,,,4,4
2019-05-10 00:12,HAK,1502,737-800,25,4,32,4,4,33,,,,,7,8
2019-05-10 00:09,HAK,1103,737-800,24,4,34,4,4,32,,,,,10,8
2019-05-10 00:08,CAN,6061,737-800,25,4,30,5,4,28,,,,,5,3
2019-05-10 00:06,605,1489,737-800,24,4,32,4,4,30,,,,,8,6
2019-05-10 00:05,HGH,5153,737-800,22,3,28,3,3,26,,,,,6,4
2019-05-10 00:05,XIY,5417,737-800,21,4,22,4,4,25,,,,,1,4
2019-05-10 00:04,ZGC,5522,737-800,10,6,22,5,5,20,,,,,12,10
2019-05-10 00:01,HAK,5082,737-800,25,5,34,4,3,29,,,,,9,4
2019-05-10 00:00,ZGC,1498,737-800,10,9,25,8,8,26,,,,,15,16
2019-05-09 23:55,XIY,1927,737-800,25,3,22,3,5,26,,,,,-3,1
2019-05-09 23:47,HAK,7886,737-800,24,4,34,5,4,28,1,,,1,10,4
2019-05-09 23:46,SYX,5735,737-800,27,3,30,3,2,30,,,,,3,3
2019-05-09 23:44,XIY,5371,737-800,20,9,23,6,6,24,,,,,3,4
2019-05-09 23:44,HAK,5405,737-800,26,4,34,4,4,34,,,,,8,8
2019-05-09 23:42,CKG,5855,737-800,23,6,26,6,6,24,,,,,3,1
2019-05-09 23:41,SYX,5735,737-800,27,3,30,3,2,30,,,,,3,3
2019-05-09 23:38,MIG,5407,737-800,20,4,27,5,4,24,,,,,7,4
2019-05-09 23:37,XIY,7400,737-800,20,5,26,4,4,25,,,,,6,5
2019-05-09 23:31,CGO,7988,737-800,21,6,28,6,5,28,,,,,7,7
2019-05-09 23:17,HAK,5408,737-800,26,5,33,5,4,30,,,,,7,4
2019-05-09 23:08,HAK,5521,737-800,29,6,26,4,6,30,,,,,-3,1
2019-05-09 23:06,HHA,5346,737-800,22,5,26,5,5,25,,,,,4,3
2019-05-09 23:05,PEK,7175,737-800,20,5,28,4,4,24,,,,,8,4
2019-05-09 22:57,HGH,5478,737-800,22,5,29,6,4,27,,,,,7,5
2019-05-09 22:53,HAK,1545,737-800,28,2,26,6,5,24,,,,,-2,-4
2019-05-09 22:50,HAK,1549,737-800,24,5,30,5,5,30,,,,,6,6
2019-05-09 22:46,DLC,1491,737-800,15,4,20,5,5,22,,,,,5,7
2019-05-09 22:45,DLC,1496,737-800,20,6,27,4,4,26,,,,,7,6
2019-05-09 22:39,PEK,5465,737-800,20,2,21,4,3,28,,,,,1,8
2019-05-09 22:38,HRB,1562,737-800,20,4,24,3,4,24,,,,,4,4
2019-05-09 22:38,URC,205T,737-800,20,2,26,2,2,26,,,,,6,6
2019-05-09 22:35,CAN,1373,737-800,26,4,32,4,4,28,,,,,6,2
2019-05-09 22:32,MIG,5732,737-800,20,3,28,2,3,24,,,,,8,4
2019-05-09 22:23,HAK,5686,737-800,25,5,32,5,5,27,,,,,7,2
2019-05-09 22:21,HAK,206H,737-800,25,4,32,2,2,30,,,,,7,5
2019-05-09 22:18,URC,1568,737-800,20,2,21,4,3,23,,,,,1,3
2019-05-09 22:16,216,1495,737-800,20,4,25,4,4,25,,,,,5,5
2019-05-09 22:09,SYX,1505,737-800,26,3,33,4,4,29,,,,,7,3
2019-05-09 22:06,HAK,7990,737-800,25,4,33,3,4,32,,,,,8,7
2019-05-09 21:55,CAN,5359,737-800,26,5,30,6,5,28,,,,,4,2
2019-05-09 21:13,HAK,5089,737-800,26,2,20,3,3,29,,,,,-6,3
2019-05-09 20:05,HGH,1547,737-800,22,6,28,6,6,28,,,,,6,6
2019-05-09 19:49,ZGC,206G,737-800,10,7,22,6,5,21,,,,,12,11
2019-05-09 19:19,HAK,5148,737-800,26,9,30,4,4,30,,,,,4,4
2019-05-09 18:51,URC,6995,737-800,25,3,25,4,3,22,,,,,0,-3
2019-05-09 18:46,URC,6995,737-800,25,3,25,4,3,22,,,,,0,-3
2019-05-09 17:29,YIH,7113,737-800,27,6,28,6,6,28,,,,,1,1
2019-05-09 17:13,XIY,1501,737-800,26,4,30,4,4,25,,,,,4,-1
2019-05-09 17:09,TYN,5852,737-800,25,4,22,5,4,22,,,,,-3,-3
2019-05-09 16:24,XIY,7616,737-800,28,3,25,3,4,25,,,,,-3,-3
2019-05-09 12:44,CTU,7990,737-800,25,3,21,3,4,22,,,,,-4,-3
2019-05-09 12:33,HRB,1906,737-800,23,7,27,7,7,25,,,,,4,2
2019-05-09 12:08,XUZ,1208,737-800,30,2,18,2,2,24,,,,,-12,-6
2019-05-09 09:42,HAK,1103,737-800,25,4,35,4,4,32,,,,,10,7
2019-05-09 09:22,XIY,1902,737-800,14,4,25,4,4,22,,,,,11,8
2019-05-09 09:20,XIY,1902,737-800,14,25,4,0,0,0,,,,,-10,-14
2019-05-09 09:16,XIY,5182,737-800,16,3,26,4,3,22,,,,,10,6
2019-05-09 09:15,HAK,5406,737-800,24,4,28,6,4,30,,,,,4,6
2019-05-09 08:48,Z?G?C,1797,737-800,10,4,21,5,7,22,,,,,11,12
2019-05-09 08:30,HAK ,1498,737-800,25,5,32,5,5,28,,,,,7,3
2019-05-09 08:20,PEK,5798,737-800,22,4,23,2,2,20,,,,,1,-2
2019-05-09 08:15,KMG,5409,737-800,25,4,21,6,6,24,,,,,-4,-1
2019-05-09 08:11,KMG,1798,737-800,15,6,26,6,6,23,,,,,11,8
2019-05-09 07:33,PEK,5662,737-800,20,3,26,3,5,25,,,,,6,5
2019-05-09 07:11,KMG,7989,737-800,15,6,26,6,6,22,,,,,11,7
2019-05-09 06:53,PEK,5465,737-800,20,6,26,6,6,24,,,,,6,4
2019-05-09 06:53,PEK,7175,737-800,20,5,27,4,4,24,,,,,7,4
2019-05-09 06:51,URC,5713,737-800,18,6,22,6,6,23,,,,,4,5
2019-05-09 06:50,PEK,7173,737-800,19,4,28,4,1,24,,,,,9,5
2019-05-09 06:45,DLC,1495,737-800,18,2,24,4,4,22,,,,,6,4
2019-05-09 06:37,FOC,5417,737-800,24,5,26,4,4,24,,,,,2,0
2019-05-09 06:24,URC,1725,737-800,17,4,28,4,4,28,,,,,11,11
2019-05-09 05:47,Z?G?C,5580,737-800,11,2,23,4,4,26,,,,,12,15
2019-05-09 05:38,SZX,5520,737-800,21,5,23,6,5,24,,,,,2,3
2019-05-09 05:31,HAK,5521,737-800,25,4,28,4,3,26,,,,,3,1
2019-05-09 05:18,SYX,5371,737-800,27,4,32,4,6,34,,,,,5,7
2019-05-09 05:14,HAK,5478,737-800,24,4,32,4,3,30,,,,,8,6
2019-05-09 05:04,KMG,1588,737-800,15,4,24,4,4,24,,,,,9,9
2019-05-09 04:56,SZX,7172,737-800,21,6,24,4,5,21,,,,,3,0
2019-05-09 04:54,HAK,7992,737-800,25,6,32,7,6,30,,,,,7,5
2019-05-09 04:49,PEK,1795,737-800,17,4,26,4,4,28,,,,,9,11
2019-05-09 04:47,HAK,6061,737-800,24,4,32,4,4,29,,,,,8,5
2019-05-09 04:42,FOC,1351,737-800,20,3,28,3,4,24,,,,,8,4
2019-05-09 04:38,PEK,5439,737-800,17,4,20,3,2,21,,,,,3,4
2019-05-09 04:33,XIY,5115,737-800,16,2,18,3,4,21,,,,,2,5
2019-05-09 04:32,URC,6268,737-800,18,3,26,5,4,25,,,,,8,7
2019-05-09 04:28,CGO,7991,737-800,22,6,25,4,4,25,,,,,3,3
2019-05-09 04:26,XIY,1733,737-800,20,3,20,3,3,20,,,,,0,0
2019-05-09 04:21,HAK,7639,737-800,26,6,34,6,6,30,,,,,8,4
2019-05-09 04:20,HA?K,7639,737-800,25,6,37,6,6,30,,,,,12,5
2019-05-09 04:16,URC,1323,737-800,15,4,24,6,5,26,,,,,9,11
2019-05-09 04:12,CAN,1538,737-800,20,3,29,3,3,27,,,,,9,7
2019-05-09 04:07,PEK,5539,737-800,20,5,25,5,5,30,,,,,5,10
2019-05-09 04:07,XIY,1903,737-800,15,2,24,2,2,25,,,,,9,10
2019-05-09 04:06,PEK,5479,737-800,20,5,26,4,5,28,,,,,6,8
2019-05-09 04:06,PEK,5482,737-800,18,2,28,6,6,28,,,,,10,10
2019-05-09 04:05,PWK,6060,737-800,18,4,26,5,5,26,,,,,8,8
2019-05-09 03:55,CAN,1215,737-800,23,4,30,4,4,30,,,,,7,7
2019-05-09 03:48,SYX,1213,737-800,30,6,34,6,6,34,,,,,4,4
2019-05-09 03:47,HGH,1489,737-800,20,3,27,3,3,24,,,,,7,4
2019-05-09 03:42,HHA,5338,737-800,20,4,20,4,4,24,,,,,0,4
2019-05-09 03:39,FOC,7113,737-800,20,5,27,5,4,25,,,,,7,5
2019-05-09 03:36,XIY,5180,737-800,16,6,24,6,6,24,,,,,8,8
2019-05-09 03:34,HHA,1130,737-800,20,3,27,3,3,24,,,,,7,4
2019-05-09 03:33,KWE,7167,737-800,18,6,25,6,6,23,,,,,7,5
2019-05-09 03:28,º£¿Ú,5540,737-800,25,5,31,5,5,32,,,,,6,7
2019-05-09 03:26,URC,2159,737-800,13,4,24,4,3,22,,,,,11,9
2019-05-09 03:25,FOC,1435,737-800,21,5,28,5,5,24,,,,,7,3
2019-05-09 03:24,DLC,6062,737-800,20,2,22,3,3,24,,,,,2,4
2019-05-09 03:24,SYX,1996,737-800,29,6,30,6,6,30,,,,,1,1
2019-05-09 03:22,DLC,6063,737-800,21,5,26,3,4,26,,,,,5,5
2019-05-09 03:19,XIY,5853,737-800,16,6,28,6,8,24,,,,,12,8
2019-05-09 03:19,KMG,1587,737-800,15,3,24,3,3,24,,,,,9,9
2019-05-09 03:14,URC,5797,737-800,15,5,20,4,4,23,,,,,5,8
2019-05-09 03:13,XIY,1726,737-800,15,4,22,4,4,22,,,,,7,7
2019-05-09 03:09,SYX,206F,737-800,26,3,32,3,3,29,,,,,6,3
2019-05-09 03:08,URC,5620,737-800,15,4,24,3,5,22,,,,,9,7
2019-05-09 03:08,HGH,5153,737-800,19,3,27,2,2,26,,,,,8,7
2019-05-09 03:03,HAK,5855,737-800,25,5,30,5,5,28,,,,,5,3
2019-05-09 03:02,KMG,7993,737-800,20,6,25,6,6,22,,,,,5,2
2019-05-09 03:02,CAN,5623,737-800,22,4,28,5,6,26,,,,,6,4
2019-05-09 02:57,URC,1346,737-800,16,6,28,5,4,22,,,,,12,6
2019-05-09 02:55,XIY,1480,737-800,19,5,26,5,6,24,,,,,7,5
2019-05-09 02:47,SZX,7171,737-800,20,4,28,4,4,28,,,,,8,8
2019-05-09 02:46,URC,1569,737-800,17,3,27,3,3,23,,,,,10,6
2019-05-09 02:42,CAN,7618,737-800,22,5,28,6,4,26,,,,,6,4
2019-05-09 02:42,XIY,5116,737-800,16,3,23,4,5,26,,,,,7,10
2019-05-09 02:41,XIY,5709,737-800,18,6,28,8,8,20,,,,,10,2
2019-05-09 02:41,PEK,5661,737-800,18,4,21,4,4,26,,,,,3,8
2019-05-09 02:39,XIY,5480,737-800,19,3,24,5,4,22,,,,,5,3
2019-05-09 02:39,HAK,5502,737-800,25,4,30,5,4,30,,,,,5,5
2019-05-09 02:38,SYX,1492,737-800,27,4,32,4,3,30,,,,,5,3
2019-05-09 02:38,URC,206P,737-800,18,6,24,5,5,22,,,,,6,4
2019-05-09 02:38,XIY,6103,737-800,17,5,22,6,6,24,,,,,5,7
2019-05-09 02:37,SZX,1785,737-800,21,2,30,8,6,30,,,,,9,9
2019-05-09 02:35,XIY,1482,737-800,15,4,28,4,4,26,,,,,13,11
2019-05-09 02:34,SYX,5372,737-800,26,9,30,9,9,32,,,,,4,6
2019-05-09 02:32,HHA,1386,737-800,18,3,26,2,2,23,,,,,8,5
2019-05-09 02:28,XIY,1903,737-800,15,2,24,2,2,25,,,,,9,10
2019-05-09 02:26,URC,1796,737-800,13,4,25,3,4,22,,,,,12,9
2019-05-09 02:22,URC,205V,737-800,17,3,26,1,2,24,,,,,9,7
2019-05-09 02:20,HHA,5463,737-800,18,4,22,4,4,22,,,,,4,4
2019-05-09 02:17,KMG,6015,737-800,20,5,17,4,4,25,,,,,-3,5
2019-05-09 02:13,URC,6995,737-800,17,4,26,4,4,25,,,,,9,8
2019-05-09 02:12,XIY,1163,737-800,17,2,24,4,3,25,,,,,7,8
2019-05-09 02:11,YIH,1350,737-800,20,4,28,4,4,24,,,,,8,4
2019-05-09 02:09,HGH,1490,737-800,25,6,26,6,6,25,,,,,1,0
2019-05-09 02:09,XIY,1161,737-800,16,4,20,5,5,22,,,,,4,6
2019-05-09 02:08,HHA,7398,737-800,17,4,27,4,4,24,,,,,10,7
2019-05-09 02:03,HAK,5418,737-800,25,8,30,7,6,32,,,,,5,7
2019-05-09 02:02,HAK,1927,737-800,25,4,30,8,4,30,,,,,5,5
2019-05-09 02:00,HAK,1928,737-800,25,6,30,7,7,29,,,,,5,4
2019-05-09 01:59,DLC,1102,737-800,19,3,18,5,5,25,,,,,-1,6
2019-05-09 01:54,URC,5713,737-800,18,6,22,6,6,23,,,,,4,5
2019-05-09 01:52,TYN,1783,737-800,16,4,22,4,4,26,,,,,6,10
2019-05-09 01:46,HHA,5638,737-800,19,4,27,4,4,26,,,,,8,7
2019-05-09 01:44,XIY,5375,737-800,17,0,18,2,2,20,,,,,1,3
2019-05-09 01:44,FOC,5430,737-800,29,6,20,6,5,21,,,,,-9,-8
2019-05-09 01:43,HAK,1728,737-800,25,5,28,6,5,26,,,,,3,1
2019-05-09 01:41,KMG,6809,737-800,15,5,18,6,5,14,,,,,3,-1
2019-05-09 01:36,TYN,5090,737-800,14,2,23,2,2,21,,,,,9,7
2019-05-09 01:34,XIY,1481,737-800,16,6,26,4,4,26,,,,,10,10
2019-05-09 01:32,URC,5637,737-800,20,3,24,3,3,23,,,,,4,3
2019-05-09 01:31,SZX,5137,737-800,21,3,20,2,2,28,,,,,-1,7
2019-05-09 01:31,XIY,5625,737-800,18,4,24,4,4,24,,,,,6,6
2019-05-09 01:31,URC,5637,737-800,20,3,24,3,3,23,,,,,4,3
2019-05-09 01:26,CAN,5359,737-800,22,4,26,4,4,26,,,,,4,4
2019-05-09 01:26,º£¿Ú,1101,737-800,25,3,36,3,2,34,1,,,1,11,9
2019-05-09 01:23,HAK,5139,737-800,26,5,36,6,4,32,1,,,1,10,6
2019-05-09 01:19,HHA,6066,737-800,19,5,27,2,2,24,,,,,8,5
2019-05-09 01:19,CGO,5138,737-800,20,4,26,4,5,28,,,,,6,8
2019-05-09 01:17,URC,7198,737-800,17,4,25,3,4,22,,,,,8,5
2019-05-09 01:17,YIH,1559,737-800,16,4,26,3,3,24,,,,,10,8
2019-05-09 01:17,SZX,5579,737-800,21,5,32,5,4,30,,,,,11,9
2019-05-09 01:16,MIG,6800,737-800,17,4,24,3,3,22,,,,,7,5
2019-05-09 01:15,HA?K,5136,737-800,25,4,33,4,4,35,,,,,8,10
2019-05-09 01:13,HAK,1549,737-800,25,5,34,6,5,31,,,,,9,6
2019-05-09 01:11,HGH,6065,737-800,24,4,26,3,4,27,,,,,2,3
2019-05-09 01:10,XIY,5429,737-800,17,4,21,3,3,24,,,,,4,7
2019-05-09 01:08,XIY,1501,737-800,17,4,24,3,3,23,,,,,7,6
2019-05-09 01:07,AYX,5735,737-800,26,2,27,1,1,28,,,,,1,2
2019-05-09 01:06,PEK,1487,737-800,18,3,26,3,3,24,,,,,8,6
2019-05-09 01:06,KMG,1208,737-800,15,3,23,3,3,22,,,,,8,7
2019-05-09 01:05,HGH,1372,737-800,25,5,26,4,4,25,,,,,1,0
2019-05-09 01:04,URC,1929,737-800,18,4,24,4,3,22,,,,,6,4
2019-05-09 01:01,PEK,5538,737-800,20,3,28,2,4,28,,,,,8,8
2019-05-09 00:59,TYN,5687,737-800,17,4,18,5,5,22,,,,,1,5
2019-05-09 00:58,CKG,7399,737-800,17,5,28,4,4,21,,,,,11,4
2019-05-09 00:55,CAN,7377,737-800,24,6,30,7,6,30,,,,,6,6
2019-05-09 00:49,SZX,5581,737-800,25,4,22,5,4,30,,,,,-3,5
2019-05-09 00:49,HGH,1547,737-800,19,4,27,4,4,26,,,,,8,7
2019-05-09 00:47,HHA,5346,737-800,20,5,25,4,5,24,,,,,5,4
2019-05-09 00:46,KHG,1570,737-800,17,5,20,4,4,18,,,,,3,1
2019-05-09 00:45,HRB,7105,737-800,12,3,18,4,3,16,,,,,6,4
2019-05-09 00:41,CAN,5428,737-800,24,4,29,4,5,30,,,,,5,6
2019-05-09 00:21,URC,5611,737-800,19,6,26,6,6,22,,,,,7,3
2019-05-09 00:20,URC,1995,737-800,19,3,24,3,4,24,,,,,5,5
2019-05-09 00:19,CGO,5358,737-800,23,6,25,5,5,27,,,,,2,4
2019-05-09 00:15,FOC,1348,737-800,24,4,29,4,3,27,,,,,5,3
2019-05-09 00:13,TYN,1488,737-800,18,8,18,6,5,18,,,,,0,0
2019-05-09 00:10,XIY,1131,737-800,15,5,28,4,4,26,,,,,13,11
2019-05-09 00:07,MIG,5407,737-800,17,2,25,4,4,24,,,,,8,7
2019-05-09 00:06,SZX,1786,737-800,22,4,29,4,4,26,,,,,7,4
2019-05-09 00:06,HAK,1793,737-800,25,5,34,5,4,31,,,,,9,6
2019-05-09 00:05,CKG,7379,737-800,20,4,30,4,4,30,,,,,10,10
2019-05-09 00:05,HAK,1793,737-800,25,5,34,5,4,31,,,,,9,6
2019-05-09 00:01,HGH,1375,737-800,25,3,26,3,3,22,,,,,1,-3
2019-05-08 23:57,CAN,5481,737-800,22,6,28,5,5,27,,,,,6,5
2019-05-08 23:56,URC,1322,737-800,15,4,24,4,3,24,,,,,9,9
2019-05-08 23:55,YIH,1906,737-800,17,6,28,6,6,26,,,,,11,9
2019-05-08 23:50,FOC,1905,737-800,20,4,28,4,2,25,,,,,8,5
2019-05-08 23:49,HAK,1541,737-800,25,5,33,6,5,34,,,,,8,9
2019-05-08 23:45,URC,1325,737-800,21,4,20,4,4,20,,,,,-1,-1
2019-05-08 23:44,URC,1325,737-800,21,4,20,4,4,20,,,,,-1,-1
2019-05-08 23:43,CAN,1373,737-800,22,4,30,3,3,24,,,,,8,2
2019-05-08 23:41,HGH,1545,737-800,25,5,29,6,6,26,,,,,4,1
2019-05-08 23:39,SZX,1548,737-800,21,4,21,4,5,20,,,,,0,-1
2019-05-08 23:33,HRB,1562,737-800,18,3,23,3,2,21,,,,,5,3
2019-05-08 23:30,SYX,1505,737-800,30,4,35,4,4,32,,,,,5,2
2019-05-08 23:24,MIG,5732,737-800,17,2,24,2,2,24,,,,,7,7
2019-05-08 23:19,CGO,205U,737-800,22,4,26,4,4,26,,,,,4,4
2019-05-08 23:19,CGO,205U,737-800,22,4,26,4,4,26,,,,,4,4
2019-05-08 23:15,URC,1727,737-800,17,4,24,4,4,22,,,,,7,5
2019-05-08 23:09,HAK,7886,737-800,25,4,35,4,4,34,,,,,10,9
2019-05-08 23:09,CGO,1586,737-800,21,4,26,4,4,28,,,,,5,7
2019-05-08 23:08,HAK,5466,737-800,25,3,26,8,4,28,,,,,1,3
2019-05-08 23:03,HAK,5082,737-800,25,4,24,4,4,32,,,,,-1,7
2019-05-08 22:59,HHA,5483,737-800,21,4,29,5,5,30,,,,,8,9
2019-05-08 22:56,CKG,6808,737-800,20,0,32,4,4,26,,,,,12,6
2019-05-08 22:56,URC,1568,737-800,17,5,25,6,6,22,,,,,8,5
2019-05-08 22:48,HRB,1433,737-800,16,7,24,7,7,24,,,,,8,8
2019-05-08 22:43,SYX,1141,737-800,30,5,36,5,6,32,,,,,6,2
2019-05-08 22:22,CAN,5686,737-800,24,6,29,4,4,26,,,,,5,2
2019-05-08 22:18,PEK,5712,737-800,23,2,26,4,4,16,,,,,3,-7
2019-05-08 22:14,XNN,1735,737-800,10,4,20,5,5,18,,,,,10,8
2019-05-08 22:14,XNN,1493,737-800,12,6,20,6,6,18,,,,,8,6
2019-05-08 22:04,SYX,5467,737-800,29,7,37,2,4,30,1,,,1,8,1
2019-05-08 21:51,CAN,7616,737-800,22,4,28,3,4,29,,,,,6,7
2019-05-08 21:49,HGH,5522,737-800,20,5,26,5,5,25,,,,,6,5
2019-05-08 21:41,DLC,1491,737-800,20,5,26,5,4,20,,,,,6,0
2019-05-08 21:32,HAK,5089,737-800,26,2,30,2,2,34,,,,,4,8
2019-05-08 20:54,DLC,1496,737-800,20,5,27,5,5,28,,,,,7,8
2019-05-08 20:17,HAK,206H,737-800,24,3,31,3,2,30,,,,,7,6
2019-05-08 19:49,HAK,5405,737-800,24,7,34,5,4,34,,,,,10,10
2019-05-08 19:18,CGO,7988,737-800,24,5,28,5,4,28,,,,,4,4
2019-05-08 19:16,HRB,7395,737-800,18,5,24,6,6,23,,,,,6,5
2019-05-08 15:05,KMG,5409,737-800,25,4,21,6,6,24,,,,,-4,-1
2019-05-08 14:22,TYN,6061,737-800,17,4,24,4,4,24,,,,,7,7
2019-05-08 13:49,SZX,1497,737-800,22,3,27,3,3,27,,,,,5,5
2019-05-08 12:54,ÃàÑô,5449,737-800,25,4,27,5,5,26,,,,,2,1
2019-05-08 12:31,CTU,7990,737-800,25,2,28,2,2,26,,,,,3,1
2019-05-08 11:41,PEK ,7173,737-800,22,3,27,4,3,22,,,,,5,0
2019-05-08 10:35,ÐìÖÝ,6016,737-800,20,4,29,4,3,26,,,,,9,6
2019-05-08 09:31,HHA,7398,737-800,17,3,23,3,4,22,,,,,6,5
2019-05-08 09:21,HHA,7398,737-800,17,4,26,3,5,26,,,,,9,9
2019-05-08 08:59,HAK,1927,737-800,27,3,30,8,3,31,,,,,3,4
2019-05-08 08:17,XIY,1435,737-800,15,5,24,6,6,24,,,,,9,9
2019-05-08 08:13,HRB,1433,737-800,8,5,28,7,6,29,,,,,20,21
2019-05-08 08:12,XIY,7400,737-800,12,4,18,5,5,20,,,,,6,8
2019-05-08 08:00,PEK,5375,737-800,20,0,20,5,4,22,,,,,0,2
2019-05-08 07:48,HHA,5338,737-800,15,3,23,4,3,24,,,,,8,9
2019-05-08 07:00,PEK,5463,737-800,20,5,25,5,5,24,,,,,5,4
2019-05-08 07:00,PEK,5463,737-800,20,5,25,5,5,24,,,,,5,4
2019-05-08 06:50,KMG,7993,737-800,18,6,26,6,6,22,,,,,8,4
2019-05-08 06:20,HAK,5579,737-800,25,8,36,8,6,35,,,,,11,10
2019-05-08 05:59,XIY,1795,737-800,13,4,20,5,4,20,,,,,7,7
2019-05-08 05:42,URC,5137,737-800,15,4,16,2,2,22,,,,,1,7
2019-05-08 05:37,SYX,1213,737-800,25,4,34,6,5,34,,,,,9,9
2019-05-08 05:25,SYX,1796,737-800,30,5,33,5,4,30,,,,,3,0
2019-05-08 05:17,CAN,1498,737-800,23,4,30,3,2,21,,,,,7,-2
2019-05-08 05:15,HAK,5733,737-800,25,6,32,5,5,30,,,,,7,5
2019-05-08 05:12,PEK,5538,737-800,21,3,30,2,2,26,,,,,9,5
2019-05-08 05:05,URC,1323,737-800,15,2,23,2,2,23,,,,,8,8
2019-05-08 05:04,CAN,5478,737-800,21,4,30,4,4,27,,,,,9,6
2019-05-08 05:01,SYX,1505,737-800,25,4,34,4,4,30,,,,,9,5
2019-05-08 04:26,PEK,5428,737-800,20,4,22,6,6,25,,,,,2,5
2019-05-08 04:13,SZX,5141,737-800,22,5,27,5,4,25,,,,,5,3
2019-05-08 04:11,FOC,5521,737-800,18,4,22,0,0,14,,,,,4,-4
2019-05-08 04:11,HGH,1487,737-800,18,2,22,2,2,20,,,,,4,2
2019-05-08 04:10,SYX,5502,737-800,28,7,33,6,5,32,,,,,5,4
2019-05-08 04:09,HAK,5855,737-800,25,7,30,8,8,29,,,,,5,4
2019-05-08 04:09,HHA,1386,737-800,16,4,24,4,5,22,,,,,8,6
2019-05-08 04:01,ZGC,5735,737-800,10,2,18,2,2,16,,,,,8,6
2019-05-08 04:01,XIY,5429,737-800,15,4,22,4,3,22,,,,,7,7
2019-05-08 03:42,HGH,1489,737-800,17,3,25,4,4,22,,,,,8,5
2019-05-08 03:28,HAK,7399,737-800,25,4,30,4,4,30,,,,,5,5
2019-05-08 03:25,URC,5853,737-800,15,6,26,6,6,26,,,,,11,11
2019-05-08 03:19,XIY,5180,737-800,20,4,24,4,4,24,,,,,4,4
2019-05-08 03:18,PEK,5480,737-800,15,4,24,6,2,22,,,,,9,7
2019-05-08 03:16,KWE,7171,737-800,12,4,20,4,4,22,,,,,8,10
2019-05-08 03:14,XIY,1903,737-800,13,2,24,2,2,25,,,,,11,12
2019-05-08 02:58,URC,1727,737-800,15,5,23,5,5,20,,,,,8,5
2019-05-08 02:57,URC,1322,737-800,16,4,24,4,4,24,,,,,8,8
2019-05-08 02:57,URC,1996,737-800,15,5,19,5,5,24,,,,,4,9
2019-05-08 02:54,CAN,6065,737-800,21,4,32,4,4,29,1,,,1,11,8
2019-05-08 02:53,CAN,1538,737-800,25,3,30,4,3,28,,,,,5,3
2019-05-08 02:53,XIY,1131,737-800,14,4,26,4,4,26,,,,,12,12
2019-05-08 02:51,URC,5662,737-800,16,3,25,4,7,24,,,,,9,8
2019-05-08 02:51,CKG,1735,737-800,16,4,24,4,4,24,,,,,8,8
2019-05-08 02:47,PEK,1542,737-800,22,4,24,4,2,20,,,,,2,-2
2019-05-08 02:42,URC,6995,737-800,18,3,26,4,5,24,,,,,8,6
2019-05-08 02:37,URC,5662,737-800,16,3,25,4,7,25,,,,,9,9
2019-05-08 02:37,URC,1929,737-800,20,4,24,4,3,22,,,,,4,2
2019-05-08 02:33,HGH,5466,737-800,17,3,18,8,2,18,,,,,1,1
2019-05-08 02:32,CKG,7379,737-800,15,3,29,4,3,28,,,,,14,13
2019-05-08 02:32,PEK,5465,737-800,23,2,22,4,4,26,,,,,-1,3
2019-05-08 02:32,URC,2159,737-800,17,8,20,2,2,22,,,,,3,5
2019-05-08 02:29,KMG,6016,737-800,16,3,19,4,4,25,,,,,3,9
2019-05-08 02:24,HAK,1502,737-800,27,5,31,4,5,32,,,,,4,5
2019-05-08 02:21,XIY,5182,737-800,14,3,25,4,4,22,,,,,11,8
2019-05-08 02:20,PEK,5337,737-800,22,5,25,6,6,26,,,,,3,4
2019-05-08 02:18,HAK,1548,737-800,30,4,33,4,3,30,,,,,3,0
2019-05-08 02:18,HHA,1549,737-800,15,5,27,5,4,25,,,,,12,10
2019-05-08 02:17,HAK,7619,737-800,25,6,30,6,6,28,,,,,5,3
2019-05-08 02:16,SZX,1786,737-800,22,2,28,4,4,24,,,,,6,2
2019-05-08 02:15,SZX,7172,737-800,22,5,32,5,4,28,,,,,10,6
2019-05-08 02:15,HHA,1101,737-800,15,2,28,2,2,24,,,,,13,9
2019-05-08 02:13,KMG,7992,737-800,20,6,24,5,6,25,,,,,4,5
2019-05-08 02:12,HAK,5138,737-800,25,4,33,5,5,35,,1,,1,8,10
2019-05-08 02:09,PEK,5482,737-800,20,0,24,4,4,27,,,,,4,7
2019-05-08 02:08,HHA,7175,737-800,20,5,27,5,5,23,,,,,7,3
2019-05-08 02:04,XIY,1161,737-800,14,4,22,6,6,22,,,,,8,8
2019-05-08 02:03,CAN,5418,737-800,22,4,26,4,4,29,,,,,4,7
2019-05-08 02:03,SZX,5581,737-800,22,4,22,5,5,30,,,,,0,8
2019-05-08 02:03,CAN,5623,737-800,23,5,31,5,6,27,,,,,8,4
2019-05-08 02:02,CAN,5686,737-800,21,5,30,5,5,25,,,,,9,4
2019-05-08 02:02,SYX,206F,737-800,28,3,34,2,2,30,,,,,6,2
2019-05-08 02:01,KMG,5407,737-800,20,4,22,5,6,22,,,,,2,2
2019-05-08 02:01,URC,1325,737-800,10,4,24,4,4,22,,,,,14,12
2019-05-08 02:00,HAK,1215,737-800,25,4,34,4,5,32,,,,,9,7
2019-05-08 01:56,HHA,5638,737-800,15,5,24,2,3,22,,,,,9,7
2019-05-08 01:52,HAK,1928,737-800,25,6,28,8,8,31,,,,,3,6
2019-05-08 01:51,KMG,1587,737-800,20,4,22,6,4,22,,,,,2,2
2019-05-08 01:51,URC,7198,737-800,16,4,23,6,5,22,,,,,7,6
2019-05-08 01:49,HAK,7377,737-800,27,6,34,6,6,35,,,,,7,8
2019-05-08 01:48,URC,5611,737-800,16,4,26,6,6,32,,1,,1,10,16
2019-05-08 01:47,XMN,5439,737-800,20,4,24,4,5,18,,,,,4,-2
2019-05-08 01:46,CGO,1586,737-800,18,4,25,5,5,25,,,,,7,7
2019-05-08 01:42,HGH,1547,737-800,20,5,25,5,6,24,,,,,5,4
2019-05-08 01:41,URC,1995,737-800,15,5,24,4,5,24,,,,,9,9
2019-05-08 01:41,CGO,1588,737-800,20,3,23,4,4,22,,,,,3,2
2019-05-08 01:39,CGO,7167,737-800,18,5,25,5,5,24,,,,,7,6
2019-05-08 01:38,KMG,1209,737-800,20,3,26,5,5,23,,,,,6,3
2019-05-08 01:37,HAK,1103,737-800,25,4,36,4,4,32,1,,,1,11,7
2019-05-08 01:33,URC,1725,737-800,17,4,24,4,6,28,,,,,7,11
2019-05-08 01:31,XMN,1797,737-800,20,4,24,3,4,28,,,,,4,8
2019-05-08 01:30,XMN,1787,737-800,20,2,26,2,2,29,,,,,6,9
2019-05-08 01:30,S?Z?X,5141,737-800,22,5,27,5,4,25,,,,,5,3
2019-05-08 01:30,XIY,1482,737-800,20,6,26,6,6,24,,,,,6,4
2019-05-08 01:26,URC,1570,737-800,17,4,24,6,6,20,,,,,7,3
2019-05-08 01:23,KMG,7988,737-800,20,4,26,5,4,26,,,,,6,6
2019-05-08 01:22,XIY,5116,737-800,20,4,20,4,3,19,,,,,0,-1
2019-05-08 01:21,XIY ,6103,737-800,15,6,25,4,4,22,,,,,10,7
2019-05-08 01:21,FOC,7113,737-800,18,4,28,5,5,27,,,,,10,9
2019-05-08 01:19,XMN,5416,737-800,20,5,30,6,6,28,,,,,10,8
2019-05-08 01:18,HAK,5089,737-800,28,4,34,4,4,33,,,,,6,5
2019-05-08 01:15,MIG,5732,737-800,20,2,23,3,3,23,,,,,3,3
2019-05-08 01:15,YIH,1350,737-800,20,5,28,6,5,28,,,,,8,8
2019-05-08 01:14,YIH,1559,737-800,22,6,28,6,6,26,,,,,6,4
2019-05-08 01:11,HHA,6066,737-800,17,3,25,2,2,23,,,,,8,6
2019-05-08 01:11,HAK,5406,737-800,26,4,33,8,8,34,,,,,7,8
2019-05-08 01:10,SYX,5372,737-800,30,7,33,8,7,34,,,,,3,4
2019-05-08 01:09,HRB,1433,737-800,14,2,24,4,4,28,,,,,10,14
2019-05-08 01:09,HGH,1490,737-800,20,5,25,5,5,23,,,,,5,3
2019-05-08 01:08,HAK,6015,737-800,25,4,34,4,4,30,,,,,9,5
2019-05-08 01:04,SZX,1728,737-800,20,4,28,4,4,26,,,,,8,6
2019-05-08 01:03,HAK,206H,737-800,26,5,32,3,3,31,,,,,6,5
2019-05-08 01:02,PEK,5540,737-800,20,6,26,6,6,26,,,,,6,6
2019-05-08 00:55,CGO,7991,737-800,19,5,23,5,5,23,,,,,4,4
2019-05-08 00:55,XIY,1162,737-800,13,3,26,3,3,22,,,,,13,9
2019-05-08 00:53,HGH,5153,737-800,17,4,24,3,4,26,,,,,7,9
2019-05-08 00:52,URC,5797,737-800,19,5,20,5,5,24,,,,,1,5
2019-05-08 00:52,DLC,1102,737-800,23,4,24,4,4,24,,,,,1,1
2019-05-08 00:49,HAK,1793,737-800,25,4,34,6,6,35,,,,,9,10
2019-05-08 00:48,MIG,1798,737-800,16,4,25,4,4,26,,,,,9,10
2019-05-08 00:46,SZX,1488,737-800,21,5,30,6,6,26,,,,,9,5
2019-05-08 00:46,TYN,5090,737-800,20,2,22,2,2,20,,,,,2,0
2019-05-08 00:44,TYN,206G,737-800,17,4,26,4,4,24,,,,,9,7
2019-05-08 00:43,FOC,1351,737-800,19,3,26,4,3,22,,,,,7,3
2019-05-08 00:41,FOC,1905,737-800,18,3,26,6,6,25,,,,,8,7
2019-05-08 00:41,HAK,5139,737-800,25,6,30,6,5,31,,,,,5,6
2019-05-08 00:40,XIY,7400,737-800,13,4,26,5,5,24,,,,,13,11
2019-05-08 00:39,HRB,7105,737-800,15,6,28,6,4,24,,,,,13,9
2019-05-08 00:38,DLC,1495,737-800,18,3,23,3,4,26,,,,,5,8
2019-05-08 00:38,CAN,7618,737-800,22,6,29,7,6,28,,,,,7,6
2019-05-08 00:38,HHA,5346,737-800,15,5,25,5,5,24,,,,,10,9
2019-05-08 00:35,FOC,1480,737-800,20,4,21,4,6,22,,,,,1,2
2019-05-08 00:34,XIY,5625,737-800,10,2,28,4,2,30,,,,,18,20
2019-05-08 00:31,KHG,1568,737-800,18,5,23,6,6,21,,,,,5,3
2019-05-08 00:27,KMG,6809,737-800,21,5,22,6,6,22,,,,,1,1
2019-05-08 00:27,XIY,1346,737-800,20,5,26,5,6,22,,,,,6,2
2019-05-08 00:26,HAK,5136,737-800,27,4,30,4,4,31,,,,,3,4
2019-05-08 00:22,URC,5637,737-800,18,2,25,2,2,20,,,,,7,2
2019-05-08 00:22,TYN,5520,737-800,20,6,28,5,5,24,,,,,8,4
2019-05-08 00:18,HGH,5483,737-800,18,4,26,6,6,18,,,,,8,0
2019-05-08 00:13,DLC,5712,737-800,22,2,20,2,2,20,,,,,-2,-2
2019-05-08 00:11,URC,1569,737-800,20,2,28,2,3,26,,,,,8,6
2019-05-08 00:10,SYX,1492,737-800,28,4,34,3,3,30,,,,,6,2
2019-05-08 00:09,PEK,5539,737-800,22,4,26,5,5,28,,,,,4,6
2019-05-08 00:02,URC,5620,737-800,10,4,26,2,4,20,,,,,16,10
2019-05-08 00:02,FOC,5430,737-800,21,6,29,5,5,29,,,,,8,8
2019-05-07 23:52,SZX ,1497,737-800,24,4,28,4,4,28,,,,,4,4
2019-05-07 23:51,MIG,5449,737-800,20,4,25,5,5,24,,,,,5,4
2019-05-07 23:50,CGO,5481,737-800,18,5,25,5,4,24,,,,,7,6
2019-05-07 23:49,URC,205T,737-800,15,6,26,4,4,24,,,,,11,9
2019-05-07 23:49,HAK,1130,737-800,26,3,33,3,3,32,,,,,7,6
2019-05-07 23:47,PEK,5713,737-800,23,6,28,6,6,24,,,,,5,1
2019-05-07 23:46,HAK,5408,737-800,28,6,34,4,3,32,,,,,6,4
2019-05-07 23:46,CGO,7989,737-800,18,7,28,6,6,23,,,,,10,5
2019-05-07 23:45,PEK,5798,737-800,25,2,20,2,1,21,,,,,-5,-4
2019-05-07 23:40,XIY,1541,737-800,14,5,28,5,5,24,,,,,14,10
2019-05-07 23:40,XIY,1481,737-800,12,6,24,6,6,25,,,,,12,13
2019-05-07 23:36,CAN,7616,737-800,21,5,28,4,4,29,,,,,7,8
2019-05-07 23:36,CAN,7616,737-800,21,5,28,4,4,29,,,,,7,8
2019-05-07 23:35,URC,206P,737-800,17,4,22,5,5,21,,,,,5,4
2019-05-07 23:30,¹þ¶û±õ,7395,737-800,16,5,22,4,4,23,,,,,6,7
2019-05-07 23:30,DLC,5852,737-800,20,4,24,4,4,22,,,,,4,2
2019-05-07 23:28,CGO,205U,737-800,19,2,24,4,3,24,,,,,5,5
2019-05-07 23:23,´óÁ¬,1496,737-800,18,6,28,5,5,25,,,,,10,7
2019-05-07 23:19,HAK,5733,737-800,25,5,32,6,6,33,,,,,7,8
2019-05-07 23:17,XIY,5709,737-800,14,6,27,8,6,24,,,,,13,10
2019-05-07 22:48,XIY,1733,737-800,15,4,22,4,4,22,,,,,7,7
2019-05-07 22:48,HAK,1375,737-800,26,4,32,25,26,35,,,,,6,9
2019-05-07 22:42,SYX,5358,737-800,25,8,36,8,8,36,1,1,,11,11,11
2019-05-07 22:39,XNN,6060,737-800,10,5,21,6,6,21,,,,,11,11
2019-05-07 22:38,XNN,1493,737-800,10,6,21,6,6,21,,,,,11,11
2019-05-07 22:35,SYX,1141,737-800,28,4,33,6,7,31,,,,,5,3
2019-05-07 22:27,HAK,5373,737-800,30,6,30,8,8,33,,,,,0,3
2019-05-07 22:26,ZGC,1347,737-800,10,7,23,6,7,25,,,,,13,15
2019-05-07 22:22,DLC,7378,737-800,21,5,22,5,4,24,,,,,1,3
2019-05-07 22:16,CKG,6808,737-800,18,4,30,5,5,26,,,,,12,8
2019-05-07 22:15,CAN,7886,737-800,23,4,31,3,2,30,,,,,8,7
2019-05-07 22:14,CAN,5359,737-800,22,9,32,4,3,28,,,,,10,6
2019-05-07 22:13,HHA,7398,737-800,16,26,5,23,3,3,,,,,-11,-13
2019-05-07 22:08,MIG,6800,737-800,14,3,22,4,4,22,,,,,8,8
2019-05-07 22:05,HAK,1545,737-800,28,4,34,4,4,32,,,,,6,4
2019-05-07 21:54,DLC,1491,737-800,20,4,26,4,4,26,,,,,6,6
2019-05-07 21:53,URC,6995,737-800,19,4,28,6,6,22,,,,,9,3
2019-05-07 21:52,HAK,1373,737-800,26,3,33,4,4,30,,,,,7,4
2019-05-07 21:44,TYN,5687,737-800,19,5,18,5,5,22,,,,,-1,3
2019-05-07 21:35,ZGC,5135,737-800,9,4,22,7,8,28,,,,,13,19
2019-05-07 21:33,PEK,6063,737-800,26,6,27,5,5,25,,,,,1,-1
2019-05-07 21:09,HAK,7639,737-800,25,6,36,8,7,32,1,,,1,11,7
2019-05-07 20:50,HAK,5082,737-800,26,4,35,4,4,32,,,,,9,6
2019-05-07 20:45,HAK,5462,737-800,26,3,32,6,4,28,,,,,6,2
2019-05-07 20:03,DLC,6062,737-800,20,3,22,3,3,24,,,,,2,4
2019-05-07 19:26,SYX ,5467,737-800,30,8,36,3,2,30,,,,,6,0
2019-05-07 19:08,FOC,1562,737-800,20,4,27,5,4,26,,,,,7,6
2019-05-07 19:00,HAK,5371,737-800,26,7,31,6,6,33,,,,,5,7
2019-05-07 18:58,HGH,5522,737-800,18,5,24,5,6,21,,,,,6,3
2019-05-07 18:42,HAK,5503,737-800,26,2,29,3,3,24,,,,,3,-2
2019-05-07 18:41,URC,205V,737-800,20,4,26,4,5,24,,,,,6,4
2019-05-07 17:42,XIY,1902,737-800,13,5,26,5,5,22,,,,,13,9
2019-05-07 17:03,YIH,1906,737-800,20,5,28,4,4,27,,,,,8,7
2019-05-07 16:24,XIY,1483,737-800,13,5,14,5,4,17,,,,,1,4
2019-05-07 12:10,XUZ,1208,737-800,20,4,24,6,6,22,,,,,4,2
2019-05-07 12:02,CTU,7990,737-800,15,3,25,3,3,23,,,,,10,8
2019-05-07 07:59,PEK,5479,737-800,19,5,22,6,5,25,,,,,3,6
2019-05-07 07:58,PEK,5375,737-800,20,0,18,3,3,22,,,,,-2,2
2019-05-07 07:26,HAK,5089,737-800,29,4,30,1,1,34,,,,,1,5
2019-05-07 07:24,HAK,5405,737-800,28,8,36,6,4,37,,,,,8,9
2019-05-07 07:23,HAK,5521,737-800,28,3,30,5,4,30,,,,,2,2
2019-05-07 07:04,CGO,6808,737-800,19,4,26,4,4,26,,,,,7,7
2019-05-07 06:28,HAK,5138,737-800,27,4,34,5,5,36,,,,,7,9
2019-05-07 06:25,XIY,5373,737-800,12,6,24,8,8,30,,,,,12,18
2019-05-07 06:01,XIY,1733,737-800,12,2,22,2,2,20,,,,,10,8
2019-05-07 05:48,CAN,5406,737-800,22,4,30,4,6,28,,,,,8,6
2019-05-07 05:36,XIY,5503,737-800,10,4,24,3,3,24,,,,,14,14
2019-05-07 05:06,ZGC,5502,737-800,10,8,20,4,6,22,,,,,10,12
2019-05-07 05:03,ZGC,1347,737-800,10,5,21,6,5,22,,,,,11,12
2019-05-07 05:02,ZGC,1492,737-800,10,4,20,6,7,22,,,,,10,12
2019-05-07 05:01,FOC,6103,737-800,18,4,25,3,3,25,,,,,7,7
2019-05-07 05:00,FOC,7113,737-800,20,2,25,4,5,27,,,,,5,7
2019-05-07 04:59,KMG,7167,737-800,19,5,25,5,5,25,,,,,6,6
2019-05-07 04:54,º£¿Ú,1103,737-800,26,4,30,8,6,32,,,,,4,6
2019-05-07 04:45,HGH,5153,737-800,17,4,24,2,2,22,,,,,7,5
2019-05-07 04:41,KMG,1587,737-800,20,3,23,6,3,23,,,,,3,3
2019-05-07 04:40,TYN,6061,737-800,15,4,22,4,4,24,,,,,7,9
2019-05-07 04:40,KMG,1588,737-800,17,4,24,5,4,22,,,,,7,5
2019-05-07 04:30,XIY,5116,737-800,15,4,20,4,4,20,,,,,5,5
2019-05-07 04:27,SZX,7619,737-800,25,5,20,5,5,28,,,,,-5,3
2019-05-07 04:24,FOC,1351,737-800,19,3,27,4,4,22,,,,,8,3
2019-05-07 04:20,CKG,7379,737-800,18,5,28,4,4,30,,,,,10,12
2019-05-07 04:20,CAN,1498,737-800,19,6,32,6,6,27,1,,,1,13,8
2019-05-07 04:20,SYX,1796,737-800,30,5,35,5,4,32,,,,,5,2
2019-05-07 04:16,PEK,5482,737-800,12,5,22,5,5,22,,,,,10,10
2019-05-07 04:07,º£¿Ú,1497,737-800,27,3,35,3,3,34,,,,,8,7
2019-05-07 04:05,HAK,5417,737-800,28,4,32,4,4,32,,,,,4,4
2019-05-07 03:55,CKG,5467,737-800,20,4,28,6,4,25,,,,,8,5
2019-05-07 03:54,XIY,1161,737-800,15,4,24,4,4,22,,,,,9,7
2019-05-07 03:53, CKG,5467,737-800,20,4,28,6,4,25,,,,,8,5
2019-05-07 03:51,KMG,6016,737-800,20,4,27,5,4,26,,,,,7,6
2019-05-07 03:49,SYX,5481,737-800,29,7,34,6,6,36,,,,,5,7
2019-05-07 03:48,XIY,1902,737-800,12,5,24,5,5,20,,,,,12,8
2019-05-07 03:44,HAK,1542,737-800,27,4,34,4,4,30,,,,,7,3
2019-05-07 03:34,HAK,5686,737-800,30,8,34,4,4,30,,,,,4,0
2019-05-07 03:30,HAK,5371,737-800,27,6,30,7,8,37,,,,,3,10
2019-05-07 03:27,PEK,5539,737-800,14,5,25,5,4,26,,,,,11,12
2019-05-07 03:24,DLC,7378,737-800,16,4,22,4,4,23,,,,,6,7
2019-05-07 03:23,HAK,5581,737-800,25,10,30,7,6,37,,,,,5,12
2019-05-07 03:20,XIY,5625,737-800,13,4,22,4,4,20,,,,,9,7
2019-05-07 03:20,FOC,5430,737-800,25,5,28,5,4,30,,,,,3,5
2019-05-07 03:19,FOC,5430,737-800,25,5,30,5,4,32,,,,,5,7
2019-05-07 03:19,DLC,1496,737-800,16,4,22,4,4,24,,,,,6,8
2019-05-07 03:17,HHA,6066,737-800,19,2,24,2,2,24,,,,,5,5
2019-05-07 03:13,SZC,7172,737-800,22,5,33,6,6,30,,,,,11,8
2019-05-07 03:13,KMG,7992,737-800,20,6,25,7,6,24,,,,,5,4
2019-05-07 03:12,URC,6268,737-800,18,6,22,5,6,25,,,,,4,7
2019-05-07 03:10,XIY,1482,737-800,15,5,27,6,6,20,,,,,12,5
2019-05-07 03:10,HAK,1793,737-800,30,4,35,4,4,30,,,,,5,0
2019-05-07 03:04,PEK ,5428,737-800,21,3,20,4,4,28,,,,,-1,7
2019-05-07 02:56,SYX,5623,737-800,30,9,34,6,6,34,,,,,4,4
2019-05-07 02:54,FOC,6103,737-800,20,5,27,5,5,28,,,,,7,8
2019-05-07 02:54,HGH,1489,737-800,15,3,23,4,4,22,,,,,8,7
2019-05-07 02:52,SYX,5373,737-800,30,9,36,9,8,34,,,,,6,4
2019-05-07 02:49,URC,205U,737-800,13,6,24,4,4,20,,,,,11,7
2019-05-07 02:49,HAK,1488,737-800,25,7,33,7,6,30,,,,,8,5
2019-05-07 02:48,HAK,1783,737-800,25,3,26,3,6,32,,,,,1,7
2019-05-07 02:44,FOC,5182,737-800,19,3,27,4,3,22,,,,,8,3
2019-05-07 02:40,URC,7198,737-800,15,4,24,4,4,24,,,,,9,9
2019-05-07 02:38,URC,6995,737-800,14,4,24,2,3,23,,,,,10,9
2019-05-07 02:38,HAK,1502,737-800,27,6,36,4,4,34,,,,,9,7
2019-05-07 02:36,HGH,5483,737-800,20,6,26,5,6,27,,,,,6,7
2019-05-07 02:36,HGH,5483,737-800,20,6,26,5,6,27,,,,,6,7
2019-05-07 02:29,DLC,1487,737-800,18,3,20,2,2,20,,,,,2,2
2019-05-07 02:29,KMG,7988,737-800,20,4,26,6,4,26,,,,,6,6
2019-05-07 02:29,XIY,1435,737-800,12,5,24,5,6,22,,,,,12,10
2019-05-07 02:28,PEK,7173,737-800,15,4,28,5,5,22,,,,,13,7
2019-05-07 02:27,XIY,5180,737-800,11,6,24,6,6,22,,,,,13,11
2019-05-07 02:26,XIY,1435,737-800,12,5,24,5,6,22,,,,,12,10
2019-05-07 02:26,SYX,1505,737-800,31,3,33,4,4,32,,,,,2,1
2019-05-07 02:24,SZX,5520,737-800,22,5,32,5,4,30,1,,,1,10,8
2019-05-07 02:23,URC,5713,737-800,15,6,22,6,6,23,,,,,7,8
2019-05-07 02:23,HHA,1549,737-800,18,5,27,5,5,26,,,,,9,8
2019-05-07 02:22,XIY,1903,737-800,13,1,23,2,2,22,,,,,10,9
2019-05-07 02:22,URC,1568,737-800,14,4,22,2,4,24,,,,,8,10
2019-05-07 02:21,URC,1570,737-800,14,6,20,6,6,20,,,,,6,6
2019-05-07 02:21,URC,1323,737-800,13,2,26,2,2,25,,,,,13,12
2019-05-07 02:20,DLC,6063,737-800,20,5,22,4,6,24,,,,,2,4
2019-05-07 02:20,URC,1568,737-800,14,4,22,2,4,24,,,,,8,10
2019-05-07 02:20,PEK,1548,737-800,15,8,10,6,5,16,,,,,-5,1
2019-05-07 02:20,DLC,1102,737-800,15,2,24,2,2,18,,,,,9,3
2019-05-07 02:19,URC,5620,737-800,15,4,27,4,2,22,,,,,12,7
2019-05-07 02:18,URC,1929,737-800,14,4,22,4,4,22,,,,,8,8
2019-05-07 02:17,URC,1727,737-800,16,5,24,5,5,19,,,,,8,3
2019-05-07 02:14,URC,1322,737-800,16,2,22,2,2,24,,,,,6,8
2019-05-07 02:12,URC,205T ,737-800,17,2,26,4,4,24,,,,,9,7
2019-05-07 02:12,HAK,5480,737-800,28,6,32,4,6,34,,,,,4,6
2019-05-07 02:12,URC,2159,737-800,15,5,21,4,5,23,,,,,6,8
2019-05-07 02:11,SYX,5358,737-800,30,7,36,8,8,36,,,,,6,6
2019-05-07 02:11,HHA,7398,737-800,19,4,26,3,3,25,,,,,7,6
2019-05-07 02:11,DLC,1102,737-800,15,2,24,2,2,18,,,,,9,3
2019-05-07 02:10,URC ,1569,737-800,18,2,18,2,3,24,,,,,0,6
2019-05-07 02:09,HGH,1490,737-800,17,5,24,5,4,21,,,,,7,4
2019-05-07 02:08,URC,5439,737-800,18,6,24,6,5,25,,,,,6,7
2019-05-07 02:06,XMN,5735,737-800,21,6,24,4,4,28,,,,,3,7
2019-05-07 02:06,HHA,7618,737-800,20,4,28,4,4,26,,,,,8,6
2019-05-07 02:05,CAN,1141,737-800,21,6,30,8,6,29,,,,,9,8
2019-05-07 02:04,XMN,5662,737-800,21,2,28,2,6,26,,,,,7,5
2019-05-07 02:04,XMN,5735,737-800,21,6,24,4,4,28,,,,,3,7
2019-05-07 02:04,XIY,1483,737-800,10,5,17,8,8,26,,,,,7,16
2019-05-07 02:03,XMN,1787,737-800,19,2,24,2,2,22,,,,,5,3
2019-05-07 02:03,YIH,1350,737-800,16,4,26,6,6,28,,,,,10,12
2019-05-07 02:02,XMN,5337,737-800,20,4,28,5,4,27,,,,,8,7
2019-05-07 02:01,PEK,5540,737-800,15,4,20,3,4,21,,,,,5,6
2019-05-07 02:01,MIG,6800,737-800,14,4,24,4,4,23,,,,,10,9
2019-05-07 02:01,XMN,1545,737-800,21,4,32,6,6,30,,,,,11,9
2019-05-07 01:56,SHA,1729,737-800,15,5,20,4,5,20,,,,,5,5
2019-05-07 01:53,HHA,5338,737-800,25,2,20,3,2,23,,,,,-5,-2
2019-05-07 01:51,HAK,7399,737-800,26,4,32,4,4,0,,,,,6,-26
2019-05-07 01:45,PEK ,5466,737-800,21,4,17,9,4,19,,,,,-4,-2
2019-05-07 01:44,TYN,206G,737-800,15,4,24,4,4,22,,,,,9,7
2019-05-07 01:43,CAN,7886,737-800,22,3,30,4,3,30,,,,,8,8
2019-05-07 01:40,CAN,1373,737-800,24,4,30,3,4,26,,,,,6,2
2019-05-07 01:40,PEK,5538,737-800,18,3,28,3,3,26,,,,,10,8
2019-05-07 01:37,CAN,5359,737-800,21,4,27,5,5,28,,,,,6,7
2019-05-07 01:37,HRB,7395,737-800,10,8,24,7,6,26,,,,,14,16
2019-05-07 01:36,XIY,1162,737-800,12,3,27,3,3,21,,,,,15,9
2019-05-07 01:35,URC,5797,737-800,15,6,14,4,5,22,,,,,-1,7
2019-05-07 01:34,XIY,5115,737-800,20,4,18,6,6,24,,,,,-2,4
2019-05-07 01:32,URC,1995,737-800,17,5,26,6,6,24,,,,,9,7
2019-05-07 01:30,XMN,1787,737-800,19,0,24,0,0,22,,,,,5,3
2019-05-07 01:30,CGO,7993,737-800,20,4,24,4,4,24,,,,,4,4
2019-05-07 01:30,XIY,1481,737-800,15,6,26,5,5,20,,,,,11,5
2019-05-07 01:29,SYX,1213,737-800,30,6,36,6,6,35,,,,,6,5
2019-05-07 01:27,HAK,1728,737-800,28,4,34,6,6,29,,,,,6,1
2019-05-07 01:26,URC,5853,737-800,14,6,26,6,7,27,,,,,12,13
2019-05-07 01:25,URC,1725,737-800,14,6,26,4,6,24,,,,,12,10
2019-05-07 01:25,SZX,5137,737-800,25,4,22,2,4,30,,,,,-3,5
2019-05-07 01:25,YIH,1480,737-800,16,4,26,4,4,22,,,,,10,6
2019-05-07 01:18,SZX,5408,737-800,23,3,29,4,4,28,,,,,6,5
2019-05-07 01:15,HGH,5580,737-800,17,6,22,6,6,28,,,,,5,11
2019-05-07 01:15,HRB,7105,737-800,12,4,26,4,4,22,,,,,14,10
2019-05-07 01:15,HAK,5686,737-800,30,5,34,4,4,30,,,,,4,0
2019-05-07 01:11,HHA,5638,737-800,24,4,27,4,4,24,,,,,3,0
2019-05-07 01:11,HHA,5638,737-800,24,4,27,4,4,24,,,,,3,0
2019-05-07 01:10,MIG,5449,737-800,16,5,27,5,5,26,,,,,11,10
2019-05-07 01:07,XIY,5661,737-800,10,4,18,4,5,24,,,,,8,14
2019-05-07 01:02,SZX,1726,737-800,20,3,30,4,3,26,,,,,10,6
2019-05-07 00:59,XIY,5709,737-800,20,6,26,7,8,30,,,,,6,10
2019-05-07 00:56,CGO,1586,737-800,20,4,26,4,4,24,,,,,6,4
2019-05-07 00:55,YIH,1559,737-800,16,3,28,3,3,22,,,,,12,6
2019-05-07 00:53,HAK,5579,737-800,28,8,37,8,8,36,,,,,9,8
2019-05-07 00:52,HHA,1386,737-800,21,3,26,4,3,22,,,,,5,1
2019-05-07 00:43,XMN,5662,737-800,21,2,28,2,6,26,,,,,7,5
2019-05-07 00:41,XIY,1501,737-800,11,4,18,4,4,22,,,,,7,11
2019-05-07 00:39,XIY,5465,737-800,12,4,24,4,4,24,,,,,12,12
2019-05-07 00:36,CAN,1538,737-800,21,3,28,2,4,27,,,,,7,6
2019-05-07 00:35,XIY,6062,737-800,13,4,22,3,3,2,,,,,9,-11
2019-05-07 00:34,SYX,5852,737-800,29,4,32,6,5,32,,,,,3,3
2019-05-07 00:34,KHG,206P,737-800,17,4,21,4,4,18,,,,,4,1
2019-05-07 00:34,PEK,1346,737-800,19,4,28,4,4,22,,,,,9,3
2019-05-07 00:33,URC,5611,737-800,15,6,24,5,5,22,,,,,9,7
2019-05-07 00:33,TYN,5090,737-800,20,3,22,3,3,24,,,,,2,4
2019-05-07 00:31,KMG,1208,737-800,20,6,26,4,4,24,,,,,6,4
2019-05-07 00:30,CAN,5478,737-800,21,3,32,4,4,26,1,,,1,11,5
2019-05-07 00:28,HGH,1495,737-800,20,4,30,4,4,23,,,,,10,3
2019-05-07 00:24,HGH,1547,737-800,17,6,25,6,6,24,,,,,8,7
2019-05-07 00:22,HAK,1797,737-800,28,3,33,4,4,30,,,,,5,2
2019-05-07 00:16,URC,5637,737-800,15,0,18,1,2,20,,,,,3,5
2019-05-07 00:09,XIY,5429,737-800,12,4,16,4,4,22,,,,,4,10
2019-05-07 00:08,CKG,1735,737-800,19,5,26,6,4,23,,,,,7,4
2019-05-07 00:08,DLC,5712,737-800,18,2,20,2,2,21,,,,,2,3
2019-05-07 00:02,XIY,5661,737-800,10,18,4,4,5,24,,,,,-6,14
2019-05-07 00:00,PEK ,5428,737-800,21,3,20,5,5,30,,,,,-1,9
2019-05-06 23:52,XIY,1131,737-800,20,5,27,5,4,26,,,,,7,6
2019-05-06 23:50,HRB,1433,737-800,16,2,10,2,2,16,,,,,-6,0
2019-05-06 23:48,XMN,5337,737-800,20,4,28,5,4,27,,,,,8,7
2019-05-06 23:48,HHA,1101,737-800,19,3,23,2,2,26,,,,,4,7
2019-05-06 23:44,HAK,5733,737-800,27,7,37,6,7,34,1,,,1,10,7
2019-05-06 23:42,FOC,1562,737-800,19,5,28,5,4,29,,,,,9,10
2019-05-06 23:36,HRB,1348,737-800,10,4,20,3,4,18,,,,,10,8
2019-05-06 23:33,CGO,5462,737-800,20,4,24,4,4,24,,,,,4,4
2019-05-06 23:30,HAK,5139,737-800,28,8,26,8,6,30,,,,,-2,2
2019-05-06 23:30,DLC,1491,737-800,16,5,26,5,5,28,,,,,10,12
2019-05-06 23:28,CAN,1130,737-800,21,3,31,3,2,28,,,,,10,7
2019-05-06 23:25,À¥Ã÷,1209,737-800,22,3,26,4,5,23,,,,,4,1
2019-05-06 23:16,DLC,1541,737-800,16,6,26,6,5,24,,,,,10,8
2019-05-06 23:16,CGO,205V,737-800,18,5,28,5,5,26,,,,,10,8
2019-05-06 23:10,SZX,1928,737-800,24,6,22,7,6,26,,,,,-2,2
2019-05-06 23:09,PEK,5416,737-800,21,8,26,8,8,28,,,,,5,7
2019-05-06 23:03,HAK,5136,737-800,27,4,32,6,4,35,,,,,5,8
2019-05-06 22:55,HAK,1927,737-800,28,6,33,8,6,32,,,,,5,4
2019-05-06 22:50,HAK,5418,737-800,27,9,34,7,8,33,,,,,7,6
2019-05-06 22:49,HAK,6809,737-800,28,5,31,6,6,32,,,,,3,4
2019-05-06 22:46,XNN,6060,737-800,12,6,21,4,4,21,,,,,9,9
2019-05-06 22:46,XNN,1493,737-800,12,5,22,6,6,18,,,,,10,6
2019-05-06 22:44,CGO,7991,737-800,19,6,24,6,6,24,,,,,5,5
2019-05-06 22:44,SZX,7171,737-800,23,5,28,4,5,28,,,,,5,5
2019-05-06 22:39,HGH,5135,737-800,17,3,25,3,2,23,,,,,8,6
2019-05-06 22:33,º£¿Ú,5855,737-800,27,8,26,4,4,26,,,,,-1,-1
2019-05-06 22:16,IRC,1325,737-800,19,5,20,4,4,19,,,,,1,0
2019-05-06 21:50,XIY,1795,737-800,20,4,22,6,5,26,,,,,2,6
2019-05-06 21:48,SYX,1997,737-800,31,6,35,5,4,32,,,,,4,1
2019-05-06 21:41,MIG,1798,737-800,16,6,28,6,6,24,,,,,12,8
2019-05-06 21:30,CAN,6065,737-800,25,4,32,4,5,30,,,,,7,5
2019-05-06 21:18,TYN,5687,737-800,20,6,22,6,5,21,,,,,2,1
2019-05-06 21:09,FOC,1905,737-800,20,4,27,4,3,22,,,,,7,2
2019-05-06 20:50,CGO,7989,737-800,20,6,27,4,4,24,,,,,7,4
2019-05-06 19:39,HGH,5522,737-800,18,5,24,6,6,22,,,,,6,4
2019-05-06 18:54,HAK,5346,737-800,26,6,32,6,6,31,,,,,6,5
2019-05-06 15:52,SZX ,5141,737-800,24,5,32,4,4,30,,,,,8,6
2019-05-06 12:35,MIG,5409,737-800,17,4,26,4,4,28,,,,,9,11
2019-05-06 12:05,FOC,1905,737-800,21,3,26,3,4,24,,,,,5,3
2019-05-06 12:03,FOC,1905,737-800,21,3,28,3,4,24,,,,,7,3
2019-05-06 11:31,CTU,7990,737-800,19,3,29,4,4,26,,,,,10,7
2019-05-06 10:29,ÐìÖÝ,6015,737-800,20,3,26,3,3,24,,,,,6,4
2019-05-06 09:54,XIY,1482,737-800,18,3,22,4,3,22,,,,,4,4
2019-05-06 09:14,HGH,7398,737-800,21,5,28,3,4,25,,,,,7,4
2019-05-06 09:13,KMG,1209,737-800,20,3,25,2,3,24,,,,,5,4
2019-05-06 08:26,PEK,5428,737-800,20,4,24,4,4,30,,,,,4,10
2019-05-06 07:41,HHA,1386,737-800,18,4,27,3,3,21,,,,,9,3
2019-05-06 07:30,XMN,1101,737-800,20,3,34,3,3,36,1,1,,11,14,16
2019-05-06 07:30,XMN, 5337,737-800,20,4,30,3,4,30,,,,,10,10
2019-05-06 07:29,XMN,1547,737-800,21,5,30,4,8,29,,,,,9,8
2019-05-06 07:28,XMN,1346,737-800,20,5,27,4,5,25,,,,,7,5
2019-05-06 06:28,PEK,6103,737-800,15,5,22,6,5,20,,,,,7,5
2019-05-06 06:27,HAK,7616,737-800,26,5,33,4,5,33,,,,,7,7
2019-05-06 06:27,HAK,5405,737-800,28,5,36,5,4,36,,,,,8,8
2019-05-06 06:26,HAK,5405,737-800,28,5,36,5,4,36,,,,,8,8
2019-05-06 06:24,KMG,1208,737-800,20,3,24,4,4,21,,,,,4,1
2019-05-06 06:10,HAK,1793,737-800,29,8,31,6,6,30,,,,,2,1
2019-05-06 06:09,HAK,7988,737-800,29,9,31,5,8,32,,,,,2,3
2019-05-06 06:08,HAK,1783,737-800,29,5,32,6,6,35,,,,,3,6
2019-05-06 06:01,FOC,1905,737-800,21,3,26,3,3,23,,,,,5,2
2019-05-06 05:56,FOC,1905,737-800,21,3,28,3,4,24,,,,,7,3
2019-05-06 05:37,XIY,1161,737-800,19,4,28,4,3,22,,,,,9,3
2019-05-06 05:10,FOC,1351,737-800,21,4,28,4,3,24,,,,,7,3
2019-05-06 05:08,XIY,1548,737-800,19,3,26,3,3,24,,,,,7,5
2019-05-06 05:01,CAN,5478,737-800,22,4,34,4,4,28,,,,,12,6
2019-05-06 05:00,CAN,5478,737-800,22,4,34,4,4,28,,,,,12,6
2019-05-06 04:58,SYX,5372,737-800,27,4,32,4,6,34,,,,,5,7
2019-05-06 04:49,XIY,1902,737-800,17,5,26,5,5,20,,,,,9,3
2019-05-06 04:34,PEK,5539,737-800,13,4,20,4,5,22,,,,,7,9
2019-05-06 04:28,HAK,5429,737-800,29,3,33,7,7,36,,,,,4,7
2019-05-06 04:12,CGO,1927,737-800,18,4,22,7,4,25,,,,,4,7
2019-05-06 04:11,KMG,7992,737-800,20,7,26,8,8,24,,,,,6,4
2019-05-06 04:09,HAK,1488,737-800,30,5,34,7,6,30,,,,,4,0
2019-05-06 04:03,HAK,1141,737-800,28,4,30,4,4,32,,,,,2,4
2019-05-06 04:01,HAK,6808,737-800,27,4,35,4,4,32,,,,,8,5
2019-05-06 03:58,FOC,5136,737-800,20,5,28,5,4,32,,,,,8,12
2019-05-06 03:55,FOC,1562,737-800,21,4,30,5,4,31,,,,,9,10
2019-05-06 03:47,PEK,5538,737-800,11,2,24,2,2,22,,,,,13,11
2019-05-06 03:44,CAN,5521,737-800,21,4,25,0,0,19,,,,,4,-2
2019-05-06 03:43,CGO,205V,737-800,18,2,30,2,2,24,,,,,12,6
2019-05-06 03:39,SYX,5358,737-800,30,7,35,7,8,34,,,,,5,4
2019-05-06 03:36,YIH,1480,737-800,22,5,23,5,4,22,,,,,1,0
2019-05-06 03:35,SYX,1495,737-800,30,3,32,4,4,36,,,,,2,6
2019-05-06 03:34,SYX,1495,737-800,30,4,33,4,4,36,,,,,3,6
2019-05-06 03:29,XIY,5503,737-800,17,4,26,3,4,23,,,,,9,6
2019-05-06 03:28,HGH,5502,737-800,20,3,25,2,2,24,,,,,5,4
2019-05-06 03:28,KMG,7993,737-800,20,5,25,6,7,24,,,,,5,4
2019-05-06 03:26,XIY,1482,737-800,18,4,28,5,6,24,,,,,10,6
2019-05-06 03:22,KMG,6015,737-800,20,3,24,5,5,24,,,,,4,4
2019-05-06 03:21,URC,6268,737-800,15,5,25,7,6,26,,,,,10,11
2019-05-06 03:21,KMG,5732,737-800,20,2,24,3,3,23,,,,,4,3
2019-05-06 03:21,CAN,5373,737-800,22,6,27,7,6,28,,,,,5,6
2019-05-06 03:14,TYN,5581,737-800,15,4,20,4,5,22,,,,,5,7
2019-05-06 03:13,HAK,1213,737-800,28,6,36,6,6,35,,,,,8,7
2019-05-06 03:10,URC,7198,737-800,12,6,11,8,6,21,,,,,-1,9
2019-05-06 03:10,URC,2159,737-800,15,8,24,3,4,22,,,,,9,7
2019-05-06 03:08,FOC,1348,737-800,23,4,30,3,3,28,,,,,7,5
2019-05-06 03:06,XIY,1435,737-800,20,5,26,6,6,24,,,,,6,4
2019-05-06 03:02,SZX,7377,737-800,23,6,30,6,5,30,,,,,7,7
2019-05-06 03:02,PEK,5463,737-800,18,5,25,5,5,18,,,,,7,0
2019-05-06 03:01,URC,6995,737-800,10,4,27,4,4,21,,,,,17,11
2019-05-06 03:00,KMG,1588,737-800,20,6,24,7,5,23,,,,,4,3
2019-05-06 02:56,CGO,6016,737-800,18,4,28,4,4,26,,,,,10,8
2019-05-06 02:49,XIY,5520,737-800,20,5,29,5,6,26,,,,,9,6
2019-05-06 02:47,XIY,7400,737-800,18,5,28,4,4,26,,,,,10,8
2019-05-06 02:45,HGH,5662,737-800,22,3,28,3,6,26,,,,,6,4
2019-05-06 02:45,XIY,1162,737-800,19,3,28,4,4,26,,,,,9,7
2019-05-06 02:38,XIY,5180,737-800,19,6,27,5,5,24,,,,,8,5
2019-05-06 02:34,URC,1725,737-800,10,4,26,6,5,28,,,,,16,18
2019-05-06 02:33,CGO,1586,737-800,17,4,24,4,4,24,,,,,7,7
2019-05-06 02:32,CAN,5373,737-800,22,6,27,7,6,28,,,,,5,6
2019-05-06 02:28,HAK,1497,737-800,28,4,35,4,4,35,,,,,7,7
2019-05-06 02:25,HHA,5735,737-800,20,4,20,4,4,20,,,,,0,0
2019-05-06 02:25,SYX,206G,737-800,30,3,35,2,3,33,,,,,5,3
2019-05-06 02:23,HRB,7105,737-800,3,3,21,5,4,23,,,,,18,20
2019-05-06 02:22,URC,1323,737-800,15,4,24,4,4,24,,,,,9,9
2019-05-06 02:20,XIY,1163,737-800,19,3,28,2,3,21,,,,,9,2
2019-05-06 02:19,URC,206P,737-800,15,5,24,5,5,21,,,,,9,6
2019-05-06 02:17,XIY,1501,737-800,18,3,22,3,4,25,,,,,4,7
2019-05-06 02:15,ZGC,5852,737-800,10,4,20,5,4,21,,,,,10,11
2019-05-06 02:14,URC,5636,737-800,10,5,25,5,4,24,,,,,15,14
2019-05-06 02:13,SZX,7172,737-800,23,4,33,6,4,30,,,,,10,7
2019-05-06 02:09,URC,1322,737-800,8,4,27,4,4,24,,,,,19,16
2019-05-06 02:09,URC ,5620,737-800,17,4,25,3,4,23,,,,,8,6
2019-05-06 02:06,ZGC,5153,737-800,10,7,20,4,5,20,,,,,10,10
2019-05-06 02:03,CAN,1538,737-800,22,3,30,4,2,28,,,,,8,6
2019-05-06 02:02,ZGC,1347,737-800,10,9,20,6,8,21,,,,,10,11
2019-05-06 02:02,URC,5637,737-800,15,2,24,2,1,20,,,,,9,5
2019-05-06 02:02,XIY,1903,737-800,19,2,27,2,2,28,,,,,8,9
2019-05-06 01:56,HAK,5139,737-800,28,8,32,8,7,33,,,,,4,5
2019-05-06 01:50,URC,1568,737-800,15,6,26,5,6,20,,,,,11,5
2019-05-06 01:48,DLC,1487,737-800,15,2,20,2,2,20,,,,,5,5
2019-05-06 01:47,PEK,1545,737-800,17,7,24,6,6,32,,,,,7,15
2019-05-06 01:46,URC,5797,737-800,15,5,18,7,7,22,,,,,3,7
2019-05-06 01:42,PEK,5713,737-800,17,6,26,6,6,23,,,,,9,6
2019-05-06 01:41,FOC,5182,737-800,22,2,30,2,3,28,,,,,8,6
2019-05-06 01:39,HHA,7175,737-800,20,4,30,4,4,25,,,,,10,5
2019-05-06 01:38,HHA,5338,737-800,20,5,23,4,4,23,,,,,3,3
2019-05-06 01:38,XIY,5115,737-800,20,3,18,5,5,26,,,,,-2,6
2019-05-06 01:36,KMG,7989,737-800,20,6,26,6,6,26,,,,,6,6
2019-05-06 01:35,CAN,6065,737-800,21,5,34,4,4,30,1,,,1,13,9
2019-05-06 01:35,SYX,7399,737-800,29,3,30,6,5,31,,,,,1,2
2019-05-06 01:32,DLC,5712,737-800,12,4,20,2,2,20,,,,,8,8
2019-05-06 01:30,URC ,5853,737-800,16,5,24,6,5,23,,,,,8,7
2019-05-06 01:21,HGH,1490,737-800,20,5,28,5,5,26,,,,,8,6
2019-05-06 01:20,SYX,1997,737-800,28,6,36,4,4,34,,,,,8,6
2019-05-06 01:20,FOC,5430,737-800,22,5,32,5,4,32,1,1,,11,10,10
2019-05-06 01:19,SYX,1796,737-800,30,5,35,4,4,32,,,,,5,2
2019-05-06 01:19,CAN ,1505,737-800,21,4,29,4,4,26,,,,,8,5
2019-05-06 01:17,DLC,6063,737-800,16,5,21,4,4,22,,,,,5,6
2019-05-06 01:16,SZX,5135,737-800,22,3,28,2,2,28,,,,,6,6
2019-05-06 01:15,SYX,5462,737-800,30,5,35,5,5,34,,,,,5,4
2019-05-06 01:14,MIG,6800,737-800,20,4,25,3,3,24,,,,,5,4
2019-05-06 01:14,MIG,6800,737-800,20,4,25,3,3,24,,,,,5,4
2019-05-06 01:13,DLC,1541,737-800,12,4,26,4,5,19,,,,,14,7
2019-05-06 01:13,MIG,5409,737-800,17,3,22,3,3,20,,,,,5,3
2019-05-06 01:10,HAK,1372,737-800,28,5,35,5,6,34,,,,,7,6
2019-05-06 01:09,SZX,5141,737-800,20,5,30,5,6,30,,,,,10,10
2019-05-06 01:09,HGH,5483,737-800,22,4,29,4,4,25,,,,,7,3
2019-05-06 01:07,XIY,5116,737-800,18,4,24,4,4,24,,,,,6,6
2019-05-06 01:07,CGO,5623,737-800,20,6,25,5,5,23,,,,,5,3
2019-05-06 01:07,XIY,5661,737-800,18,4,24,4,4,28,,,,,6,10
2019-05-06 01:03,CKG,7379,737-800,20,4,31,3,3,32,,,,,11,12
2019-05-06 01:00,HAK,1502,737-800,28,4,34,4,4,34,,,,,6,6
2019-05-06 00:57,CAN,5359,737-800,22,5,26,5,5,26,,,,,4,4
2019-05-06 00:57,KHG,1569,737-800,17,3,24,2,2,22,,,,,7,5
2019-05-06 00:56,HGH,5408,737-800,22,2,28,4,3,24,,,,,6,2
2019-05-06 00:54,URC,1995,737-800,8,4,25,6,6,24,,,,,17,16
2019-05-06 00:52,TYN,6061,737-800,15,4,16,7,7,24,,,,,1,9
2019-05-06 00:48,CAN,5418,737-800,23,4,26,4,4,30,,,,,3,7
2019-05-06 00:48,MIG,1798,737-800,17,6,29,6,6,25,,,,,12,8
2019-05-06 00:48,HHA,7618,737-800,22,3,26,4,4,26,,,,,4,4
2019-05-06 00:43,TYN,5481,737-800,15,6,24,4,4,22,,,,,9,7
2019-05-06 00:43,TYN,5090,737-800,15,2,10,2,2,20,,,,,-5,5
2019-05-06 00:39,HGH,XIY,737-800,21,5,28,3,4,25,,,,,7,4
2019-05-06 00:39,URC,1727,737-800,12,5,24,5,5,19,,,,,12,7
2019-05-06 00:37,XIY,5625,737-800,19,4,22,3,3,24,,,,,3,5
2019-05-06 00:32,CGO,1587,737-800,17,2,22,3,3,22,,,,,5,5
2019-05-06 00:28,URC,5611,737-800,15,5,27,4,5,22,,,,,12,7
2019-05-06 00:27,HHA,5638,737-800,20,4,28,4,4,26,,,,,8,6
2019-05-06 00:26,PEK,1729,737-800,16,4,19,4,4,20,,,,,3,4
2019-05-06 00:23,CAN,1498,737-800,22,5,29,5,5,24,,,,,7,2
2019-05-06 00:21,URC,1996,737-800,14,4,22,5,5,24,,,,,8,10
2019-05-06 00:20,URC,5798,737-800,15,3,20,3,2,20,,,,,5,5
2019-05-06 00:09,XIY,6062,737-800,20,3,26,4,3,27,,,,,6,7
2019-05-06 00:07,SZX,1928,737-800,25,5,34,5,6,26,,,,,9,1
2019-05-06 00:07,FOC,1351,737-800,21,4,30,4,4,26,,,,,9,5
2019-05-06 00:05,KMG,6809,737-800,22,5,24,6,6,24,,,,,2,2
2019-05-06 00:04,SZX,1489,737-800,23,4,29,4,4,30,,,,,6,7
2019-05-06 00:02,XIY,5416,737-800,17,7,24,7,8,30,,,,,7,13
2019-05-05 23:59,PEK,5466,737-800,17,0,10,4,0,10,,,,,-7,-7
2019-05-05 23:59,DLC,7173,737-800,20,4,27,5,4,22,,,,,7,2
2019-05-05 23:54,MIG,5407,737-800,17,4,28,6,4,26,,,,,11,9
2019-05-05 23:52,HAK,5687,737-800,25,4,29,5,4,34,,,,,4,9
2019-05-05 23:50,SZX,5137,737-800,22,3,19,2,2,28,,,,,-3,6
2019-05-05 23:47,XIY,1131,737-800,17,5,28,4,4,27,,,,,11,10
2019-05-05 23:46,HHA,6066,737-800,25,4,23,5,4,24,,,,,-2,-1
2019-05-05 23:39,XIY,1733,737-800,18,3,19,3,3,20,,,,,1,2
2019-05-05 23:28,HAK,5709,737-800,29,9,37,8,7,34,,,,,8,5
2019-05-05 23:28,HAK,1787,737-800,29,1,34,6,5,36,,,,,5,7
2019-05-05 23:26,HAK,1375,737-800,28,8,36,4,4,34,,,,,8,6
2019-05-05 23:25,URC,1929,737-800,10,4,28,3,3,24,,,,,18,14
2019-05-05 23:19,HRB,7113,737-800,4,4,19,3,4,18,,,,,15,14
2019-05-05 23:19,HGH,5522,737-800,22,4,26,5,5,24,,,,,4,2
2019-05-05 23:19,SYX,206F,737-800,27,7,36,2,3,32,,,,,9,5
2019-05-05 23:09,HGH,1726,737-800,22,5,29,4,4,24,,,,,7,2
2019-05-05 23:00,HAK,1542,737-800,29,3,34,4,4,33,,,,,5,4
2019-05-05 22:56,DLC,1496,737-800,14,5,25,6,5,24,,,,,11,10
2019-05-05 22:54,URC,1325,737-800,16,4,26,4,4,20,,,,,10,4
2019-05-05 22:52,HRB,1433,737-800,13,2,22,2,3,18,,,,,9,5
2019-05-05 22:50,PEK,7378,737-800,18,4,20,4,4,22,,,,,2,4
2019-05-05 22:50,URC,205T,737-800,10,2,24,3,3,25,,,,,14,15
2019-05-05 22:43,HHA,5375,737-800,18,2,22,5,4,25,,,,,4,7
2019-05-05 22:38,HAK,5686,737-800,26,4,32,6,5,32,,,,,6,6
2019-05-05 22:34,HAK,5580,737-800,29,8,36,6,6,36,,,,,7,7
2019-05-05 22:34,PEK,1103,737-800,18,4,28,3,4,24,,,,,10,6
2019-05-05 22:28,CKG,5467,737-800,20,2,30,3,1,33,,1,,1,10,13
2019-05-05 22:28,HAK,5733,737-800,28,8,36,7,7,34,,,,,8,6
2019-05-05 22:19,HAK,5855,737-800,29,8,32,8,9,30,,,,,3,1
2019-05-05 22:16,TYN,5417,737-800,17,5,20,5,4,21,,,,,3,4
2019-05-05 22:14,SYX,7886,737-800,30,5,36,4,3,37,,,,,6,7
2019-05-05 22:08,XNN,1493,737-800,11,6,21,6,6,18,,,,,10,7
2019-05-05 22:08,XNN,6060,737-800,11,6,21,6,6,21,,,,,10,10
2019-05-05 22:04,HGH,1785,737-800,26,0,24,4,4,28,,,,,-2,2
2019-05-05 22:02,CAN,5579,737-800,22,6,32,7,6,30,,,,,10,8
2019-05-05 21:35,DLC,1102,737-800,15,4,24,4,4,22,,,,,9,7
2019-05-05 21:15,HAK,206H,737-800,29,3,35,3,3,33,,,,,6,4
2019-05-05 21:08,XMN,1492,737-800,24,3,31,3,3,30,,,,,7,6
2019-05-05 21:07,DLC,1491,737-800,15,5,25,3,2,22,,,,,10,7
2019-05-05 19:27,HRB,1559,737-800,15,4,18,5,4,19,,,,,3,4
2019-05-05 18:58,PEK,5479,737-800,25,4,24,6,6,26,,,,,-1,1
2019-05-05 18:53,HAK,5089,737-800,30,7,32,3,4,36,,,,,2,6
2019-05-05 17:33,KMG,5449,737-800,20,6,26,5,5,26,,,,,6,6
2019-05-05 17:12,XUZ,7167,737-800,26,5,27,5,4,25,,,,,1,-1
2019-05-05 16:27,SZX,7619,737-800,25,5,28,6,5,30,,,,,3,5
2019-05-05 16:26,SZX,7619,737-800,25,5,28,6,5,30,,,,,3,5
2019-05-05 13:39,CTU,7990,737-800,20,3,21,4,3,23,,,,,1,3
2019-05-05 11:39,PEK,5479,737-800,22,32,28,28,30,30,,,,,6,8
2019-05-05 09:51,XMN,1545,737-800,23,6,30,4,4,30,,,,,7,7
2019-05-05 09:50,XMN,5371,737-800,25,6,30,6,8,28,,,,,5,3
2019-05-05 09:50,XMN,1547,737-800,23,6,30,6,6,30,,,,,7,7
2019-05-05 09:05,XIY,5503,737-800,20,6,26,6,6,24,,,,,6,4
2019-05-05 07:16,PEK,1725,737-800,17,5,26,3,4,25,,,,,9,8
2019-05-05 07:07,ZGC,5153,737-800,15,4,22,4,4,18,,,,,7,3
2019-05-05 07:06,ZGC,1501,737-800,20,5,18,4,5,17,,,,,-2,-3
2019-05-05 07:05,ZGC,5462,737-800,12,2,20,4,4,20,,,,,8,8
2019-05-05 07:00,HRB,1433,737-800,12,7,20,4,5,20,,,,,8,8
2019-05-05 06:54,SZX,5135,737-800,21,4,28,4,4,26,,,,,7,5
2019-05-05 06:53,SZX,7616,737-800,21,4,27,4,4,26,,,,,6,5
2019-05-05 06:52,HRB,1433,737-800,5,2,24,2,2,18,,,,,19,13
2019-05-05 06:52,SZX,1488,737-800,20,4,28,4,4,26,,,,,8,6
2019-05-05 06:24,HGH,5522,737-800,21,4,26,6,5,22,,,,,5,1
2019-05-05 06:22,SYX,1498,737-800,29,6,36,6,6,35,,,,,7,6
2019-05-05 05:55,PEK,5429,737-800,20,4,24,3,2,32,,,,,4,12
2019-05-05 05:53,PEK,1346,737-800,20,4,24,3,2,32,,,,,4,12
2019-05-05 05:29,CAN,1797,737-800,19,3,24,3,3,25,,,,,5,6
2019-05-05 05:23,PEK,5538,737-800,20,3,27,3,3,25,,,,,7,5
2019-05-05 05:01,HAK,6060,737-800,26,6,32,4,5,30,,,,,6,4
2019-05-05 04:58,XIY,1163,737-800,20,2,28,2,2,28,,,,,8,8
2019-05-05 04:57,URC,5797,737-800,15,5,18,5,5,22,,,,,3,7
2019-05-05 04:39,CKG,6808,737-800,22,4,19,4,4,25,,,,,-3,3
2019-05-05 04:33,XIY,5625,737-800,21,6,25,4,4,25,,,,,4,4
2019-05-05 04:20,XIY,5116,737-800,23,4,24,4,5,24,,,,,1,1
2019-05-05 04:12,URC,6995,737-800,15,4,24,5,5,20,,,,,9,5
2019-05-05 04:08,HAK,1503,737-800,25,4,32,4,4,30,,,,,7,5
2019-05-05 04:07,KMG,7167,737-800,18,5,26,5,6,24,,,,,8,6
2019-05-05 04:06,KMG,7989,737-800,20,6,24,6,6,24,,,,,4,4
2019-05-05 04:03,SYX,1997,737-800,25,5,33,5,5,29,,,,,8,4
2019-05-05 03:58,URC,2159,737-800,13,4,16,2,2,18,,,,,3,5
2019-05-05 03:57,ÃàÑô,1798,737-800,20,6,29,7,6,24,,,,,9,4
2019-05-05 03:48,HAK,1502,737-800,25,4,31,4,4,30,,,,,6,5
2019-05-05 03:43,PEK,5138,737-800,21,4,24,4,2,30,,,,,3,9
2019-05-05 03:38,URC,1325,737-800,15,4,24,4,4,19,,,,,9,4
2019-05-05 03:26,FOC,1905,737-800,22,4,27,4,3,24,,,,,5,2
2019-05-05 03:23,SZX,5137,737-800,19,2,20,2,2,26,,,,,1,7
2019-05-05 03:23,KMG,7167,737-800,20,5,26,5,6,24,,,,,6,4
2019-05-05 03:22,CAN,1505,737-800,20,4,27,4,4,24,,,,,7,4
2019-05-05 03:21,URC,5637,737-800,15,4,20,4,4,22,,,,,5,7
2019-05-05 03:20,URC,205U,737-800,15,4,25,4,4,21,,,,,10,6
2019-05-05 03:19,CAN,206F,737-800,20,4,28,3,3,24,,,,,8,4
2019-05-05 03:16,XIY,1903,737-800,21,2,28,2,2,38,,,,,7,17
2019-05-05 03:12,XIY,5180,737-800,20,2,24,6,6,26,,,,,4,6
2019-05-05 03:11,SYX,5372,737-800,28,8,35,7,8,36,,,,,7,8
2019-05-05 03:06,HGH,5662,737-800,20,3,22,7,3,22,,,,,2,2
2019-05-05 03:06,HHA,7175,737-800,20,5,30,5,4,26,,,,,10,6
2019-05-05 03:05,XIY,1482,737-800,20,6,24,4,4,26,,,,,4,6
2019-05-05 03:04,PEK,5539,737-800,18,4,26,6,4,30,,,,,8,12
2019-05-05 03:02,HGH,5502,737-800,15,3,20,4,4,22,,,,,5,7
2019-05-05 03:02,URC,5620,737-800,13,2,25,3,4,20,,,,,12,7
2019-05-05 02:58,HHA,7618,737-800,25,4,26,2,2,24,,,,,1,-1
2019-05-05 02:57,KMG,7991,737-800,20,8,25,8,8,26,,,,,5,6
2019-05-05 02:56,PEK,5713,737-800,19,6,22,6,6,24,,,,,3,5
2019-05-05 02:56,XIY,1435,737-800,25,6,26,6,5,26,,,,,1,1
2019-05-05 02:55,URC,6268,737-800,13,4,28,6,8,30,,,,,15,17
2019-05-05 02:44,HAK,1735,737-800,25,5,32,4,4,26,,,,,7,1
2019-05-05 02:43,KMG,6809,737-800,20,5,25,6,6,24,,,,,5,4
2019-05-05 02:42,HAK,1347,737-800,26,4,34,8,6,32,,,,,8,6
2019-05-05 02:39,HAK,5338,737-800,24,3,29,5,4,32,,,,,5,8
2019-05-05 02:38,HHA,5735,737-800,21,4,30,4,5,20,,,,,9,-1
2019-05-05 02:34,CGO,1588,737-800,21,4,25,4,4,24,,,,,4,3
2019-05-05 02:28,HAK,1787,737-800,25,0,30,0,0,28,,,,,5,3
2019-05-05 02:27,HAK,7639,737-800,27,6,33,6,6,30,,,,,6,3
2019-05-05 02:27,KMG,7992,737-800,20,5,24,7,7,26,,,,,4,6
2019-05-05 02:24,XIY,1161,737-800,20,3,27,2,2,23,,,,,7,3
2019-05-05 02:24,FOC,7400,737-800,22,4,26,4,4,22,,,,,4,0
2019-05-05 02:24,FOC,5430,737-800,25,6,27,2,3,24,,,,,2,-1
2019-05-05 02:22,SHA,7398,737-800,19,5,28,4,4,24,,,,,9,5
2019-05-05 02:18,HAK,5709,737-800,28,6,34,8,6,32,,,,,6,4
2019-05-05 02:16,XIY,1141,737-800,20,4,26,6,5,26,,,,,6,6
2019-05-05 02:14,SYX,206G,737-800,29,4,36,4,4,35,,,,,7,6
2019-05-05 02:12,SYX,7399,737-800,29,4,34,4,3,36,,,,,5,7
2019-05-05 02:11,SZX,1549,737-800,20,5,28,4,4,30,,,,,8,10
2019-05-05 02:11,HAK,6066,737-800,25,3,34,3,2,31,,,,,9,6
2019-05-05 02:10,XIY,1737,737-800,20,4,26,4,4,22,,,,,6,2
2019-05-05 02:09,TYN,5520,737-800,20,5,30,7,5,26,,,,,10,6
2019-05-05 02:08,SYX,5623,737-800,27,6,36,6,6,32,,,,,9,5
2019-05-05 02:07,KMG,7988,737-800,20,4,24,6,4,25,,,,,4,5
2019-05-05 02:06,URC,1569,737-800,10,2,26,2,2,22,,,,,16,12
2019-05-05 02:05,CAN,5478,737-800,20,4,32,4,4,25,1,,,1,12,5
2019-05-05 02:04,HHA,1786,737-800,26,4,28,4,4,26,,,,,2,0
2019-05-05 02:03,HHA,1728,737-800,22,5,27,5,5,24,,,,,5,2
2019-05-05 02:02,FOC,1562,737-800,20,4,27,4,4,27,,,,,7,7
2019-05-05 02:02,XIY,5115,737-800,22,4,18,5,5,26,,,,,-4,4
2019-05-05 02:02,PEK,1346,737-800,20,6,25,6,6,24,,,,,5,4
2019-05-05 02:02,HHA ,5638,737-800,22,3,20,4,4,23,,,,,-2,1
2019-05-05 02:02,FOC,1348,737-800,20,3,27,3,3,25,,,,,7,5
2019-05-05 02:01,HGH,5408,737-800,20,4,26,5,5,22,,,,,6,2
2019-05-05 02:00,HGH,1101,737-800,20,2,24,2,2,22,,,,,4,2
2019-05-05 02:00,HAK,5346,737-800,26,5,34,5,5,31,,,,,8,5
2019-05-05 01:57,SHA,6103,737-800,19,6,24,5,5,25,,,,,5,6
2019-05-05 01:57,XIY,1490,737-800,20,4,26,4,4,25,,,,,6,5
2019-05-05 01:56,KMG,1586,737-800,22,4,26,4,4,26,,,,,4,4
2019-05-05 01:55,FOC,5182,737-800,23,2,25,3,2,24,,,,,2,1
2019-05-05 01:53,URC,1727,737-800,12,5,24,5,4,18,,,,,12,6
2019-05-05 01:50,FOC,1562,737-800,20,5,30,5,5,28,,,,,10,8
2019-05-05 01:47,YIH,7395,737-800,21,6,28,5,5,30,,,,,7,9
2019-05-05 01:45,SYX,7886,737-800,30,3,36,4,3,35,,,,,6,5
2019-05-05 01:43,XIY,1902,737-800,20,6,20,5,5,24,,,,,0,4
2019-05-05 01:42,PEK,5439,737-800,21,4,26,4,4,24,,,,,5,3
2019-05-05 01:40,CGO,1587,737-800,20,2,24,3,3,24,,,,,4,4
2019-05-05 01:35,SZX,1489,737-800,19,4,28,4,4,27,,,,,9,8
2019-05-05 01:32,HAK,5139,737-800,26,5,26,6,4,30,,,,,0,4
2019-05-05 01:30,HGH,1130,737-800,20,2,27,2,2,22,,,,,7,2
2019-05-05 01:25,CAN,1729,737-800,20,4,26,4,4,22,,,,,6,2
2019-05-05 01:25,KMG,1209,737-800,20,5,28,4,4,25,,,,,8,5
2019-05-05 01:24,URC,5687,737-800,10,4,20,4,4,20,,,,,10,10
2019-05-05 01:23,URC,1131,737-800,10,4,20,4,4,20,,,,,10,10
2019-05-05 01:20,Î÷°²,1481,737-800,21,6,18,5,5,24,,,,,-3,3
2019-05-05 01:19,PEK,5428,737-800,19,4,22,6,4,28,,,,,3,9
2019-05-05 01:17,SZX ,1497,737-800,20,3,28,4,4,30,,,,,8,10
2019-05-05 01:17,SYX,1997,737-800,25,4,35,6,6,32,,,,,10,7
2019-05-05 01:13,YIH,1350,737-800,21,4,28,5,5,28,,,,,7,7
2019-05-05 01:11,CGO,5449,737-800,23,5,26,5,5,26,,,,,3,3
2019-05-05 01:10,XIY,7619,737-800,10,2,28,4,2,30,,,,,18,20
2019-05-05 01:10,URC,1995,737-800,10,6,24,6,6,24,,,,,14,14
2019-05-05 01:06,HAK,5855,737-800,25,7,28,7,7,27,,,,,3,2
2019-05-05 00:56,URC,1996,737-800,10,5,20,5,5,24,,,,,10,14
2019-05-05 00:53,DLC,1541,737-800,18,6,24,5,6,23,,,,,6,5
2019-05-05 00:53,URC,5636,737-800,11,5,22,6,6,26,,,,,11,15
2019-05-05 00:51,DLC,1102,737-800,24,4,24,4,4,24,,,,,0,0
2019-05-05 00:50,HGH,1785,737-800,20,1,26,7,8,26,,,,,6,6
2019-05-05 00:50,URC,5798,737-800,10,2,20,2,2,18,,,,,10,8
2019-05-05 00:43,XIY,1491,737-800,21,5,30,5,5,30,,,,,9,9
2019-05-05 00:43,MIG,5409,737-800,20,4,25,4,4,27,,,,,5,7
2019-05-05 00:42,HAK,7377,737-800,25,5,32,5,4,32,,,,,7,7
2019-05-05 00:42,HHA,5375,737-800,25,2,20,2,2,18,,,,,-5,-7
2019-05-05 00:41,KHG,206P,737-800,19,4,22,4,4,20,,,,,3,1
2019-05-05 00:40,XIY,1162,737-800,22,3,30,3,3,26,,,,,8,4
2019-05-05 00:39,XIY,7171,737-800,22,4,26,5,4,27,,,,,4,5
2019-05-05 00:37,CKG,7379,737-800,22,4,30,4,4,30,,,,,8,8
2019-05-05 00:35,HAK,5417,737-800,25,4,31,4,4,31,,,,,6,6
2019-05-05 00:34,HGH,5337,737-800,21,4,23,5,6,24,,,,,2,3
2019-05-05 00:32,DLC,1487,737-800,23,2,22,2,2,20,,,,,-1,-3
2019-05-05 00:31,SZX,5141,737-800,20,6,23,5,5,26,,,,,3,6
2019-05-05 00:30,URC,1322,737-800,10,4,22,4,4,22,,,,,12,12
2019-05-05 00:28,PEK,5686,737-800,19,4,26,4,6,24,,,,,7,5
2019-05-05 00:27,TYN,5090,737-800,20,2,26,2,3,22,,,,,6,2
2019-05-05 00:20,HRB,1433,737-800,12,10,20,16,16,10,,,,,8,-2
2019-05-05 00:18,MIG,5407,737-800,15,5,26,5,4,27,,,,,11,12
2019-05-05 00:17,HAK,1542,737-800,26,4,33,6,5,30,,,,,7,4
2019-05-05 00:15,XIY,6062,737-800,20,5,21,5,4,20,,,,,1,0
2019-05-05 00:13,HHA,5373,737-800,22,6,26,6,6,26,,,,,4,4
2019-05-05 00:12,CGO,1726,737-800,21,6,28,6,6,24,,,,,7,3
2019-05-05 00:12,HAK,1208,737-800,25,4,30,2,2,28,,,,,5,3
2019-05-05 00:12,FOC,1906,737-800,21,8,29,7,8,26,,,,,8,5
2019-05-05 00:10,CGO,6016,737-800,26,4,28,4,4,26,,,,,2,0
2019-05-05 00:10,CGO,5483,737-800,24,4,28,6,4,24,,,,,4,0
2019-05-05 00:06,KMG,6800,737-800,22,4,26,5,5,23,,,,,4,1
2019-05-05 00:05,ÃàÑô,5732,737-800,18,3,27,3,3,26,,,,,9,8
2019-05-04 23:52,YIH,1480,737-800,26,4,26,5,4,26,,,,,0,0
2019-05-04 23:47,URC,5466,737-800,15,3,19,9,3,17,,,,,4,2
2019-05-04 23:46,XIY,6061,737-800,10,4,30,2,4,28,,,,,20,18
2019-05-04 23:40,TYN,1372,737-800,20,2,24,2,2,20,,,,,4,0
2019-05-04 23:35,CGO,205V,737-800,20,1,30,1,1,26,,,,,10,6
2019-05-04 23:31,PEK,6063,737-800,21,6,28,6,5,21,,,,,7,0
2019-05-04 23:26,HAK,1213,737-800,25,6,36,6,6,35,,,,,11,10
2019-05-04 23:25,HRB,7105,737-800,13,4,24,5,4,22,,,,,11,9
2019-05-04 23:25,SZX,7172,737-800,23,4,30,4,5,30,,,,,7,7
2019-05-04 23:24,XIY,7378,737-800,16,6,24,4,6,26,,,,,8,10
2019-05-04 23:23,URC,205T,737-800,10,2,22,5,6,24,,,,,12,14
2019-05-04 23:21,HAK,5463,737-800,26,5,31,5,5,26,,,,,5,0
2019-05-04 23:21,URC,1131,737-800,10,4,26,4,4,24,,,,,16,14
2019-05-04 23:20,DLC,1496,737-800,20,6,26,6,5,24,,,,,6,4
2019-05-04 23:19,CKG,5467,737-800,25,2,31,3,5,26,,,,,6,1
2019-05-04 23:14,PEK,5579,737-800,21,6,30,6,5,28,,,,,9,7
2019-05-04 23:14,SYX,5358,737-800,29,9,37,9,8,37,1,1,,11,8,8
2019-05-04 23:06,XIY,1373,737-800,20,4,26,4,4,22,,,,,6,2
2019-05-04 22:58,HAK,5405,737-800,25,5,36,5,4,34,1,,,1,11,9
2019-05-04 22:55,HAK,1928,737-800,25,5,25,7,6,28,,,,,0,3
2019-05-04 22:53,PEK,1215,737-800,17,2,28,3,4,30,,,,,11,13
2019-05-04 22:50,CAN,5661,737-800,19,3,28,3,3,28,,,,,9,9
2019-05-04 22:48,HAK,6060,737-800,25,6,35,6,5,30,,,,,10,5
2019-05-04 22:47,URC,7198,737-800,10,4,21,5,3,22,,,,,11,12
2019-05-04 22:46,URC,1323,737-800,10,4,24,4,4,24,,,,,14,14
2019-05-04 22:44,¹þ¶û±õ,1559,737-800,13,6,26,3,2,23,,,,,13,10
2019-05-04 22:44,DLC,1733,737-800,22,3,20,3,3,20,,,,,-2,-2
2019-05-04 22:37,DLC,1386,737-800,21,2,24,2,3,22,,,,,3,1
2019-05-04 22:34,HAK,5480,737-800,26,4,30,6,5,34,,,,,4,8
2019-05-04 22:25,HAK,5611,737-800,25,6,34,6,5,29,,,,,9,4
2019-05-04 22:21,XNN,1493,737-800,15,6,21,6,6,20,,,,,6,5
2019-05-04 22:12,HAK,206H,737-800,25,3,32,3,3,32,,,,,7,7
2019-05-04 22:01,SYX,1495,737-800,25,4,36,3,4,33,1,,,1,11,8
2019-05-04 21:52,XIY,5853,737-800,22,6,29,6,6,26,,,,,7,4
2019-05-04 21:42,HAK,5089,737-800,27,2,30,2,2,34,,,,,3,7
2019-05-04 21:33,´óÁ¬,5712,737-800,18,2,20,2,2,20,,,,,2,2
2019-05-04 21:31,XNN,1103,737-800,15,4,26,4,4,21,,,,,11,6
2019-05-04 20:51,HGH,1375,737-800,22,4,26,4,6,26,,,,,4,4
2019-05-04 20:50,HAK,1795,737-800,26,4,31,5,4,31,,,,,5,5
2019-05-04 20:23,DLC,7173,737-800,22,4,26,6,4,24,,,,,4,2
2019-05-04 19:59,HAK,5359,737-800,26,6,31,6,4,32,,,,,5,6
2019-05-04 19:57,URC,1568,737-800,7,6,25,6,6,26,,,,,18,19
2019-05-04 19:39,FOC,1348,737-800,20,4,30,4,4,26,,,,,10,6
2019-05-04 19:32,HAK,5733,737-800,25,6,34,6,6,34,,,,,9,9
2019-05-04 17:38,FOC,1351,737-800,23,4,28,4,4,22,,,,,5,-1
2019-05-04 16:03,HHA,5136,737-800,25,4,26,4,4,26,,,,,1,1
2019-05-04 15:19,TYN,5481,737-800,31,6,25,6,6,24,,,,,-6,-7
2019-05-04 13:21,ÐìÖÝ,7993,737-800,15,5,28,6,7,26,,,,,13,11
2019-05-04 12:21,HRB,7113,737-800,29,5,26,6,5,24,,,,,-3,-5
2019-05-04 10:53,CTU,7990,737-800,25,2,30,2,2,28,,,,,5,3
2019-05-04 08:44,ZGC,1498,737-800,10,6,12,6,6,18,,,,,2,8
2019-05-04 08:43,ZGC,6060,737-800,15,4,18,4,5,22,,,,,3,7
2019-05-04 08:41,ZGC,1501,737-800,10,4,25,4,4,20,,,,,15,10
2019-05-04 08:25,PEK,6103,737-800,22,6,26,6,6,25,,,,,4,3
2019-05-04 08:19,KMG,1587,737-800,20,2,24,4,3,22,,,,,4,2
2019-05-04 05:56,PEK,7400,737-800,15,6,26,4,4,24,,,,,11,9
2019-05-04 05:42,XIY,1795,737-800,18,7,26,4,4,25,,,,,8,7
2019-05-04 05:40,XIY,7172,737-800,19,4,27,5,4,26,,,,,8,7
2019-05-04 05:22,PEK,5538,737-800,25,5,28,4,4,28,,,,,3,3
2019-05-04 05:04,XIY,7619,737-800,18,4,25,4,4,25,,,,,7,7
2019-05-04 04:48,KMG,1209,737-800,20,4,24,4,4,24,,,,,4,4
2019-05-04 04:37,XIY,1141,737-800,18,6,28,6,6,26,,,,,10,8
2019-05-04 04:35,XIY,5429,737-800,18,4,22,4,4,24,,,,,4,6
2019-05-04 04:21,SYX,1796,737-800,28,6,34,5,5,30,,,,,6,2
2019-05-04 04:14,KMG,1586,737-800,19,4,24,5,4,26,,,,,5,7
2019-05-04 04:08,HAK,1213,737-800,26,6,35,6,6,34,,,,,9,8
2019-05-04 04:05,URC,5798,737-800,13,3,20,3,4,20,,,,,7,7
2019-05-04 04:04,206,5709,737-800,20,5,27,8,6,28,,,,,7,8
2019-05-04 03:53,XIY,5116,737-800,25,4,22,4,4,22,,,,,-3,-3
2019-05-04 03:48,KMG,7993,737-800,19,3,21,5,6,23,,,,,2,4
2019-05-04 03:45,URC,1727,737-800,16,4,24,2,3,22,,,,,8,6
2019-05-04 03:44,FOC,1562,737-800,19,5,22,5,5,28,,,,,3,9
2019-05-04 03:44,URC,1725,737-800,16,4,26,4,4,26,,,,,10,10
2019-05-04 03:43,URC,205U,737-800,15,4,24,4,4,24,,,,,9,9
2019-05-04 03:42,HAK,5428,737-800,28,4,28,6,4,31,,,,,0,3
2019-05-04 03:42,URC,1995,737-800,16,4,25,6,6,25,,,,,9,9
2019-05-04 03:41,FOC,1480,737-800,18,5,21,5,5,20,,,,,3,2
2019-05-04 03:41,URC,5797,737-800,13,6,24,6,6,26,,,,,11,13
2019-05-04 03:40,URC,206P,737-800,14,4,22,4,4,22,,,,,8,8
2019-05-04 03:39,URC,5637,737-800,15,2,23,2,3,22,,,,,8,7
2019-05-04 03:38,URC,205V,737-800,14,4,26,4,4,22,,,,,12,8
2019-05-04 03:37,URC,6268,737-800,11,4,26,4,4,22,,,,,15,11
2019-05-04 03:35,HHA,1215,737-800,24,4,29,4,4,29,,,,,5,5
2019-05-04 03:35,FOC,5465,737-800,19,4,29,3,4,29,,,,,10,10
2019-05-04 03:31,XIY,1482,737-800,18,6,30,6,6,24,,,,,12,6
2019-05-04 03:29,HAK,5687,737-800,25,4,30,5,5,32,,,,,5,7
2019-05-04 03:25,URC,1322,737-800,15,4,24,5,4,22,,,,,9,7
2019-05-04 03:24,URC,2159,737-800,15,6,16,4,5,22,,,,,1,7
2019-05-04 03:22,KMG,7991,737-800,20,6,26,6,6,24,,,,,6,4
2019-05-04 03:09,HAK,5522,737-800,25,3,32,4,4,32,,,,,7,7
2019-05-04 03:07,HHA,1547,737-800,24,5,20,6,6,28,,,,,-4,4
2019-05-04 03:04,XIY,1435,737-800,18,6,24,6,6,24,,,,,6,6
2019-05-04 03:04,KMG,1798,737-800,21,7,28,9,7,18,,,,,7,-3
2019-05-04 03:01,URC,7198,737-800,13,4,23,4,3,22,,,,,10,9
2019-05-04 03:01,HAK,5337,737-800,25,6,31,6,5,30,,,,,6,5
2019-05-04 02:59,URC,1325,737-800,15,8,29,7,8,25,,,,,14,10
2019-05-04 02:56,SYX,7886,737-800,30,4,35,4,3,34,,,,,5,4
2019-05-04 02:54,XIY,5503,737-800,18,4,25,4,4,26,,,,,7,8
2019-05-04 02:52,PEK,5466,737-800,23,5,22,7,7,21,,,,,-1,-2
2019-05-04 02:51,URC,1131,737-800,20,4,26,4,4,24,,,,,6,4
2019-05-04 02:47,PEK,BX5479,737-800,21,5,24,6,6,27,,,,,3,6
2019-05-04 02:45,KMG,7988,737-800,18,5,26,5,4,26,,,,,8,8
2019-05-04 02:43,HHA,7175,737-800,24,5,30,5,5,25,,,,,6,1
2019-05-04 02:38,URC,1929,737-800,12,3,25,3,3,25,,,,,13,13
2019-05-04 02:37,XIY,1163,737-800,18,2,28,2,2,22,,,,,10,4
2019-05-04 02:34,SZX,5141,737-800,27,6,27,5,5,32,,,,,0,5
2019-05-04 02:32,HGH,5375,737-800,20,3,20,5,6,22,,,,,0,2
2019-05-04 02:31,XMN,5153,737-800,22,3,27,5,6,29,,,,,5,7
2019-05-04 02:29,HGH,1733,737-800,19,3,22,3,4,21,,,,,3,2
2019-05-04 02:29,XIY,1483,737-800,18,5,24,6,6,24,,,,,6,6
2019-05-04 02:28,XIY,1902,737-800,16,4,22,4,4,22,,,,,6,6
2019-05-04 02:25,XIY,1481,737-800,17,6,25,6,6,26,,,,,8,9
2019-05-04 02:24,YIH,7395,737-800,22,6,28,5,4,24,,,,,6,2
2019-05-04 02:23,YIH,7113,737-800,22,4,26,4,4,28,,,,,4,6
2019-05-04 02:22,SYX,5090,737-800,28,6,34,4,4,32,,,,,6,4
2019-05-04 02:22,YIH,1348,737-800,22,4,26,4,4,26,,,,,4,4
2019-05-04 02:21,XIY,1903,737-800,17,2,26,2,2,26,,,,,9,9
2019-05-04 02:20,SYX,1130,737-800,29,3,35,3,3,33,,,,,6,4
2019-05-04 02:20,SYX,5439,737-800,28,5,32,4,4,30,,,,,4,2
2019-05-04 02:18,KMG,1208,737-800,20,3,24,3,3,22,,,,,4,2
2019-05-04 02:16,XIY,7171,737-800,20,4,22,5,5,26,,,,,2,6
2019-05-04 02:14,HAK,5406,737-800,25,3,32,6,4,30,,,,,7,5
2019-05-04 02:13,SYX,206G,737-800,28,5,35,5,6,32,,,,,7,4
2019-05-04 02:12,SZX,5338,737-800,25,4,26,4,4,27,,,,,1,2
2019-05-04 02:11,XMN,7398,737-800,22,5,27,6,6,28,,,,,5,6
2019-05-04 02:11,HHA,1786,737-800,25,4,26,4,4,24,,,,,1,-1
2019-05-04 02:10,XMN,5373,737-800,22,7,32,8,8,33,1,1,,11,10,11
2019-05-04 02:10,PEK,5539,737-800,25,5,26,6,6,28,,,,,1,3
2019-05-04 02:10,XMN,5138,737-800,22,6,24,4,4,28,,,,,2,6
2019-05-04 02:09,SZX,1492,737-800,24,4,29,3,3,27,,,,,5,3
2019-05-04 02:04,CAN,5478,737-800,24,4,28,4,4,27,,,,,4,3
2019-05-04 01:59,HHA,5638,737-800,30,4,28,3,3,28,,,,,-2,-2
2019-05-04 01:58,URC,6995,737-800,15,6,22,6,6,22,,,,,7,7
2019-05-04 01:58,HHA,5638,737-800,30,4,28,3,3,28,,,,,-2,-2
2019-05-04 01:57,CAN,7377,737-800,25,6,30,7,6,30,,,,,5,5
2019-05-04 01:57,HAK,5713,737-800,25,6,26,6,6,30,,,,,1,5
2019-05-04 01:52,HAK,5481,737-800,27,4,30,4,4,30,,,,,3,3
2019-05-04 01:50,CAN,1505,737-800,23,4,31,4,4,27,,,,,8,4
2019-05-04 01:49,HAK,5686,737-800,26,4,31,8,7,23,,,,,5,-3
2019-05-04 01:46,CGO,7989,737-800,22,4,26,4,4,25,,,,,4,3
2019-05-04 01:44,XIY,5429,737-800,19,3,21,4,4,24,,,,,2,5
2019-05-04 01:40,FOC,5430,737-800,20,6,28,6,6,29,,,,,8,9
2019-05-04 01:39,XIY,1162,737-800,18,3,27,1,1,23,,,,,9,5
2019-05-04 01:38,SYX,5483,737-800,29,5,36,7,4,35,,,,,7,6
2019-05-04 01:35,SZX,1488,737-800,24,5,30,6,5,28,,,,,6,4
2019-05-04 01:31,URC,1569,737-800,19,3,26,4,3,24,,,,,7,5
2019-05-04 01:30,CAN,6065,737-800,27,5,31,5,5,29,,,,,4,2
2019-05-04 01:29,URC,5636,737-800,14,4,26,4,4,25,,,,,12,11
2019-05-04 01:28,TYN,5520,737-800,17,5,28,5,5,26,,,,,11,9
2019-05-04 01:28,SYX,1495,737-800,30,4,32,2,4,32,,,,,2,2
2019-05-04 01:26,CGO,5467,737-800,24,2,26,4,2,24,,,,,2,0
2019-05-04 01:24,ÃàÑô,6809,737-800,19,5,24,5,5,25,,,,,5,6
2019-05-04 01:24,CAN,1542,737-800,25,4,30,4,4,26,,,,,5,1
2019-05-04 01:20,HGH,5502,737-800,20,4,24,6,5,24,,,,,4,4
2019-05-04 01:17,CAN,5661,737-800,25,4,25,4,4,30,,,,,0,5
2019-05-04 01:14,HAK,5346,737-800,25,5,31,6,6,31,,,,,6,6
2019-05-04 01:13,HGH,5462,737-800,20,5,26,3,3,27,,,,,6,7
2019-05-04 01:13,PEK,5482,737-800,24,0,28,5,4,28,,,,,4,4
2019-05-04 01:09,HGH,5620,737-800,20,4,26,2,2,24,,,,,6,4
2019-05-04 01:08,KHG,1323,737-800,19,2,21,2,2,22,,,,,2,3
2019-05-04 01:06,DLC,5712,737-800,21,1,22,1,2,21,,,,,1,0
2019-05-04 01:04,URC,1726,737-800,15,2,26,5,6,22,,,,,11,7
2019-05-04 01:03,DLC,1487,737-800,22,3,24,2,2,22,,,,,2,0
2019-05-04 01:01,URC,7198,737-800,15,6,22,6,6,22,,,,,7,7
2019-05-04 00:59,MIG,5732,737-800,20,2,26,3,3,25,,,,,6,5
2019-05-04 00:58,DLC,5662,737-800,25,3,22,3,5,24,,,,,-3,-1
2019-05-04 00:57,DLC,5662,737-800,25,3,22,3,5,24,,,,,-3,-1
2019-05-04 00:53,XIY,5115,737-800,18,3,16,4,4,16,,,,,-2,-2
2019-05-04 00:52,DLC,1491,737-800,20,4,26,4,5,25,,,,,6,5
2019-05-04 00:49,CAN,1548,737-800,24,4,30,4,4,26,,,,,6,2
2019-05-04 00:49,CAN,1538,737-800,24,3,28,4,2,27,,,,,4,3
2019-05-04 00:49,HAK,5463,737-800,26,5,32,4,5,30,,,,,6,4
2019-05-04 00:48,DLC,1386,737-800,20,4,26,4,3,20,,,,,6,0
2019-05-04 00:47,CAN,1373,737-800,27,4,21,4,3,23,,,,,-6,-4
2019-05-04 00:46,HAK,6066,737-800,26,3,32,3,2,31,,,,,6,5
2019-05-04 00:44,HAK,5139,737-800,27,7,33,8,4,30,,,,,6,3
2019-05-04 00:43,DLC,7173,737-800,20,3,23,4,4,22,,,,,3,2
2019-05-04 00:40,URC,1996,737-800,15,4,20,5,4,23,,,,,5,8
2019-05-04 00:39,HHA,5733,737-800,25,6,27,6,6,27,,,,,2,2
2019-05-04 00:38,FOC,1351,737-800,19,4,28,4,4,22,,,,,9,3
2019-05-04 00:37,FOC,1906,737-800,20,6,29,7,7,25,,,,,9,5
2019-05-04 00:35,TYN,5416,737-800,15,6,24,6,6,22,,,,,9,7
2019-05-04 00:34,TYN,1372,737-800,15,4,24,4,4,24,,,,,9,9
2019-05-04 00:31,TYN,7639,737-800,20,6,28,6,6,25,,,,,8,5
2019-05-04 00:30,HAK,1490,737-800,26,5,33,3,4,29,,,,,7,3
2019-05-04 00:28,DLC,1346,737-800,20,6,26,5,5,23,,,,,6,3
2019-05-04 00:25,HRB,1350,737-800,15,4,24,4,5,22,,,,,9,7
2019-05-04 00:24,ÃàÑô,5407,737-800,20,4,28,6,4,25,,,,,8,5
2019-05-04 00:24,CGO,5449,737-800,20,4,24,5,4,26,,,,,4,6
2019-05-04 00:24,CGO,5359,737-800,20,4,22,5,5,25,,,,,2,5
2019-05-04 00:23,CAN,1928,737-800,25,5,25,6,6,26,,,,,0,1
2019-05-04 00:23,CGO,1568,737-800,25,6,27,6,6,24,,,,,2,-1
2019-05-04 00:23,SZX,5855,737-800,25,6,30,5,5,30,,,,,5,5
2019-05-04 00:22,HGH,1375,737-800,20,4,24,4,5,24,,,,,4,4
2019-05-04 00:17,CKG,7616,737-800,19,5,26,4,4,26,,,,,7,7
2019-05-04 00:15,TYN,5372,737-800,20,8,26,8,8,24,,,,,6,4
2019-05-04 00:13,CKG,6808,737-800,24,4,30,4,4,28,,,,,6,4
2019-05-04 00:13,XIY,5180,737-800,19,1,23,5,4,25,,,,,4,6
2019-05-04 00:09,FOC,1905,737-800,21,4,27,4,4,22,,,,,6,1
2019-05-04 00:06,PEK,5417,737-800,24,4,22,5,4,24,,,,,-2,0
2019-05-04 00:06,SZX,5137,737-800,25,3,18,2,2,26,,,,,-7,1
2019-05-04 00:05,XIY,6061,737-800,20,4,26,5,4,24,,,,,6,4
2019-05-04 00:03,HAK,206F,737-800,25,3,34,3,3,30,,,,,9,5
2019-05-03 23:59,CGO,6016,737-800,22,4,28,4,4,26,,,,,6,4
2019-05-03 23:57,XIY,1496,737-800,18,6,30,6,6,30,,,,,12,12
2019-05-03 23:51,HAK,1489,737-800,25,4,32,4,5,30,,,,,7,5
2019-05-03 23:48,SZX,1549,737-800,25,4,30,6,6,30,,,,,5,5
2019-05-03 23:46,PEK,5371,737-800,24,9,22,8,6,25,,,,,-2,1
2019-05-03 23:46,PEK,1541,737-800,25,4,28,4,4,26,,,,,3,1
2019-05-03 23:45,KMG,6015,737-800,19,2,27,4,4,24,,,,,8,5
2019-05-03 23:39,HAK,5089,737-800,27,4,30,8,7,31,,,,,3,4
2019-05-03 23:38,HRB,1433,737-800,20,2,24,2,2,20,,,,,4,0
2019-05-03 23:36,CGO,7992,737-800,22,6,26,6,6,24,,,,,4,2
2019-05-03 23:33,À¥Ã÷,6800,737-800,22,4,23,4,3,22,,,,,1,0
2019-05-03 23:30,HAK,1502,737-800,26,4,33,4,4,33,,,,,7,7
2019-05-03 23:28,HRB,7105,737-800,11,4,17,3,4,18,,,,,6,7
2019-05-03 23:20,CKG,7399,737-800,21,4,22,2,4,23,,,,,1,2
2019-05-03 23:19,MIG,5409,737-800,20,5,25,5,4,26,,,,,5,6
2019-05-03 23:17,CGO,6016,737-800,20,4,28,4,4,26,,,,,8,6
2019-05-03 23:09,SYX,1729,737-800,30,5,28,5,5,30,,,,,-2,0
2019-05-03 23:04,HHA,1728,737-800,21,5,25,5,5,24,,,,,4,3
2019-05-03 23:03,XIY,7378,737-800,20,6,24,6,4,26,,,,,4,6
2019-05-03 23:02,SZX,1497,737-800,26,4,30,3,2,30,,,,,4,4
2019-05-03 23:00,XIY,5853,737-800,20,5,26,6,6,24,,,,,6,4
2019-05-03 23:00,HAK,7167,737-800,25,6,32,5,5,32,,,,,7,7
2019-05-03 22:55,HGH,5408,737-800,20,3,26,4,4,22,,,,,6,2
2019-05-03 22:53,HHA,5735,737-800,26,2,26,3,3,20,,,,,0,-6
2019-05-03 22:53,HGH,1785,737-800,20,1,27,4,4,27,,,,,7,7
2019-05-03 22:52,SZX,5135,737-800,25,4,28,4,4,30,,,,,3,5
2019-05-03 22:50,HAK,206H,737-800,26,3,32,2,2,31,,,,,6,5
2019-05-03 22:45,URC,205T ,737-800,18,3,26,3,3,26,,,,,8,8
2019-05-03 22:34,HAK,6066,737-800,26,32,3,2,3,31,,,,,-23,5
2019-05-03 22:33,URC,1545,737-800,18,2,22,4,4,22,,,,,4,4
2019-05-03 22:27,URC,5289,737-800,16,6,0,7,0,0,,,,,-16,-16
2019-05-03 22:12,HAK,5581,737-800,26,6,28,6,5,31,,,,,2,5
2019-05-03 22:09,CAN,1797,737-800,25,4,26,4,4,25,,,,,1,0
2019-05-03 22:07,XNN,1493,737-800,15,6,21,6,6,20,,,,,6,5
2019-05-03 21:51,HAK,1503,737-800,26,3,33,4,3,31,,,,,7,5
2019-05-03 21:41,DLC,1102,737-800,22,3,24,3,3,24,,,,,2,2
2019-05-03 21:39,XNN,1103,737-800,15,4,26,4,4,21,,,,,11,6
2019-05-03 20:59,PEK,5579,737-800,26,6,30,6,7,28,,,,,4,2
2019-05-03 19:54,FOC,1906,737-800,23,6,30,8,7,26,,,,,7,3
2019-05-03 19:47,FOC,5182,737-800,24,4,28,4,4,26,,,,,4,2
2019-05-03 19:39,HGH,5580,737-800,22,6,24,6,6,28,,,,,2,6
2019-05-03 19:02,HRB,1559,737-800,10,3,17,3,3,17,,,,,7,7
2019-05-03 19:00,HRB,1559,737-800,10,4,17,3,4,17,,,,,7,7
2019-05-03 18:54,HAK,1793,737-800,27,5,33,5,4,30,,,,,6,3
2019-05-03 18:42,PEK,6063,737-800,19,5,27,6,5,26,,,,,8,7
2019-05-03 16:56,XUZ,1588,737-800,28,2,25,4,4,24,,,,,-3,-4
2019-05-03 16:37,Î÷°²,5358,737-800,20,4,20,4,4,20,,,,,0,0
2019-05-03 09:51,HAK,1489,737-800,26,4,30,4,4,30,,,,,4,4
2019-05-03 09:24,PEK,6103,737-800,20,5,24,6,6,24,,,,,4,4
2019-05-03 09:05,KMG,1208,737-800,21,3,24,3,4,23,,,,,3,2
2019-05-03 08:38,HAK,6808,737-800,25,5,32,7,7,22,,,,,7,-3
2019-05-03 07:00,XMN,1997,737-800,20,4,20,6,8,22,,,,,0,2
2019-05-03 06:41,XIY,1482,737-800,20,3,27,3,4,28,,,,,7,8
2019-05-03 06:40,XIY,1163,737-800,20,2,26,2,2,27,,,,,6,7
2019-05-03 06:01,FOC,1435,737-800,20,5,27,5,5,24,,,,,7,4
2019-05-03 05:38,HGH,5580,737-800,18,4,24,4,4,26,,,,,6,8
2019-05-03 05:28,KMG,7991,737-800,20,6,24,6,7,22,,,,,4,2
2019-05-03 05:08,CAN,5090,737-800,21,2,28,2,4,28,,,,,7,7
2019-05-03 05:07,SZX,1492,737-800,23,8,26,8,7,26,,,,,3,3
2019-05-03 05:03,CGO,6016,737-800,20,4,22,4,4,26,,,,,2,6
2019-05-03 04:45,HAK,1927,737-800,24,4,19,8,4,19,,,,,-5,-5
2019-05-03 04:44,HHA,1786,737-800,20,4,22,2,3,22,,,,,2,2
2019-05-03 04:22,KMG,1798,737-800,15,3,22,4,3,23,,,,,7,8
2019-05-03 04:21,URC,5798,737-800,17,5,20,5,5,23,,,,,3,6
2019-05-03 04:20,HAK,5579,737-800,25,6,34,5,6,32,,,,,9,7
2019-05-03 04:16,PEK,5465,737-800,16,3,26,2,2,24,,,,,10,8
2019-05-03 04:12,SYX,1495,737-800,27,5,24,3,4,22,,,,,-3,-5
2019-05-03 04:07,HGH,1728,737-800,17,4,24,4,4,22,,,,,7,5
2019-05-03 03:57,HHA,1215,737-800,21,4,28,4,4,28,,,,,7,7
2019-05-03 03:48,CAN,1542,737-800,22,4,27,4,3,26,,,,,5,4
2019-05-03 03:41,HHA,5735,737-800,20,5,23,5,4,23,,,,,3,3
2019-05-03 03:40,ZGC,5439,737-800,15,3,21,4,4,22,,,,,6,7
2019-05-03 03:40,CGO,5449,737-800,21,5,24,4,4,25,,,,,3,4
2019-05-03 03:39,FOC,1906,737-800,18,5,27,4,4,26,,,,,9,8
2019-05-03 03:37,URC,2159,737-800,18,8,20,6,5,24,,,,,2,6
2019-05-03 03:37,FOC,1562,737-800,18,4,27,4,4,27,,,,,9,9
2019-05-03 03:31,XIY,1161,737-800,20,4,20,4,4,18,,,,,0,-2
2019-05-03 03:30,HGH,1541,737-800,18,4,26,5,4,25,,,,,8,7
2019-05-03 03:27,SYX,7886,737-800,28,2,32,2,2,32,,,,,4,4
2019-05-03 03:16,MIG,5409,737-800,21,4,24,4,5,28,,,,,3,7
2019-05-03 03:14,XIY,5503,737-800,18,2,22,3,3,23,,,,,4,5
2019-05-03 02:58,HHA,5346,737-800,20,6,24,5,5,24,,,,,4,4
2019-05-03 02:52,URC,5798,737-800,10,2,20,2,2,20,,,,,10,10
2019-05-03 02:47,TYN,5712,737-800,10,2,19,3,2,16,,,,,9,6
2019-05-03 02:42,º£¿Ú,1497,737-800,26,2,30,8,8,28,,,,,4,2
2019-05-03 02:39,URC,1131,737-800,16,4,19,2,2,17,,,,,3,1
2019-05-03 02:35,XIY,1902,737-800,30,4,24,5,5,26,,,,,-6,-4
2019-05-03 02:34,CTU,7990,737-800,20,4,28,4,4,28,,,,,8,8
2019-05-03 02:32,SYX,1729,737-800,27,4,26,4,4,29,,,,,-1,2
2019-05-03 02:29,CAN,5463,737-800,21,5,23,5,5,22,,,,,2,1
2019-05-03 02:28,SZX,1488,737-800,21,6,30,5,5,26,,,,,9,5
2019-05-03 02:21,KMG,1587,737-800,20,3,23,6,3,23,,,,,3,3
2019-05-03 02:21,URC,1570,737-800,18,4,24,4,5,25,,,,,6,7
2019-05-03 02:18,KMG,7167,737-800,20,6,26,6,6,25,,,,,6,5
2019-05-03 02:16,URC,1727,737-800,15,4,21,4,5,22,,,,,6,7
2019-05-03 02:13,º£¿Ú,1503,737-800,26,2,26,4,4,30,,,,,0,4
2019-05-03 02:13,CAN,1797,737-800,23,3,22,4,4,24,,,,,-1,1
2019-05-03 02:12,PEK,6063,737-800,23,7,26,4,6,25,,,,,3,2
2019-05-03 02:11,HGH,6065,737-800,21,5,26,5,5,27,,,,,5,6
2019-05-03 02:11,CAN,5337,737-800,22,3,28,4,4,28,,,,,6,6
2019-05-03 02:08,HAK,7379,737-800,25,4,33,4,3,35,,,,,8,10
2019-05-03 02:04,URC,1755,737-800,16,4,24,4,4,22,,,,,8,6
2019-05-03 02:03,SYX,206G,737-800,27,4,34,4,4,32,,,,,7,5
2019-05-03 02:00,XIY,1162,737-800,20,4,28,2,2,22,,,,,8,2
2019-05-03 01:58,KMG,1588,737-800,20,4,24,4,4,24,,,,,4,4
2019-05-03 01:56,PEK,5373,737-800,22,6,25,6,6,26,,,,,3,4
2019-05-03 01:54,CKG,7616,737-800,20,3,26,3,3,27,,,,,6,7
2019-05-03 01:54,XIY,1481,737-800,20,5,28,5,6,26,,,,,8,6
2019-05-03 01:54,HAK,1783,737-800,27,4,24,4,4,32,,,,,-3,5
2019-05-03 01:53,CGO,1209,737-800,21,3,27,4,4,24,,,,,6,3
2019-05-03 01:52,HHA,1215,737-800,21,4,28,4,4,28,,,,,7,7
2019-05-03 01:52,DLC,1547,737-800,20,5,25,5,5,24,,,,,5,4
2019-05-03 01:50,CAN,1373,737-800,21,4,28,8,8,36,,,,,7,15
2019-05-03 01:48,URC,6995,737-800,18,3,24,4,4,22,,,,,6,4
2019-05-03 01:47,DLC,5520,737-800,23,5,28,7,5,25,,,,,5,2
2019-05-03 01:47,FOC,7400,737-800,16,5,16,5,5,24,,,,,0,8
2019-05-03 01:46,URC,1325,737-800,15,4,24,4,4,20,,,,,9,5
2019-05-03 01:45,URC,206P,737-800,18,4,24,8,8,28,,,,,6,10
2019-05-03 01:43,PEK,5482,737-800,22,2,22,5,5,24,,,,,0,2
2019-05-03 01:42,URC,1323,737-800,17,3,28,3,4,27,,,,,11,10
2019-05-03 01:39,HHA,5661,737-800,25,3,22,4,4,26,,,,,-3,1
2019-05-03 01:38,PEK,5406,737-800,22,4,24,3,3,25,,,,,2,3
2019-05-03 01:38,FOC,1433,737-800,18,2,26,2,3,20,,,,,8,2
2019-05-03 01:38,CAN,7618,737-800,24,6,28,6,5,26,,,,,4,2
2019-05-03 01:35,HHA,,737-800,5638,4,26,4,5,24,,,,,-5612,-5614
2019-05-03 01:32,XIY,5478,737-800,19,5,25,4,4,22,,,,,6,3
2019-05-03 01:32,SZX,5713,737-800,23,6,32,6,6,28,,,,,9,5
2019-05-03 01:28,XIY,5116,737-800,20,5,22,5,5,21,,,,,2,1
2019-05-03 01:24,URC,1995,737-800,17,5,25,6,6,25,,,,,8,8
2019-05-03 01:24,YIH,1348,737-800,17,3,27,4,4,25,,,,,10,8
2019-05-03 01:20,KMG,7988,737-800,20,4,28,6,4,25,,,,,8,5
2019-05-03 01:20,KMG,7988,737-800,20,4,28,6,4,25,,,,,8,5
2019-05-03 01:20,CGO,5449,737-800,21,5,24,4,4,25,,,,,3,4
2019-05-03 01:17,HGH,6060,737-800,18,4,25,3,3,20,,,,,7,2
2019-05-03 01:15,PEK,5538,737-800,22,3,30,4,3,28,,,,,8,6
2019-05-03 01:15,HAK,5089,737-800,25,2,26,2,2,32,,,,,1,7
2019-05-03 01:12,SZX,5855,737-800,22,6,27,5,5,26,,,,,5,4
2019-05-03 01:12,DLC,7378,737-800,19,4,23,4,5,24,,,,,4,5
2019-05-03 01:12,SYX,5483,737-800,27,6,32,4,6,34,,,,,5,7
2019-05-03 01:11,XMN,5852,737-800,23,8,20,8,6,26,,,,,-3,3
2019-05-03 01:11,MIG,6809,737-800,22,5,25,6,6,26,,,,,3,4
2019-05-03 01:10,XMN,1101,737-800,23,2,24,2,2,26,,,,,1,3
2019-05-03 01:09,PEK,5662,737-800,23,5,24,4,7,23,,,,,1,0
2019-05-03 01:09,XMN,1501,737-800,25,3,20,2,3,20,,,,,-5,-5
2019-05-03 01:07,HGH,5620,737-800,18,3,28,2,3,23,,,,,10,5
2019-05-03 01:04,URC,1796,737-800,15,6,24,5,4,0,,,,,9,-15
2019-05-03 01:04,HAK,1549,737-800,26,6,33,6,5,32,,,,,7,6
2019-05-03 01:04,CGO,7992,737-800,21,6,26,6,6,24,,,,,5,3
2019-05-03 01:03,KHG,1569,737-800,17,2,25,3,3,24,,,,,8,7
2019-05-03 01:02,XIY,1480,737-800,22,6,24,4,2,24,,,,,2,2
2019-05-03 00:57,XIY,5418,737-800,20,5,26,4,6,25,,,,,6,5
2019-05-03 00:55,SYX,5623,737-800,26,6,31,6,7,29,,,,,5,3
2019-05-03 00:54,CGO,5428,737-800,22,4,26,5,5,29,,,,,4,7
2019-05-03 00:53,DLC,1346,737-800,22,3,22,3,4,22,,,,,0,0
2019-05-03 00:53,URC,7398,737-800,15,4,24,3,4,22,,,,,9,7
2019-05-03 00:51,HHA,5733,737-800,23,5,24,6,6,24,,,,,1,1
2019-05-03 00:51,URC,1322,737-800,15,2,24,2,3,23,,,,,9,8
2019-05-03 00:51,HGH,1372,737-800,21,5,26,5,5,24,,,,,5,3
2019-05-03 00:50,URC,1726,737-800,14,4,24,4,4,23,,,,,10,9
2019-05-03 00:48,DLC,5416,737-800,20,6,21,7,6,26,,,,,1,6
2019-05-03 00:48,KMG,5732,737-800,20,4,18,4,5,16,,,,,-2,-4
2019-05-03 00:42,HRB,7113,737-800,18,3,23,3,3,20,,,,,5,2
2019-05-03 00:41,XIY,1496,737-800,17,6,26,5,5,26,,,,,9,9
2019-05-03 00:39,XIY,5180,737-800,19,6,28,7,6,26,,,,,9,7
2019-05-03 00:37,HAK,5709,737-800,27,6,34,8,6,32,,,,,7,5
2019-05-03 00:36,HAK,1505,737-800,26,4,34,6,4,32,,,,,8,6
2019-05-03 00:34,TYN,7639,737-800,20,8,28,6,6,22,,,,,8,2
2019-05-03 00:33,XIY,6061,737-800,19,4,24,5,5,24,,,,,5,5
2019-05-03 00:33,HAK,1735,737-800,25,4,31,6,5,26,,,,,6,1
2019-05-03 00:33,DLC,7173,737-800,19,4,26,5,5,22,,,,,7,3
2019-05-03 00:33,SZX,1213,737-800,20,6,30,6,5,30,,,,,10,10
2019-05-03 00:32,YIH,7113,737-800,17,5,26,5,5,24,,,,,9,7
2019-05-03 00:30,URC,5636,737-800,10,4,24,4,5,26,,,,,14,16
2019-05-03 00:30,DLC,1491,737-800,20,4,28,5,5,26,,,,,8,6
2019-05-03 00:24,DLC,1487,737-800,22,3,23,3,3,22,,,,,1,0
2019-05-03 00:24,PEK,5539,737-800,22,4,24,5,5,25,,,,,2,3
2019-05-03 00:23,HGH,5580,737-800,18,4,24,4,4,26,,,,,6,8
2019-05-03 00:22,HHA,1490,737-800,25,5,28,4,4,25,,,,,3,0
2019-05-03 00:21,FOC,1905,737-800,19,3,27,4,3,21,,,,,8,2
2019-05-03 00:19,FOC ,5430,737-800,20,6,28,6,5,30,,,,,8,10
2019-05-03 00:16,XIY,7619,737-800,19,5,25,4,4,24,,,,,6,5
2019-05-03 00:16,URC,1996,737-800,15,5,17,5,4,24,,,,,2,9
2019-05-03 00:16,XIY,7172,737-800,18,4,27,4,4,26,,,,,9,8
2019-05-03 00:13,HAK,5137,737-800,26,3,23,2,2,30,,,,,-3,4
2019-05-03 00:09,SZX,7377,737-800,22,3,19,3,3,23,,,,,-3,1
2019-05-03 00:08,TYN,5375,737-800,18,4,22,4,4,24,,,,,4,6
2019-05-03 00:08,SYX,1130,737-800,26,3,34,3,2,31,,,,,8,5
2019-05-03 00:07,MIG,5407,737-800,20,4,26,4,4,24,,,,,6,4
2019-05-03 00:05,URC,6268,737-800,17,4,26,4,6,26,,,,,9,9
2019-05-03 00:01,CAN,7175,737-800,23,5,30,5,5,27,,,,,7,4
2019-05-02 23:59,SYX,5359,737-800,27,6,30,5,5,30,,,,,3,3
2019-05-02 23:59,HAK,5135,737-800,26,7,34,2,2,31,,,,,8,5
2019-05-02 23:59,,1386,737-800,20,3,26,4,4,25,,,,,6,5
2019-05-02 23:56,SZX,5338,737-800,21,4,26,4,4,27,,,,,5,6
2019-05-02 23:51,XIY,5625,737-800,22,4,23,5,5,24,,,,,1,2
2019-05-02 23:50,URC,1929,737-800,19,3,18,3,4,24,,,,,-1,5
2019-05-02 23:46,URC,5371,737-800,17,4,20,5,6,21,,,,,3,4
2019-05-02 23:29,MIG,1586,737-800,25,4,28,4,4,28,,,,,3,3
2019-05-02 23:28,CGO,1568,737-800,23,5,26,7,7,24,,,,,3,1
2019-05-02 23:26,SYX,5467,737-800,27,0,28,0,0,22,,,,,1,-5
2019-05-02 23:25,HAK,5687,737-800,26,4,32,4,4,32,,,,,6,6
2019-05-02 23:24,PEK,5466,737-800,23,0,0,3,1,12,,,,,-23,-11
2019-05-02 23:23,º£¿Ú,1793,737-800,26,4,34,6,4,30,,,,,8,4
2019-05-02 23:20,SZX,5521,737-800,21,6,26,0,0,20,,,,,5,-1
2019-05-02 23:18,CAN,1787,737-800,23,1,28,1,1,24,,,,,5,1
2019-05-02 23:12,HRB,1350,737-800,18,2,21,3,2,20,,,,,3,2
2019-05-02 23:11,HAK,5637,737-800,26,2,34,2,3,33,,,,,8,7
2019-05-02 23:06,KMG,7989,737-800,20,5,28,7,5,24,,,,,8,4
2019-05-02 23:02,HRB,1559,737-800,13,5,18,6,6,19,,,,,5,6
2019-05-02 22:56,ZGC,1498,737-800,20,6,26,6,5,16,,,,,6,-4
2019-05-02 22:53,URC,7198,737-800,20,4,24,4,5,25,,,,,4,5
2019-05-02 22:52,HGH,5408,737-800,21,5,26,5,5,24,,,,,5,3
2019-05-02 22:50,PEK,5417,737-800,25,5,20,5,5,22,,,,,-5,-3
2019-05-02 22:48,CKG,1785,737-800,20,0,30,9,9,28,,,,,10,8
2019-05-02 22:48,ZGC,5153,737-800,20,3,22,3,3,24,,,,,2,4
2019-05-02 22:40,PEK,5853,737-800,25,6,28,8,6,24,,,,,3,-1
2019-05-02 22:35,HAK,1502,737-800,26,3,32,4,4,32,,,,,6,6
2019-05-02 22:34,SYX,1928,737-800,27,4,27,5,5,32,,,,,0,5
2019-05-02 22:33,HAK,206F,737-800,25,4,30,4,5,29,,,,,5,4
2019-05-02 22:33,URC,205T,737-800,18,2,26,3,3,26,,,,,8,8
2019-05-02 22:26,HAK,5462,737-800,26,4,32,4,6,31,,,,,6,5
2019-05-02 22:19,HGH,5502,737-800,19,4,24,4,3,25,,,,,5,6
2019-05-02 22:16,XIY,1733,737-800,20,6,25,6,7,28,,,,,5,8
2019-05-02 22:14,XIY,1141,737-800,19,4,28,4,4,26,,,,,9,7
2019-05-02 22:01,TYN,5372,737-800,20,8,19,8,7,21,,,,,-1,1
2019-05-02 21:54,XNN,5581,737-800,15,4,18,5,5,22,,,,,3,7
2019-05-02 21:53,TYN,5429,737-800,16,4,28,4,4,22,,,,,12,6
2019-05-02 21:53,XNN,1493,737-800,15,4,20,4,4,20,,,,,5,5
2019-05-02 20:47,PEK,5481,737-800,25,4,24,4,4,24,,,,,-1,-1
2019-05-02 20:05,HAK,1796,737-800,28,4,36,4,4,32,,,,,8,4
2019-05-02 19:35,PEK,1346,737-800,29,4,25,4,4,24,,,,,-4,-5
2019-05-02 19:08,CTU,7989,737-800,25,5,30,5,6,27,,,,,5,2
2019-05-02 18:27,CAN,1538,737-800,20,2,20,5,4,20,,,,,0,0
2019-05-02 17:58,HAK,5139,737-800,27,6,28,6,4,30,,,,,1,3
2019-05-02 17:27,YIH,7395,737-800,25,5,26,6,6,26,,,,,1,1
2019-05-02 16:32,FOC,5182,737-800,23,6,27,4,5,20,,,,,4,-3
2019-05-02 15:58,URC,205U,737-800,24,4,28,5,4,27,,,,,4,3
2019-05-02 15:22,XIY,5115,737-800,27,3,16,5,5,17,,,,,-11,-10
2019-05-02 13:35,PEK,7400,737-800,32,6,24,13,14,20,,,,,-8,-12
2019-05-02 12:33,ÐìÖÝ,7933,737-800,20,5,27,5,6,26,,,,,7,6
2019-05-02 09:58,CGO,6016,737-800,20,6,28,5,4,26,,,,,8,6
2019-05-02 09:21,HHA,5481,737-800,20,5,28,4,4,27,,,,,8,7
2019-05-02 08:53,SZX,6065,737-800,24,4,30,4,4,28,,,,,6,4
2019-05-02 08:52,SZX,1492,737-800,23,4,28,3,3,24,,,,,5,1
2019-05-02 08:50,HAK,5540,737-800,26,5,34,4,4,34,,,,,8,8
2019-05-02 08:36,XMN,5439,737-800,20,5,27,5,7,28,,,,,7,8
2019-05-02 08:36,XMN,5138,737-800,22,3,29,7,6,30,,,,,7,8
2019-05-02 08:35,XMN,5852,737-800,20,4,25,5,6,25,,,,,5,5
2019-05-02 08:34,XMN,5406,737-800,20,5,26,4,6,27,,,,,6,7
2019-05-02 08:32,XMN,1545,737-800,23,8,30,4,5,28,,,,,7,5
2019-05-02 08:18,SZX,6061,737-800,24,6,29,5,4,26,,,,,5,2
2019-05-02 08:13,PEK,5136,737-800,18,3,21,4,5,30,,,,,3,12
2019-05-02 07:57,TYN,7379,737-800,16,4,26,4,4,26,,,,,10,10
2019-05-02 07:54,XIY,1102,737-800,15,6,23,6,6,26,,,,,8,11
2019-05-02 07:44,ZGC,5153,737-800,16,4,20,3,3,19,,,,,4,3
2019-05-02 07:20,PEK,7400,737-800,18,6,24,6,6,20,,,,,6,2
2019-05-02 06:35,CGO,205V,737-800,20,4,23,3,4,21,,,,,3,1
2019-05-02 06:15,HRB,1905,737-800,11,1,23,4,7,24,,,,,12,13
2019-05-02 06:15,HRB,1905,737-800,11,1,23,4,7,24,,,,,12,13
2019-05-02 06:08,PEK,1733,737-800,20,2,20,1,2,19,,,,,0,-1
2019-05-02 05:52,CAN,1538,737-800,24,2,26,4,4,25,,,,,2,1
2019-05-02 05:43,HAK,7377,737-800,26,6,31,7,6,30,,,,,5,4
2019-05-02 05:42,HAK,2158,737-800,27,5,24,4,4,25,,,,,-3,-2
2019-05-02 05:39,PEK,5482,737-800,20,0,18,4,4,23,,,,,-2,3
2019-05-02 05:33,KMG,1798,737-800,20,6,25,8,6,22,,,,,5,2
2019-05-02 05:32,HAK,1505,737-800,26,4,30,4,4,28,,,,,4,2
2019-05-02 05:23,HAK,1735,737-800,28,4,28,6,6,26,,,,,0,-2
2019-05-02 05:09,SZX ,1488,737-800,24,6,32,5,5,30,,,,,8,6
2019-05-02 05:07,XIY,5418,737-800,15,4,30,2,4,28,,,,,15,13
2019-05-02 05:06,HHA,5481,737-800,20,4,26,4,5,28,,,,,6,8
2019-05-02 05:03,HGH,1498,737-800,18,5,26,6,6,24,,,,,8,6
2019-05-02 04:53,CAN,5579,737-800,23,5,30,5,6,28,,,,,7,5
2019-05-02 04:33,KMG,1209,737-800,18,2,26,4,4,22,,,,,8,4
2019-05-02 04:30,HAK,5687,737-800,25,6,31,5,6,30,,,,,6,5
2019-05-02 04:30,KMG,5407,737-800,20,4,20,4,4,17,,,,,0,-3
2019-05-02 04:29,HAK,5372,737-800,26,8,30,9,9,32,,,,,4,6
2019-05-02 04:21,HAK,5135,737-800,26,6,33,3,4,30,,,,,7,4
2019-05-02 04:20,HAK,1103,737-800,26,6,34,4,4,32,,,,,8,6
2019-05-02 04:16,SYX,1729,737-800,25,4,22,5,4,26,,,,,-3,1
2019-05-02 04:15,PEK,1541,737-800,13,4,28,5,5,23,,,,,15,10
2019-05-02 04:10,XIY,1481,737-800,16,5,26,6,6,22,,,,,10,6
2019-05-02 04:10,HAK,5408,737-800,25,4,33,6,4,29,,,,,8,4
2019-05-02 04:08,XIY,5337,737-800,18,4,20,6,5,20,,,,,2,2
2019-05-02 03:55,CGO,1799,737-800,20,5,26,5,5,26,,,,,6,6
2019-05-02 03:54,HGH,5798,737-800,21,2,22,2,1,21,,,,,1,0
2019-05-02 03:51,URC,205U,737-800,16,4,24,4,4,23,,,,,8,7
2019-05-02 03:44,XIY,1902,737-800,15,4,24,4,4,24,,,,,9,9
2019-05-02 03:38,URC,6268,737-800,16,4,24,4,5,23,,,,,8,7
2019-05-02 03:38,URC,1131,737-800,17,4,28,4,4,27,,,,,11,10
2019-05-02 03:35,CGO,1588,737-800,21,4,24,5,5,23,,,,,3,2
2019-05-02 03:33,KMG,1587,737-800,18,4,24,6,4,22,,,,,6,4
2019-05-02 03:28,HAK,5465,737-800,28,3,32,4,4,30,,,,,4,2
2019-05-02 03:19,FOC,7395,737-800,19,4,27,4,5,26,,,,,8,7
2019-05-02 03:19,XIY,1483,737-800,15,4,22,6,6,22,,,,,7,7
2019-05-02 03:14,HHA,5638,737-800,21,4,26,4,4,26,,,,,5,5
2019-05-02 03:08,URC,1996,737-800,15,4,20,5,5,23,,,,,5,8
2019-05-02 03:07,XIY,1141,737-800,17,6,26,5,6,26,,,,,9,9
2019-05-02 03:07,URC,7198,737-800,20,4,24,5,4,24,,,,,4,4
2019-05-02 03:06,XIY,5116,737-800,17,3,20,3,3,19,,,,,3,2
2019-05-02 03:04,SYX,6060,737-800,29,4,32,6,5,31,,,,,3,2
2019-05-02 03:01,CAN,1375,737-800,22,3,28,3,3,23,,,,,6,1
2019-05-02 03:01,KMG,7990,737-800,20,3,24,3,4,23,,,,,4,3
2019-05-02 03:00,KMG,6015,737-800,20,3,24,2,2,22,,,,,4,2
2019-05-02 02:59,URC,1323,737-800,15,4,28,4,4,26,,,,,13,11
2019-05-02 02:59,ZGC,1130,737-800,20,3,20,2,3,20,,,,,0,0
2019-05-02 02:59,PEK,5538,737-800,23,2,30,2,4,28,,,,,7,5
2019-05-02 02:58,ZGC,5153,737-800,16,4,20,3,3,19,,,,,4,3
2019-05-02 02:56,ZGC,1997,737-800,20,4,22,4,6,26,,,,,2,6
2019-05-02 02:54,URC,5371,737-800,16,4,22,4,4,22,,,,,6,6
2019-05-02 02:54,URC,2157,737-800,15,2,22,8,6,22,,,,,7,7
2019-05-02 02:51,URC,1929,737-800,17,4,24,3,4,22,,,,,7,5
2019-05-02 02:50,XIY,1161,737-800,17,4,24,4,4,22,,,,,7,5
2019-05-02 02:47,HGH,1493,737-800,18,6,25,6,6,21,,,,,7,3
2019-05-02 02:45,XIY,5503,737-800,16,3,24,3,3,22,,,,,8,6
2019-05-02 02:45,CAN,1549,737-800,22,6,28,5,5,27,,,,,6,5
2019-05-02 02:45,FOC,5182,737-800,18,3,28,4,3,25,,,,,10,7
2019-05-02 02:44,SYX,6066,737-800,25,2,33,2,2,31,,,,,8,6
2019-05-02 02:43,XIY,5478,737-800,16,3,26,4,3,24,,,,,10,8
2019-05-02 02:42,XIY,1386,737-800,20,3,24,6,6,22,,,,,4,2
2019-05-02 02:41,SZX,1503,737-800,23,3,30,4,4,28,,,,,7,5
2019-05-02 02:41,SYX,1495,737-800,26,4,34,5,5,32,,,,,8,6
2019-05-02 02:36,FOC ,5430,737-800,18,6,30,6,5,30,,,,,12,12
2019-05-02 02:34,FOC,5185,737-800,19,3,30,4,3,28,,,,,11,9
2019-05-02 02:34,XIY,1162,737-800,18,3,27,3,2,23,,,,,9,5
2019-05-02 02:33,HHA,5735,737-800,20,2,24,2,2,22,,,,,4,2
2019-05-02 02:30,HAK,5625,737-800,25,8,36,5,5,34,,,,,11,9
2019-05-02 02:29,HGH,5502,737-800,18,4,24,4,6,23,,,,,6,5
2019-05-02 02:27,URC,1568,737-800,16,5,25,6,5,21,,,,,9,5
2019-05-02 02:25,HHA,1927,737-800,21,3,26,5,4,26,,,,,5,5
2019-05-02 02:24,SYX,5428,737-800,30,4,34,5,4,34,,,,,4,4
2019-05-02 02:23,HAK,7886,737-800,26,4,34,4,4,32,,,,,8,6
2019-05-02 02:23,URC,5623,737-800,15,5,25,5,6,22,,,,,10,7
2019-05-02 02:20,XIY,1163,737-800,15,2,26,2,2,24,,,,,11,9
2019-05-02 02:17,URC,5371,737-800,20,3,20,3,4,20,,,,,0,0
2019-05-02 02:16,CAN,5579,737-800,23,5,30,5,6,28,,,,,7,5
2019-05-02 02:15,XIY,1903,737-800,16,2,25,4,3,22,,,,,9,6
2019-05-02 02:15,SYX,5359,737-800,27,4,29,6,6,30,,,,,2,3
2019-05-02 02:14,CAN,1787,737-800,24,1,29,0,0,24,,,,,5,0
2019-05-02 02:13,URC,206P,737-800,16,5,24,3,5,23,,,,,8,7
2019-05-02 02:12,104,5466,737-800,20,4,0,7,1,19,,,,,-20,-1
2019-05-02 02:12,KMG,1209,737-800,18,2,26,4,4,22,,,,,8,4
2019-05-02 02:12,FOC,1433,737-800,19,4,28,2,2,22,,,,,9,3
2019-05-02 02:08,XIY,1480,737-800,16,6,20,4,4,20,,,,,4,4
2019-05-02 02:07,URC,6995,737-800,22,4,28,6,6,24,,,,,6,2
2019-05-02 02:06,XIY,1213,737-800,18,5,21,5,5,22,,,,,3,4
2019-05-02 02:00,PEK,5539,737-800,28,5,22,6,5,24,,,,,-6,-4
2019-05-02 01:49,FOC,7398,737-800,19,4,28,4,4,24,,,,,9,5
2019-05-02 01:44,TYN,5520,737-800,15,2,22,2,2,20,,,,,7,5
2019-05-02 01:44,YIH,1435,737-800,25,5,26,6,6,24,,,,,1,-1
2019-05-02 01:43,HAK,1497,737-800,26,3,32,5,4,31,,,,,6,5
2019-05-02 01:42,HAK,5686,737-800,30,6,32,4,4,33,,,,,2,3
2019-05-02 01:39,MIG,6809,737-800,20,4,24,4,4,24,,,,,4,4
2019-05-02 01:36,HGH,1491,737-800,21,5,28,6,6,30,,,,,7,9
2019-05-02 01:35,PEK,5482,737-800,26,1,19,5,5,25,,,,,-7,-1
2019-05-02 01:33,HHA,1215,737-800,22,3,28,5,5,29,,,,,6,7
2019-05-02 01:26,URC,1101,737-800,16,2,30,4,4,30,,,,,14,14
2019-05-02 01:25,KMG,7167,737-800,18,5,25,5,5,22,,,,,7,4
2019-05-02 01:24,CGO,7992,737-800,20,6,26,6,6,24,,,,,6,4
2019-05-02 01:23,CAN,1797,737-800,22,4,27,4,4,26,,,,,5,4
2019-05-02 01:22,CAN,5463,737-800,22,5,23,5,4,22,,,,,1,0
2019-05-02 01:21,XIY,5180,737-800,16,6,25,6,7,24,,,,,9,8
2019-05-02 01:21,HAK,5521,737-800,25,4,28,3,2,27,,,,,3,2
2019-05-02 01:20,HHA,5661,737-800,20,4,26,4,3,29,,,,,6,9
2019-05-02 01:20,URC,1131,737-800,17,4,28,4,4,27,,,,,11,10
2019-05-02 01:19,SYX,206G,737-800,27,6,34,6,6,30,,,,,7,3
2019-05-02 01:18,XIY,7619,737-800,18,5,26,8,8,26,,,,,8,8
2019-05-02 01:17,CGO,1785,737-800,22,2,26,8,8,26,,,,,4,4
2019-05-02 01:15,DLC,1487,737-800,16,2,20,2,2,20,,,,,4,4
2019-05-02 01:15,KMG,1208,737-800,17,3,14,3,3,21,,,,,-3,4
2019-05-02 01:13,URC,5139,737-800,20,3,20,6,2,24,,,,,0,4
2019-05-02 01:13,HHA,1786,737-800,22,4,19,3,3,22,,,,,-3,0
2019-05-02 01:11,URC,5662,737-800,15,4,22,4,4,26,,,,,7,11
2019-05-02 01:03,PEK,5522,737-800,18,4,20,6,4,20,,,,,2,2
2019-05-02 01:02,HGH,1372,737-800,24,5,26,4,4,24,,,,,2,0
2019-05-02 00:59,URC,1325,737-800,15,4,24,4,4,20,,,,,9,5
2019-05-02 00:55,YIH,1348,737-800,21,4,30,4,3,26,,,,,9,5
2019-05-02 00:54,SZX,1489,737-800,24,4,29,4,4,27,,,,,5,3
2019-05-02 00:54,FOC,1906,737-800,20,6,28,6,6,28,,,,,8,8
2019-05-02 00:53,HAK,1542,737-800,26,2,32,8,6,30,,,,,6,4
2019-05-02 00:52,¹þ¶û±õ,1351,737-800,11,3,26,3,4,17,,,,,15,6
2019-05-02 00:51,KMG,7993,737-800,18,6,25,6,6,22,,,,,7,4
2019-05-02 00:50,URC,5636,737-800,17,4,26,4,4,25,,,,,9,8
2019-05-02 00:49,DLC,1928,737-800,16,4,22,3,4,22,,,,,6,6
2019-05-02 00:44,HAK,5709,737-800,26,6,36,6,7,32,,,,,10,6
2019-05-02 00:42,MIG,1586,737-800,22,4,28,4,4,27,,,,,6,5
2019-05-02 00:33,YIH,7113,737-800,21,4,27,5,5,25,,,,,6,4
2019-05-02 00:27,PEK,7378,737-800,19,5,22,5,6,24,,,,,3,5
2019-05-02 00:26,CAN,7618,737-800,26,5,28,7,5,26,,,,,2,0
2019-05-02 00:25,CAN,5137,737-800,23,3,29,3,3,26,,,,,6,3
2019-05-02 00:24,KHG,1569,737-800,23,2,24,2,2,23,,,,,1,0
2019-05-02 00:24,CAN,1496,737-800,23,6,31,6,6,30,,,,,8,7
2019-05-02 00:23,CGO,1588,737-800,21,4,24,5,5,23,,,,,3,2
2019-05-02 00:23,CKG,5483,737-800,20,4,30,4,4,30,,,,,10,10
2019-05-02 00:21,DLC,1346,737-800,15,6,26,4,6,21,,,,,11,6
2019-05-02 00:20,DLC,1547,737-800,24,6,22,6,6,22,,,,,-2,-2
2019-05-02 00:20,HGH,5620,737-800,19,3,28,4,4,22,,,,,9,3
2019-05-02 00:20,CAN,7618,737-800,26,5,28,7,5,26,,,,,2,0
2019-05-02 00:20,URC,1995,737-800,17,8,20,7,6,18,,,,,3,1
2019-05-02 00:18,HHA,1490,737-800,23,5,28,4,4,26,,,,,5,3
2019-05-02 00:15,MIG,5407,737-800,20,4,26,4,4,26,,,,,6,6
2019-05-02 00:12,HRB,7105,737-800,11,4,22,4,4,20,,,,,11,9
2019-05-02 00:08,URC,1726,737-800,20,4,28,4,4,22,,,,,8,2
2019-05-02 00:06,HGH,1728,737-800,22,6,26,5,6,23,,,,,4,1
2019-05-02 00:05,HAK,1793,737-800,26,4,34,6,5,30,,,,,8,4
2019-05-02 00:05,TYN,5429,737-800,17,3,20,3,2,22,,,,,3,5
2019-05-02 00:02,PEK,6103,737-800,19,6,23,6,6,23,,,,,4,4
2019-05-01 23:57,SZX ,5713,737-800,24,6,30,4,4,28,,,,,6,4
2019-05-01 23:57,URC,1725,737-800,17,4,28,5,5,26,,,,,11,9
2019-05-01 23:54,URC,5797,737-800,17,6,18,5,5,21,,,,,1,4
2019-05-01 23:50,TYN,7639,737-800,10,6,30,6,6,24,,,,,20,14
2019-05-01 23:48,CAN,5137,737-800,23,3,29,3,3,26,,,,,6,3
2019-05-01 23:45,URC,1570,737-800,16,5,22,5,5,20,,,,,6,4
2019-05-01 23:44,URC,205T,737-800,15,3,26,3,3,27,,,,,11,12
2019-05-01 23:40,SYX,1727,737-800,25,5,33,4,5,28,,,,,8,3
2019-05-01 23:38,SYX,5467,737-800,27,2,30,2,2,25,,,,,3,-2
2019-05-01 23:37,HAK,5338,737-800,25,3,30,5,4,32,,,,,5,7
2019-05-01 23:29,´óÁ¬,1487,737-800,16,2,20,2,2,20,,,,,4,4
2019-05-01 23:24,MIG,5732,737-800,20,4,26,4,4,24,,,,,6,4
2019-05-01 23:22,XIY ,5853 ,737-800,18,4,22,6,7,23,,,,,4,5
2019-05-01 23:17,HAK,5462,737-800,27,4,32,8,4,33,,,,,5,6
2019-05-01 23:16,HRB,1905,737-800,11,4,20,23,24,12,,,,,9,1
2019-05-01 23:14,HGH,5405,737-800,21,4,30,4,4,25,,,,,9,4
2019-05-01 23:12,XIY,5416,737-800,18,8,26,8,8,17,,,,,8,-1
2019-05-01 23:10,PEK,5479,737-800,19,4,20,6,6,26,,,,,1,7
2019-05-01 23:08,DLC,7173,737-800,15,4,25,6,5,22,,,,,10,7
2019-05-01 23:05,SYX,6062,737-800,29,6,35,5,4,35,,,,,6,6
2019-05-01 22:55,HAK,5449,737-800,27,9,27,9,9,27,,,,,0,0
2019-05-01 22:47,DLC,5712,737-800,20,2,20,2,3,18,,,,,0,-2
2019-05-01 22:38,CKG,7399,737-800,26,6,34,5,5,35,,,,,8,9
2019-05-01 22:36,DLC,6063,737-800,18,6,25,5,5,24,,,,,7,6
2019-05-01 22:33,XIY,5346,737-800,18,4,20,5,4,20,,,,,2,2
2019-05-01 22:32,CGO,7988,737-800,22,5,25,5,4,25,,,,,3,3
2019-05-01 22:31,HAK,5089,737-800,28,3,24,1,2,33,,,,,-4,5
2019-05-01 22:21,PEK,1501,737-800,25,4,27,3,4,24,,,,,2,-1
2019-05-01 22:20,XNN,7175,737-800,13,5,22,5,5,20,,,,,9,7
2019-05-01 22:17,URC,2159,737-800,19,7,21,2,2,21,,,,,2,2
2019-05-01 22:11,HAK,1502,737-800,27,3,31,4,4,30,,,,,4,3
2019-05-01 22:08,CAN,5637,737-800,25,2,30,3,2,28,,,,,5,3
2019-05-01 21:44,XNN,5581,737-800,13,4,22,3,5,18,,,,,9,5
2019-05-01 21:20,HAK,206H,737-800,28,1,24,2,3,34,,,,,-4,6
2019-05-01 21:17,TYN,5375,737-800,17,2,18,4,4,20,,,,,1,3
2019-05-01 21:07,106,1347,737-800,24,3,24,2,2,22,,,,,0,-2
2019-05-01 21:02,FOC,1562,737-800,19,5,30,5,5,29,,,,,11,10
2019-05-01 20:46,DLC,7172,737-800,18,3,26,4,5,27,,,,,8,9
2019-05-01 20:37,HAK,1373,737-800,28,4,32,4,4,28,,,,,4,0
2019-05-01 20:21,HRB,1559,737-800,14,2,23,2,2,23,,,,,9,9
2019-05-01 19:45,FOC,1562,737-800,19,5,30,5,5,29,,,,,11,10
2019-05-01 18:43,HAK,5090,737-800,27,1,28,2,3,30,,,,,1,3
2019-05-01 17:40,HHA,7171,737-800,30,5,32,4,4,32,,,,,2,2
2019-05-01 17:16,XUZ,7991,737-800,25,5,26,5,5,24,,,,,1,-1
2019-05-01 13:47,CGO,5409,737-800,26,1,25,5,4,25,,,,,-1,-1
2019-05-01 13:02,URC,6268,737-800,17,4,28,4,5,26,,,,,11,9
2019-05-01 12:09,³É¶¼,7989,737-800,30,5,30,4,5,29,,,,,0,-1
2019-05-01 09:13,SZX,5709,737-800,26,6,32,7,6,32,,,,,6,6
2019-05-01 09:08,SZX,5540,737-800,27,4,28,5,5,30,,,,,1,3
2019-05-01 08:58,SZX,5522,737-800,24,6,30,6,7,28,,,,,6,4
2019-05-01 08:36,PEK,7398,737-800,21,4,24,3,3,21,,,,,3,0
2019-05-01 08:13,XIY,7105,737-800,20,4,26,5,4,24,,,,,6,4
2019-05-01 08:06,FOC,7395,737-800,20,7,26,6,6,27,,,,,6,7
2019-05-01 08:05,URC,5139,737-800,20,2,26,4,4,24,,,,,6,4
2019-05-01 07:43,XMN,5408,737-800,19,6,28,2,2,22,,,,,9,3
2019-05-01 07:42,XMN,1130,737-800,25,4,33,9,8,36,,1,,1,8,11
2019-05-01 07:41,XMN,5406,737-800,20,4,30,8,4,21,,,,,10,1
2019-05-01 07:41,XMN,7639,737-800,25,6,30,6,6,31,,,,,5,6
2019-05-01 07:40,XMN,5417,737-800,20,4,29,3,3,30,,,,,9,10
2019-05-01 07:15,HAK,1796,737-800,27,6,32,6,4,34,,,,,5,7
2019-05-01 07:06,XIY,7619,737-800,20,5,26,6,6,26,,,,,6,6
2019-05-01 07:05,KMG,7990,737-800,15,3,24,4,4,22,,,,,9,7
2019-05-01 06:39,HHA,1927,737-800,15,3,24,9,9,20,,,,,9,5
2019-05-01 06:19,FOC,5430,737-800,21,6,30,5,6,30,,,,,9,9
2019-05-01 06:18,FOC,5430,737-800,21,6,30,5,6,32,,,,,9,11
2019-05-01 05:51,CAN,5637,737-800,21,3,28,2,2,26,,,,,7,5
2019-05-01 05:48,Ö£ÖÝ,1587,737-800,15,2,22,4,2,24,,,,,7,9
2019-05-01 05:14,XIY,1481,737-800,16,6,26,6,6,24,,,,,10,8
2019-05-01 05:08,FOC,6066,737-800,20,3,24,4,5,23,,,,,4,3
2019-05-01 05:07,HHA,1215,737-800,23,4,34,4,4,32,1,,,1,11,9
2019-05-01 05:02,HHA,5481,737-800,17,5,26,5,5,22,,,,,9,5
2019-05-01 05:01,FOC,5182,737-800,20,3,29,4,3,25,,,,,9,5
2019-05-01 04:46,KMG,1588,737-800,15,4,22,4,4,20,,,,,7,5
2019-05-01 04:40,PEK,7400,737-800,17,4,24,4,5,20,,,,,7,3
2019-05-01 04:38,XIY,5418,737-800,17,5,17,4,4,19,,,,,0,2
2019-05-01 04:37,XIY,5478,737-800,19,4,28,5,4,22,,,,,9,3
2019-05-01 04:35,XIY,5337,737-800,20,4,23,6,5,24,,,,,3,4
2019-05-01 04:31,URC,1322,737-800,20,4,24,4,4,24,,,,,4,4
2019-05-01 04:27,HAK,1793,737-800,26,5,34,6,5,30,,,,,8,4
2019-05-01 04:24,PEK,1735,737-800,15,4,22,4,4,20,,,,,7,5
2019-05-01 04:19,FOC,1562,737-800,19,4,28,4,4,27,,,,,9,8
2019-05-01 04:08,XIY,5503,737-800,20,4,24,4,4,24,,,,,4,4
2019-05-01 04:08,HHA,1733,737-800,18,2,21,3,3,18,,,,,3,0
2019-05-01 04:05,HAK,5479,737-800,28,6,28,5,4,28,,,,,0,0
2019-05-01 03:58,KMG,1209,737-800,15,4,26,4,4,20,,,,,11,5
2019-05-01 03:55,HAK,1541,737-800,25,6,32,7,5,32,,,,,7,7
2019-05-01 03:53,CKG,7399,737-800,21,4,26,4,4,27,,,,,5,6
2019-05-01 03:42,KMG,7991,737-800,16,6,24,8,8,21,,,,,8,5
2019-05-01 03:42,KMG,7993,737-800,15,6,24,6,6,22,,,,,9,7
2019-05-01 03:41,KMG,5407,737-800,14,4,22,4,5,22,,,,,8,8
2019-05-01 03:40,PEK,1735,737-800,20,4,22,4,4,25,,,,,2,5
2019-05-01 03:40,PEK,1735,737-800,20,4,22,4,4,25,,,,,2,5
2019-05-01 03:36,HAK,5733,737-800,26,6,33,6,5,34,,,,,7,8
2019-05-01 03:35,URC,6995,737-800,20,4,26,5,5,23,,,,,6,3
2019-05-01 03:30,HGH,1487,737-800,18,3,24,2,2,22,,,,,6,4
2019-05-01 03:28,HA?K,5141,737-800,26,4,32,8,8,33,,,,,6,7
2019-05-01 03:28,HAK,1498,737-800,26,6,33,6,6,32,,,,,7,6
2019-05-01 03:23,SZX,5713,737-800,25,5,30,5,4,29,,,,,5,4
2019-05-01 03:23,URC,1101,737-800,17,2,26,2,3,22,,,,,9,5
2019-05-01 03:23,HHA,5735,737-800,18,0,20,0,0,18,,,,,2,0
2019-05-01 03:21,HGH,1545,737-800,20,4,24,2,2,20,,,,,4,0
2019-05-01 03:20,HAK,5462,737-800,27,4,32,6,5,34,,,,,5,7
2019-05-01 03:17,YIH,7113,737-800,17,5,27,5,5,24,,,,,10,7
2019-05-01 03:13,KMG,7988,737-800,14,4,24,5,4,24,,,,,10,10
2019-05-01 03:11,HAK,1347,737-800,27,4,36,4,4,30,,,,,9,3
2019-05-01 03:10,URC,5371,737-800,21,4,20,4,4,21,,,,,-1,0
2019-05-01 03:09,URC,5623,737-800,20,6,26,6,5,24,,,,,6,4
2019-05-01 03:08,URC,2157,737-800,20,4,24,6,6,24,,,,,4,4
2019-05-01 03:08,SYX,1799,737-800,28,6,35,6,6,32,,,,,7,4
2019-05-01 03:08,URC,1996,737-800,20,6,20,5,6,24,,,,,0,4
2019-05-01 03:06,URC ,206P,737-800,21,4,22,4,4,22,,,,,1,1
2019-05-01 03:04,KMG,1208,737-800,16,2,24,4,4,21,,,,,8,5
2019-05-01 03:04,URC,1726,737-800,20,4,22,4,4,20,,,,,2,0
2019-05-01 03:02,URC,1570,737-800,18,6,21,4,6,20,,,,,3,2
2019-05-01 03:02,ZGC,5439,737-800,13,5,19,5,6,19,,,,,6,6
2019-05-01 03:01,URC,5638,737-800,20,4,24,4,4,24,,,,,4,4
2019-05-01 02:58,URC,205U,737-800,24,4,26,4,5,22,,,,,2,-2
2019-05-01 02:54,XIY,1795,737-800,20,4,22,4,5,22,,,,,2,2
2019-05-01 02:52,SYX,5686,737-800,28,8,34,6,6,31,,,,,6,3
2019-05-01 02:50,XIY,1482,737-800,15,6,26,6,6,24,,,,,11,9
2019-05-01 02:50,HAK,1497,737-800,26,3,36,4,4,32,,,,,10,6
2019-05-01 02:43,XIY,5467,737-800,19,0,24,2,0,18,,,,,5,-1
2019-05-01 02:37,FOC,1906,737-800,22,6,25,4,4,24,,,,,3,2
2019-05-01 02:35,URC,1995,737-800,20,6,22,4,6,26,,,,,2,6
2019-05-01 02:32,CAN,1549,737-800,23,6,28,4,4,28,,,,,5,5
2019-05-01 02:31,HAK,5082,737-800,25,4,34,4,4,31,,,,,9,6
2019-05-01 02:31,URC,1568,737-800,20,6,24,4,6,20,,,,,4,0
2019-05-01 02:31,HAK,5358,737-800,27,8,32,8,8,34,,,,,5,7
2019-05-01 02:31,HAK,5090,737-800,28,2,26,2,3,30,,,,,-2,2
2019-05-01 02:30,HAK,1386,737-800,25,4,31,4,3,28,,,,,6,3
2019-05-01 02:30,CAN,5465,737-800,22,3,26,6,6,23,,,,,4,1
2019-05-01 02:30,XIY,1902,737-800,20,6,24,4,4,22,,,,,4,2
2019-05-01 02:29,HAK,1489,737-800,26,4,33,5,5,30,,,,,7,4
2019-05-01 02:28,HGH,1491,737-800,18,5,30,5,5,28,,,,,12,10
2019-05-01 02:25,SYX,1542,737-800,30,4,33,5,4,32,,,,,3,2
2019-05-01 02:24,CAN,1490,737-800,21,5,28,6,5,26,,,,,7,5
2019-05-01 02:24,HHA,1505,737-800,18,3,28,4,4,22,,,,,10,4
2019-05-01 02:23,KMG,7992,737-800,10,7,22,5,5,20,,,,,12,10
2019-05-01 02:22,SYX,5428,737-800,30,6,30,5,4,32,,,,,0,2
2019-05-01 02:20,SZX,5855,737-800,25,6,26,5,4,27,,,,,1,2
2019-05-01 02:16,SZX,6065,737-800,27,5,34,5,5,32,,,,,7,5
2019-05-01 02:16,SYX,6060,737-800,29,6,34,6,6,32,,,,,5,3
2019-05-01 02:16,KMG,7167,737-800,14,6,23,7,6,21,,,,,9,7
2019-05-01 02:15,SYX,6062,737-800,29,4,35,4,4,35,,,,,6,6
2019-05-01 02:12,CGO,6016,737-800,20,4,24,4,4,24,,,,,4,4
2019-05-01 02:10,CAN,5637,737-800,25,2,30,2,2,26,,,,,5,1
2019-05-01 02:09,,206G,737-800,30,4,34,4,4,32,,,,,4,2
2019-05-01 02:08,XIY,1163,737-800,20,3,26,3,3,26,,,,,6,6
2019-05-01 02:08,XIY,5116,737-800,20,4,21,4,5,20,,,,,1,0
2019-05-01 02:06,HAK,5625,737-800,26,4,32,4,5,36,,,,,6,10
2019-05-01 02:04,PEK,5712,737-800,21,4,20,4,3,21,,,,,-1,0
2019-05-01 02:02,TYN,1488,737-800,20,6,24,4,4,20,,,,,4,0
2019-05-01 02:02,PEK,5539,737-800,18,5,20,4,4,24,,,,,2,6
2019-05-01 02:00,HRB,1559,737-800,9,2,24,3,4,20,,,,,15,11
2019-05-01 01:56,XIY,5115,737-800,21,3,20,4,4,24,,,,,-1,3
2019-05-01 01:55,YIH,1435,737-800,17,5,28,5,6,24,,,,,11,7
2019-05-01 01:51,HAK,6061,737-800,26,4,30,4,4,30,,,,,4,4
2019-05-01 01:51,XIY,1162,737-800,18,3,26,3,3,22,,,,,8,4
2019-05-01 01:50,XIY,5180,737-800,20,6,25,7,6,25,,,,,5,5
2019-05-01 01:50,HAK,1727,737-800,26,5,31,6,5,28,,,,,5,2
2019-05-01 01:46,HRB,1905,737-800,11,3,12,4,4,18,,,,,1,7
2019-05-01 01:37,XIY,1161,737-800,20,4,22,3,3,22,,,,,2,2
2019-05-01 01:36,URC,5797,737-800,20,6,22,6,6,22,,,,,2,2
2019-05-01 01:35,HAK,206F,737-800,26,2,30,2,2,28,,,,,4,2
2019-05-01 01:33,PEK,1783,737-800,20,3,20,3,2,20,,,,,0,0
2019-05-01 01:31,HAK,1373,737-800,25,4,32,4,4,28,,,,,7,3
2019-05-01 01:28,PEK,5482,737-800,21,0,20,3,3,24,,,,,-1,3
2019-05-01 01:26,CAN,5338,737-800,25,4,24,4,3,26,,,,,-1,1
2019-05-01 01:18,ZGC,1997,737-800,15,2,18,4,4,18,,,,,3,3
2019-05-01 01:15,HGH,7171,737-800,18,4,21,4,4,25,,,,,3,7
2019-05-01 01:12,XIY,1501,737-800,22,4,28,4,4,32,,,,,6,10
2019-05-01 01:11,FOC,1480,737-800,20,5,24,5,6,22,,,,,4,2
2019-05-01 01:09,XIY,5416,737-800,20,7,22,8,8,27,,,,,2,7
2019-05-01 01:07,SZX,5483,737-800,28,5,33,5,5,34,,,,,5,6
2019-05-01 01:02,HHA,1797,737-800,18,3,25,3,3,22,,,,,7,4
2019-05-01 01:00,HAK,1373,737-800,25,4,84,4,4,28,,,,,59,3
2019-05-01 00:58,YIH,1348,737-800,17,4,27,5,4,24,,,,,10,7
2019-05-01 00:58,URC,1929,737-800,20,4,25,5,5,26,,,,,5,6
2019-05-01 00:56,PEK,5136,737-800,18,4,20,4,6,22,,,,,2,4
2019-05-01 00:54,HGH,5375,737-800,18,2,20,4,3,22,,,,,2,4
2019-05-01 00:54,XIY,5478,737-800,19,4,28,5,4,22,,,,,9,3
2019-05-01 00:52,DLC,5853,737-800,15,5,23,4,4,22,,,,,8,7
2019-05-01 00:52,KHG,1569,737-800,13,2,27,3,3,24,,,,,14,11
2019-05-01 00:52,HGH,5153,737-800,19,3,26,3,3,26,,,,,7,7
2019-05-01 00:50,HAK,7171,737-800,25,6,32,6,7,33,,,,,7,8
2019-05-01 00:49,XIY,1787,737-800,25,2,22,2,2,20,,,,,-3,-5
2019-05-01 00:46,DLC,7173,737-800,20,5,28,5,5,24,,,,,8,4
2019-05-01 00:45,DLC,7379,737-800,15,4,20,4,4,22,,,,,5,7
2019-05-01 00:44,DLC,1346,737-800,17,5,26,4,6,24,,,,,9,7
2019-05-01 00:43,DLC,1493,737-800,15,6,24,6,6,22,,,,,9,7
2019-05-01 00:43,HAK,1503,737-800,26,4,34,5,4,33,,,,,8,7
2019-05-01 00:42,URC,5502,737-800,22,4,24,6,6,23,,,,,2,1
2019-05-01 00:40,MIG,6809,737-800,23,4,25,4,4,24,,,,,2,1
2019-05-01 00:39,MIG,1586,737-800,23,4,27,4,4,27,,,,,4,4
2019-05-01 00:39,CAN,5687,737-800,23,5,0,4,4,28,,,,,-23,5
2019-05-01 00:31,CAN,5463,737-800,23,3,36,4,4,22,1,,,1,13,-1
2019-05-01 00:30,CGO,1785,737-800,20,4,26,8,8,25,,,,,6,5
2019-05-01 00:22,CKG,7616,737-800,21,4,25,4,4,25,,,,,4,4
2019-05-01 00:21,SZX,1492,737-800,25,4,32,3,3,30,,,,,7,5
2019-05-01 00:16,MIG,1798,737-800,23,5,27,6,6,25,,,,,4,2
2019-05-01 00:11,CAN,5579,737-800,20,6,24,6,6,26,,,,,4,6
2019-05-01 00:10,HGH,5798,737-800,20,3,24,3,3,22,,,,,4,2
2019-05-01 00:01,XIY,5137,737-800,20,6,14,4,4,20,,,,,-6,0
2019-04-30 23:50,HAK,206H,737-800,27,4,34,2,2,32,,,,,7,5
2019-04-30 23:49,XIY,6103,737-800,20,6,22,6,6,24,,,,,2,4
2019-04-30 23:48,ZGC,1729,737-800,13,3,21,5,4,16,,,,,8,3
2019-04-30 23:48,XIY,6103,737-800,20,6,22,6,6,24,,,,,2,4
2019-04-30 23:46,XIY,1213,737-800,19,6,29,6,6,26,,,,,10,7
2019-04-30 23:45,SZX,5372,737-800,27,8,29,8,7,31,,,,,2,4
2019-04-30 23:45,XIY,5346,737-800,20,6,22,6,6,26,,,,,2,6
2019-04-30 23:42,PEK,5538,737-800,19,3,30,3,3,28,,,,,11,9
2019-04-30 23:41,URC,1325,737-800,24,4,23,4,4,21,,,,,-1,-3
2019-04-30 23:27,HHA,5852,737-800,23,4,26,4,5,24,,,,,3,1
2019-04-30 23:23,HRB,1433,737-800,13,3,23,2,2,18,,,,,10,5
2019-04-30 23:22,DLC,7172,737-800,15,4,28,4,5,26,,,,,13,11
2019-04-30 23:21,CGO,205V,737-800,20,3,30,4,4,26,,,,,10,6
2019-04-30 23:15,PEK,5466,737-800,20,0,0,4,0,10,,,,,-20,-10
2019-04-30 23:11,SYX,1495,737-800,30,4,32,4,4,31,,,,,2,1
2019-04-30 23:06,SYX,5520,737-800,30,5,36,6,5,35,,,,,6,5
2019-04-30 23:05,CKG,5581,737-800,24,5,22,5,6,26,,,,,-2,2
2019-04-30 23:04,HRB,1351,737-800,10,4,18,3,4,17,,,,,8,7
2019-04-30 22:59,HAK,1502,737-800,27,2,34,4,4,32,,,,,7,5
2019-04-30 22:56,SZX,1103,737-800,27,4,35,4,4,31,,,,,8,4
2019-04-30 22:46,HAK,2158,737-800,27,6,30,4,4,28,,,,,3,1
2019-04-30 22:43,HGH,5135,737-800,20,3,25,3,3,26,,,,,5,6
2019-04-30 22:39,CAN,1141,737-800,25,6,32,5,6,29,,,,,7,4
2019-04-30 22:25,SYX,7618,737-800,29,6,33,6,5,32,,,,,4,3
2019-04-30 22:22,XNN,7175,737-800,12,5,21,7,5,20,,,,,9,8
2019-04-30 22:22,DLC,6063,737-800,16,4,22,3,3,24,,,,,6,8
2019-04-30 22:22,XNN,1786,737-800,12,4,20,4,4,20,,,,,8,8
2019-04-30 22:21,TYN,5429,737-800,15,4,22,4,4,22,,,,,7,7
2019-04-30 22:21,URC,1323,737-800,23,4,26,3,4,26,,,,,3,3
2019-04-30 22:20,PEK ,5138,737-800,22,4,21,4,4,30,,,,,-1,8
2019-04-30 22:11,CAN,1375,737-800,21,4,30,4,3,28,,,,,9,7
2019-04-30 22:11,HAK,1496,737-800,27,6,32,6,6,32,,,,,5,5
2019-04-30 22:10,CAN,1375,737-800,21,4,30,4,3,28,,,,,9,7
2019-04-30 22:07,HAK,7886,737-800,27,3,35,4,4,34,,,,,8,7
2019-04-30 21:58,DLC,1547,737-800,15,5,25,6,6,24,,,,,10,9
2019-04-30 21:32,CAN,1538,737-800,21,2,30,2,3,27,,,,,9,6
2019-04-30 21:03,PEK,7378,737-800,23,4,24,3,4,24,,,,,1,1
2019-04-30 20:54,MIG,5732,737-800,25,2,26,3,3,25,,,,,1,0
2019-04-30 20:44,CGO,1372,737-800,26,4,26,4,4,24,,,,,0,-2
2019-04-30 20:43,CGO,1327,737-800,26,4,26,4,4,24,,,,,0,-2
2019-04-30 20:14,HGH,5620,737-800,20,2,16,4,4,20,,,,,-4,0
2019-04-30 20:06,HHA,5405,737-800,20,4,30,4,4,26,,,,,10,6
2019-04-30 17:40,HRB,1350,737-800,20,4,22,4,4,20,,,,,2,0
2019-04-30 15:42,SZX,5522,737-800,24,6,37,6,7,27,,,,,13,3
2019-04-30 15:01,URC,7198,737-800,23,4,24,4,4,24,,,,,1,1
2019-04-30 14:57,TYN,5359,737-800,20,4,20,4,4,21,,,,,0,1
2019-04-30 12:55,ÐìÖÝ,6015,737-800,20,5,28,3,3,26,,,,,8,6
2019-04-30 11:32,SZX,5522,737-800,25,9,41,6,7,27,,,,,16,2
2019-04-30 09:35,XIY,1215,737-800,20,4,22,3,4,26,,,,,2,6
2019-04-30 08:15,PEK,1373,737-800,20,4,24,4,4,18,,,,,4,-2
2019-04-30 07:59,CKG,7616,737-800,20,3,26,3,3,26,,,,,6,6
2019-04-30 07:31,FOC,1480,737-800,24,5,25,4,4,25,,,,,1,1
2019-04-30 07:23,PEK,7400,737-800,17,5,26,4,4,22,,,,,9,5
2019-04-30 07:18,SZX,5522,737-800,26,5,33,6,8,34,,,,,7,8
2019-04-30 07:08,FOC,1480,737-800,24,5,25,4,4,25,,,,,1,1
2019-04-30 06:41,DLC,5466,737-800,13,2,0,7,1,18,,,,,-13,5
2019-04-30 06:20,XMN,5709,737-800,22,7,31,8,8,34,,,,,9,12
2019-04-30 06:19,XMN,1997,737-800,26,6,30,7,7,33,,,,,4,7
2019-04-30 06:19,HHA,5136,737-800,20,4,24,4,3,23,,,,,4,3
2019-04-30 06:18,XMN,5417,737-800,28,5,33,5,5,30,,,,,5,2
2019-04-30 06:18,XMN,1502,737-800,26,4,33,4,4,32,,,,,7,6
2019-04-30 06:17,XMN,1131,737-800,25,5,28,6,6,29,,,,,3,4
2019-04-30 06:08,URC,5371,737-800,17,5,20,6,6,22,,,,,3,5
2019-04-30 05:47,FOC,7113,737-800,24,5,30,6,5,28,,,,,6,4
2019-04-30 05:40,URC,5139,737-800,18,4,26,3,4,22,,,,,8,4
2019-04-30 05:33,CGO,7993,737-800,15,4,24,2,4,24,,,,,9,9
2019-04-30 05:30,FOC,5430,737-800,25,6,34,6,6,35,,1,,1,9,10
2019-04-30 05:25,SYX,7379,737-800,28,4,34,4,5,34,,,,,6,6
2019-04-30 05:22,HHA,5735,737-800,15,0,19,2,2,19,,,,,4,4
2019-04-30 05:20,HHA,5735,737-800,15,0,19,2,2,20,,,,,4,5
2019-04-30 05:11,KMG,5449,737-800,15,2,22,3,3,23,,,,,7,8
2019-04-30 05:06,HGH,5798,737-800,15,3,22,2,3,23,,,,,7,8
2019-04-30 04:50,URC,1725,737-800,16,4,28,5,5,28,,,,,12,12
2019-04-30 04:39,KMG,7991,737-800,16,6,24,7,7,23,,,,,8,7
2019-04-30 04:34,CTU,7989,737-800,20,6,29,6,6,29,,,,,9,9
2019-04-30 04:29,URC,5797,737-800,15,2,20,2,3,20,,,,,5,5
2019-04-30 04:29,CAN,5465,737-800,25,3,28,4,4,30,,,,,3,5
2019-04-30 04:17,URC,6268,737-800,16,4,26,5,5,26,,,,,10,10
2019-04-30 04:16,KMG,7988,737-800,20,5,26,6,5,26,,,,,6,6
2019-04-30 04:13,FOC,7398,737-800,26,4,30,4,4,28,,,,,4,2
2019-04-30 04:06,HGH,7171,737-800,17,3,21,4,3,22,,,,,4,5
2019-04-30 04:06,XIY,1902,737-800,21,5,28,5,5,22,,,,,7,1
2019-04-30 04:04,Î÷°²,5115,737-800,18,4,16,6,6,20,,,,,-2,2
2019-04-30 04:04,HGH,1491,737-800,16,5,19,4,3,19,,,,,3,3
2019-04-30 04:00,CAN,1549,737-800,26,6,28,6,4,30,,,,,2,4
2019-04-30 04:00,CAN,5358,737-800,26,9,34,8,8,32,,,,,8,6
2019-04-30 03:57,HAK,5483,737-800,26,3,31,5,5,33,,,,,5,7
2019-04-30 03:56,HAK,206H,737-800,27,5,31,6,5,32,,,,,4,5
2019-04-30 03:54,HGH,5375,737-800,16,0,19,3,3,21,,,,,3,5
2019-04-30 03:48,SYX,1347,737-800,27,4,34,4,4,32,,,,,7,5
2019-04-30 03:44,FOC,1350,737-800,25,4,30,4,4,30,,,,,5,5
2019-04-30 03:43,FOC,7113,737-800,31,6,34,7,7,32,,,,,3,1
2019-04-30 03:43,CGO,1587,737-800,17,2,24,4,2,24,,,,,7,7
2019-04-30 03:42,PEK,5539,737-800,17,5,24,5,5,25,,,,,7,8
2019-04-30 03:41,SZX,5522,737-800,26,5,33,26,25,34,,,,,7,8
2019-04-30 03:39,PEK,5338,737-800,20,4,32,3,3,29,,,,,12,9
2019-04-30 03:39,HAK,6808,737-800,28,4,31,6,4,30,,,,,3,2
2019-04-30 03:31,XIY,1162,737-800,18,3,24,2,2,22,,,,,6,4
2019-04-30 03:27,HAK,5373,737-800,26,6,30,8,8,30,,,,,4,4
2019-04-30 03:24,KMG,1208,737-800,19,3,23,4,4,22,,,,,4,3
2019-04-30 03:22,URC,5797,737-800,15,3,20,2,3,21,,,,,5,6
2019-04-30 03:20,SZX,6061,737-800,27,5,32,5,4,30,,,,,5,3
2019-04-30 03:19,KMG,7167,737-800,20,7,26,6,6,24,,,,,6,4
2019-04-30 03:15,SZX,1492,737-800,27,4,32,2,2,30,,,,,5,3
2019-04-30 03:15,KMG,1588,737-800,20,4,24,4,5,21,,,,,4,1
2019-04-30 03:07,XIY,1481,737-800,18,6,27,6,6,26,,,,,9,8
2019-04-30 03:05,XIY,5180,737-800,18,6,26,6,6,26,,,,,8,8
2019-04-30 02:59,HAK,5137,737-800,26,2,22,2,2,30,,,,,-4,4
2019-04-30 02:57,URC,1325,737-800,17,4,26,4,4,21,,,,,9,4
2019-04-30 02:57,HGH,5620,737-800,20,2,26,2,2,24,,,,,6,4
2019-04-30 02:55,PEK,5580,737-800,14,5,26,6,6,26,,,,,12,12
2019-04-30 02:55,KMG,7990,737-800,20,2,26,5,3,24,,,,,6,4
2019-04-30 02:50,URC,2157,737-800,15,6,30,6,6,26,,,,,15,11
2019-04-30 02:48,SYX,1785,737-800,28,1,30,5,6,30,,,,,2,2
2019-04-30 02:43,URC,1569,737-800,17,2,23,1,2,21,,,,,6,4
2019-04-30 02:41,HAK,1795,737-800,25,5,31,5,5,30,,,,,6,5
2019-04-30 02:38,CAN,7377,737-800,26,6,32,6,5,32,,,,,6,6
2019-04-30 02:36,HGH,5439,737-800,16,5,22,3,4,21,,,,,6,5
2019-04-30 02:34,SYX ,1542,737-800,30,4,33,4,4,30,,,,,3,0
2019-04-30 02:30,XIY,6103,737-800,20,6,25,6,6,26,,,,,5,6
2019-04-30 02:27,URC,1570,737-800,19,5,22,5,5,20,,,,,3,1
2019-04-30 02:27,CAN,1141,737-800,26,6,32,6,6,30,,,,,6,4
2019-04-30 02:25,HAK,1793,737-800,27,4,34,4,4,29,,,,,7,2
2019-04-30 02:21,HAK,5713,737-800,28,5,30,6,6,30,,,,,2,2
2019-04-30 02:19,SZX,5429,737-800,27,3,30,4,3,30,,,,,3,3
2019-04-30 02:17,HHA,1487,737-800,20,2,22,3,3,21,,,,,2,1
2019-04-30 02:16,HAK,1786,737-800,25,6,30,6,6,30,,,,,5,5
2019-04-30 02:13,URC,1726,737-800,17,4,24,4,4,20,,,,,7,3
2019-04-30 02:12,SYX,5520,737-800,27,6,35,6,5,34,,,,,8,7
2019-04-30 02:11,PEK,5416,737-800,20,7,25,8,8,26,,,,,5,6
2019-04-30 02:07,HAK,5521,737-800,25,5,30,0,0,27,,,,,5,2
2019-04-30 02:06,URC,5502,737-800,17,3,21,3,2,22,,,,,4,5
2019-04-30 01:59,FOC,1906,737-800,26,6,34,6,6,31,,,,,8,5
2019-04-30 01:58,DLC,5466,737-800,13,2,0,7,1,18,,,,,-13,5
2019-04-30 01:57,XIY,5116,737-800,20,2,20,2,3,23,,,,,0,3
2019-04-30 01:57,XIY,5503,737-800,20,3,24,4,3,25,,,,,4,5
2019-04-30 01:57,SYX,7618,737-800,28,5,32,6,6,31,,,,,4,3
2019-04-30 01:55,FOC,7398,737-800,24,4,31,4,4,28,,,,,7,4
2019-04-30 01:54,XIY,1483,737-800,20,4,25,3,3,26,,,,,5,6
2019-04-30 01:50,HHA,7886,737-800,14,4,24,2,2,25,,,,,10,11
2019-04-30 01:50,XIY,5418,737-800,19,3,20,4,2,22,,,,,1,3
2019-04-30 01:50,HHA,1797,737-800,15,4,24,3,3,24,,,,,9,9
2019-04-30 01:47,URC,6995,737-800,20,4,23,3,4,21,,,,,3,1
2019-04-30 01:47,CAN,1489,737-800,26,3,29,3,3,29,,,,,3,3
2019-04-30 01:45,ZGC,5686,737-800,5,4,18,2,2,18,,,,,13,13
2019-04-30 01:45,SYX,1799,737-800,29,2,32,4,4,32,,,,,3,3
2019-04-30 01:43,HAK,1927,737-800,27,3,30,4,3,31,,,,,3,4
2019-04-30 01:43,YIH,1435,737-800,24,5,23,7,6,25,,,,,-1,1
2019-04-30 01:42,HGH,1727,737-800,15,3,24,4,4,24,,,,,9,9
2019-04-30 01:41,PEK,5625,737-800,19,4,24,6,6,28,,,,,5,9
2019-04-30 01:41,URC,1101,737-800,15,3,26,2,2,23,,,,,11,8
2019-04-30 01:41,CAN,1495,737-800,26,3,33,4,4,31,,,,,7,5
2019-04-30 01:41,XIY,1372,737-800,19,4,18,4,4,22,,,,,-1,3
2019-04-30 01:39,HAK,1735,737-800,31,4,32,5,5,26,,,,,1,-5
2019-04-30 01:36,CAN,1538,737-800,26,3,31,4,3,30,,,,,5,4
2019-04-30 01:36,DLC,6063,737-800,15,4,22,4,3,23,,,,,7,8
2019-04-30 01:35,MIG,1798,737-800,24,7,28,6,6,25,,,,,4,1
2019-04-30 01:35,HAK,5687,737-800,29,5,0,5,5,32,,,,,-29,3
2019-04-30 01:34,FOC,1480,737-800,27,5,26,4,4,25,,,,,-1,-2
2019-04-30 01:33,DLC,1213,737-800,14,4,26,6,6,25,,,,,12,11
2019-04-30 01:32,HAK,5855,737-800,27,7,29,7,6,28,,,,,2,1
2019-04-30 01:31,HGH,5623,737-800,20,6,28,5,4,25,,,,,8,5
2019-04-30 01:25,SYX,5338,737-800,28,4,30,4,4,31,,,,,2,3
2019-04-30 01:24,XIY,1163,737-800,18,4,24,3,3,26,,,,,6,8
2019-04-30 01:19,SZX,5540,737-800,27,4,36,3,4,30,,,,,9,3
2019-04-30 01:15,URC,1322,737-800,18,4,24,4,4,23,,,,,6,5
2019-04-30 01:13,PEK,5482,737-800,16,2,24,4,4,24,,,,,8,8
2019-04-30 01:11,CKG,5581,737-800,20,4,21,4,6,25,,,,,1,5
2019-04-30 01:11,HAK,2158,737-800,25,7,28,5,5,28,,,,,3,3
2019-04-30 01:11,CGO,5409,737-800,16,4,24,4,4,26,,,,,8,10
2019-04-30 01:10,URC,1568,737-800,19,2,23,2,2,22,,,,,4,3
2019-04-30 01:08,FOC,1562,737-800,27,5,32,5,5,32,,,,,5,5
2019-04-30 01:07,URC,1130,737-800,19,2,27,2,2,23,,,,,8,4
2019-04-30 01:07,SZX,7399,737-800,25,3,31,3,4,32,,,,,6,7
2019-04-30 01:06,FOC,1562,737-800,27,5,27,5,5,32,,,,,0,5
2019-04-30 01:05,CKG,5581,737-800,20,4,21,4,6,25,,,,,1,5
2019-04-30 01:03,URC,1995,737-800,19,5,25,5,7,24,,,,,6,5
2019-04-30 01:02,HAK,1386,737-800,27,6,29,6,8,22,,,,,2,-5
2019-04-30 01:00,HHA,5852,737-800,20,5,24,5,4,23,,,,,4,3
2019-04-30 00:58,SYX,206G,737-800,28,4,35,4,4,31,,,,,7,3
2019-04-30 00:57,TYN,5359,737-800,19,0,10,4,4,20,,,,,-9,1
2019-04-30 00:57,CAN,1503,737-800,26,3,24,4,3,31,,,,,-2,5
2019-04-30 00:56,SYX,6062,737-800,28,4,34,4,3,34,,,,,6,6
2019-04-30 00:56,KMG,1209,737-800,20,4,26,9,9,18,,,,,6,-2
2019-04-30 00:55,TYN,5090,737-800,21,1,20,2,3,21,,,,,-1,0
2019-04-30 00:52,DLC,1346,737-800,14,6,26,5,6,22,,,,,12,8
2019-04-30 00:45,YIH,1348,737-800,22,4,28,4,3,24,,,,,6,2
2019-04-30 00:43,PEK,1929,737-800,15,4,25,4,4,25,,,,,10,10
2019-04-30 00:37,PEK,6066,737-800,18,3,25,4,4,15,,,,,7,-3
2019-04-30 00:37,XIY,5478,737-800,23,4,28,4,4,25,,,,,5,2
2019-04-30 00:35,CGO,7992,737-800,18,4,26,4,4,26,,,,,8,8
2019-04-30 00:32,XIY,1497,737-800,20,3,25,4,3,24,,,,,5,4
2019-04-30 00:30,HRB,1559,737-800,11,3,23,2,3,22,,,,,12,11
2019-04-30 00:28,KHG,206P,737-800,13,4,26,4,4,22,,,,,13,9
2019-04-30 00:20,SZX,5462,737-800,27,3,32,5,4,34,,,,,5,7
2019-04-30 00:17,XIY,1501,737-800,23,4,28,4,4,25,,,,,5,2
2019-04-30 00:17,URC,5638,737-800,18,4,25,3,4,22,,,,,7,4
2019-04-30 00:16,CAN,5463,737-800,25,5,30,5,5,28,,,,,5,3
2019-04-30 00:13,XIY,5853,737-800,15,4,23,4,5,26,,,,,8,11
2019-04-30 00:10,URC,1496,737-800,20,4,24,4,5,25,,,,,4,5
2019-04-30 00:10,HAK,5733,737-800,29,7,33,7,6,34,,,,,4,5
2019-04-30 00:09,DLC,1547,737-800,15,4,22,4,5,22,,,,,7,7
2019-04-30 00:08,HAK,5479,737-800,27,5,28,6,6,32,,,,,1,5
2019-04-30 00:08,SZX,6065,737-800,28,4,36,4,5,34,,,,,8,6
2019-04-30 00:07,URC,205V,737-800,15,4,28,4,4,26,,,,,13,11
2019-04-30 00:05,TYN,7639,737-800,20,4,24,5,6,24,,,,,4,4
2019-04-30 00:05,URC,7198,737-800,19,4,24,4,5,24,,,,,5,5
2019-04-30 00:03,MIG,5732,737-800,25,4,27,3,3,25,,,,,2,0
2019-04-29 23:59,CGO,5428,737-800,17,5,22,6,6,29,,,,,5,12
2019-04-29 23:57,MIG,6809,737-800,25,4,26,4,4,25,,,,,1,0
2019-04-29 23:57,MIG,5407,737-800,25,6,28,5,5,27,,,,,3,2
2019-04-29 23:54,HAK,1784,737-800,28,4,28,4,4,34,,,,,0,6
2019-04-29 23:50,CGO,5579,737-800,17,6,28,6,6,26,,,,,11,9
2019-04-29 23:49,Z?G?C,5408,737-800,6,8,22,7,8,28,,,,,16,22
2019-04-29 23:46,URC,205T,737-800,17,2,24,3,3,25,,,,,7,8
2019-04-29 23:43,HAK,1586,737-800,28,4,33,5,4,32,,,,,5,4
2019-04-29 23:43,PEK,7172,737-800,18,4,28,4,4,26,,,,,10,8
2019-04-29 23:37,HRB,7395,737-800,20,6,30,6,6,26,,,,,10,6
2019-04-29 23:36,KMG,6016,737-800,19,4,27,4,4,24,,,,,8,5
2019-04-29 23:35,CGO,205U,737-800,17,4,27,3,3,25,,,,,10,8
2019-04-29 23:34,XIY,5346,737-800,21,5,24,5,5,24,,,,,3,3
2019-04-29 23:33,DLC,1493,737-800,15,6,23,4,5,20,,,,,8,5
2019-04-29 23:28,DLC,1928,737-800,14,4,21,6,5,20,,,,,7,6
2019-04-29 23:26,HAK,1996,737-800,26,5,26,9,8,23,,,,,0,-3
2019-04-29 23:11,URC,1102,737-800,20,4,25,4,4,24,,,,,5,4
2019-04-29 23:09,CKG,5135,737-800,20,2,28,2,2,26,,,,,8,6
2019-04-29 23:09,HHA,5405,737-800,20,4,28,4,4,26,,,,,8,6
2019-04-29 23:07,PEK,5662,737-800,18,3,25,3,6,25,,,,,7,7
2019-04-29 22:55,SYX,1545,737-800,29,4,34,5,4,32,,,,,5,3
2019-04-29 22:36,HAK,7378,737-800,27,6,29,6,6,30,,,,,2,3
2019-04-29 22:29,PEK,5138,737-800,18,4,24,4,4,26,,,,,6,8
2019-04-29 22:19,URC,1323,737-800,20,2,18,2,2,23,,,,,-2,3
2019-04-29 22:19,XNN,1498,737-800,8,6,22,6,6,21,,,,,14,13
2019-04-29 22:15,FOC,5182,737-800,25,4,29,4,4,30,,,,,4,5
2019-04-29 22:12,PEK,5467,737-800,19,6,30,6,8,28,,,,,11,9
2019-04-29 22:10,ZGC,1541,737-800,10,5,21,6,4,23,,,,,11,13
2019-04-29 22:10,HAK,206F,737-800,29,3,24,4,4,29,,,,,-5,0
2019-04-29 22:09,HAK,1103,737-800,28,4,34,4,4,32,,,,,6,4
2019-04-29 22:06,HAK,1733,737-800,28,3,30,3,3,32,,,,,2,4
2019-04-29 22:05,FOC,5430,737-800,25,6,34,6,6,35,,,,,9,10
2019-04-29 21:49,TYN,1488,737-800,21,6,26,6,6,24,,,,,5,3
2019-04-29 21:47,HAK,1787,737-800,28,1,33,1,2,29,,,,,5,1
2019-04-29 21:46,HGH,5481,737-800,20,4,24,4,4,22,,,,,4,2
2019-04-29 21:45,XIY,7175,737-800,8,4,21,5,5,19,,,,,13,11
2019-04-29 20:46,CAN,1375,737-800,26,4,33,5,4,29,,,,,7,3
2019-04-29 20:40,CAN,5637,737-800,24,2,36,2,2,33,1,,,1,12,9
2019-04-29 20:40,HAK,5089,737-800,29,6,18,1,1,32,,,,,-11,3
2019-04-29 20:28,DLC,7173,737-800,13,4,26,5,5,22,,,,,13,9
2019-04-29 19:50,HRB,1905,737-800,21,3,22,3,4,20,,,,,1,-1
2019-04-29 19:41,XIY,5115,737-800,25,3,17,6,6,27,,,,,-8,2
2019-04-29 19:21,SZX,5372,737-800,25,8,30,9,9,24,,,,,5,-1
2019-04-29 18:38,SZX,5855,737-800,28,6,30,7,7,26,,,,,2,-2
2019-04-29 17:30,XUZ,6015,737-800,20,4,28,4,4,24,,,,,8,4
2019-04-29 17:02,CGO,1728,737-800,25,4,22,3,4,23,,,,,-3,-2
2019-04-29 15:35,CGO,1728,737-800,25,4,24,4,4,23,,,,,-1,-2
2019-04-29 14:37,PEK,6060,737-800,25,8,28,6,6,25,,,,,3,0
2019-04-29 10:28,XIY,1903,737-800,18,2,18,6,6,14,,,,,0,-4
2019-04-29 10:08,HAK,5483,737-800,28,4,30,4,5,30,,,,,2,2
2019-04-29 08:53,PEK,1490,737-800,17,5,25,4,5,25,,,,,8,8
2019-04-29 08:48,XIY,5359,737-800,15,5,25,5,4,25,,,,,10,10
2019-04-29 08:36,XIY,,737-800,25,6,26,6,6,22,,,,,1,-3
2019-04-29 08:36,XIY,1481,737-800,25,6,26,6,6,22,,,,,1,-3
2019-04-29 07:53,KMG,5409,737-800,17,4,24,4,4,26,,,,,7,9
2019-04-29 07:52,KMG,1588,737-800,20,4,24,5,4,23,,,,,4,3
2019-04-29 07:51,KMG,7990,737-800,20,3,23,3,3,23,,,,,3,3
2019-04-29 07:19,XMN,5712,737-800,15,3,20,2,7,20,,,,,5,5
2019-04-29 07:19,XMN,5417,737-800,24,5,27,4,4,28,,,,,3,4
2019-04-29 07:18,XMN,5686,737-800,24,7,31,5,5,28,,,,,7,4
2019-04-29 07:17,XMN,1502,737-800,24,2,28,9,3,28,,,,,4,4
2019-04-29 07:16,XMN,1131,737-800,24,2,30,5,4,32,,,,,6,8
2019-04-29 06:59,Î÷°²,1162,737-800,11,2,26,3,3,20,,,,,15,9
2019-04-29 06:57,XIY,5406,737-800,15,3,20,6,4,20,,,,,5,5
2019-04-29 06:39,PEK,7400,737-800,15,5,24,5,5,22,,,,,9,7
2019-04-29 06:00,XIY,5430,737-800,15,5,24,3,4,23,,,,,9,8
2019-04-29 05:57,PEK,5538,737-800,14,3,30,3,3,27,,,,,16,13
2019-04-29 05:45,URC,1496,737-800,14,4,20,2,4,18,,,,,6,4
2019-04-29 05:30,CKG,7616,737-800,21,4,23,4,4,25,,,,,2,4
2019-04-29 05:14,PEK,1547,737-800,15,7,24,6,8,26,,,,,9,11
2019-04-29 05:00,XIY ,7105 ,737-800,10,6,24,4,4,25,,,,,14,15
2019-04-29 04:59,HGH,5375,737-800,20,2,20,3,3,22,,,,,0,2
2019-04-29 04:40,HAK,5522,737-800,28,7,37,8,7,36,1,,,1,9,8
2019-04-29 04:37,SYX,1542,737-800,27,4,35,3,4,31,,,,,8,4
2019-04-29 04:30,HGH,5623,737-800,20,6,30,8,8,20,,,,,10,0
2019-04-29 04:25,º£¿Ú,5581,737-800,28,8,28,6,6,34,,,,,0,6
2019-04-29 04:17,URC,5797,737-800,20,3,18,4,4,20,,,,,-2,0
2019-04-29 04:16,ZGC,7378,737-800,15,6,24,7,5,25,,,,,9,10
2019-04-29 04:16,URC,5416,737-800,17,8,26,8,8,26,,,,,9,9
2019-04-29 04:16,URC,2157,737-800,20,2,24,4,5,24,,,,,4,4
2019-04-29 04:10,ZGC,5408,737-800,14,4,20,4,3,17,,,,,6,3
2019-04-29 04:08,ZGC,5338,737-800,15,6,24,5,7,23,,,,,9,8
2019-04-29 04:05,CGO,2158,737-800,14,3,20,3,3,20,,,,,6,6
2019-04-29 03:59,URC,1997,737-800,15,4,22,3,3,20,,,,,7,5
2019-04-29 03:56,HGH,1386,737-800,19,3,26,2,3,22,,,,,7,3
2019-04-29 03:53,KMG,7993,737-800,18,6,26,8,8,22,,,,,8,4
2019-04-29 03:49,FOC,6066,737-800,20,3,26,2,2,25,,,,,6,5
2019-04-29 03:45,SYX,5579,737-800,29,5,34,5,5,32,,,,,5,3
2019-04-29 03:45,FOC,6066,737-800,20,4,28,3,3,26,,,,,8,6
2019-04-29 03:41,FOC,6066,737-800,20,4,28,3,3,26,,,,,8,6
2019-04-29 03:38,KMG,1587,737-800,20,3,25,4,6,23,,,,,5,3
2019-04-29 03:37,KMG,1208,737-800,20,3,24,4,4,22,,,,,4,2
2019-04-29 03:28,SZX,1492,737-800,26,3,28,3,3,30,,,,,2,4
2019-04-29 03:27,XIY,5478,737-800,10,2,26,4,4,28,,,,,16,18
2019-04-29 03:25,CGO,7167,737-800,13,3,23,4,3,21,,,,,10,8
2019-04-29 03:19,ZUH,1501,737-800,26,4,32,4,4,32,,,,,6,6
2019-04-29 03:14,SYX,1545,737-800,30,5,34,5,5,32,,,,,4,2
2019-04-29 03:10,KMG,6015,737-800,18,4,24,3,3,22,,,,,6,4
2019-04-29 03:05,URC,6268,737-800,15,4,26,4,4,18,,,,,11,3
2019-04-29 03:04,SYX,5713,737-800,25,7,30,5,5,30,,,,,5,5
2019-04-29 03:03,HAK,7639,737-800,27,4,35,8,8,30,,,,,8,3
2019-04-29 03:01,HHA,1505,737-800,14,3,24,4,4,23,,,,,10,9
2019-04-29 02:58,HGH,5709,737-800,30,7,27,7,7,26,,,,,-3,-4
2019-04-29 02:58,URC,1570,737-800,17,5,21,5,4,19,,,,,4,2
2019-04-29 02:57,URC,205V,737-800,15,6,30,3,4,23,,,,,15,8
2019-04-29 02:57,FOC,1350,737-800,20,4,30,4,4,25,,,,,10,5
2019-04-29 02:57,ÃàÑô,1798,737-800,24,6,26,5,5,24,,,,,2,0
2019-04-29 02:57,XIY,5116,737-800,20,4,19,4,4,18,,,,,-1,-2
2019-04-29 02:56,URC,6268,737-800,15,4,26,4,4,18,,,,,11,3
2019-04-29 02:55,TYN,7399,737-800,15,4,22,5,4,22,,,,,7,7
2019-04-29 02:54,HGH,5481,737-800,20,5,27,5,4,25,,,,,7,5
2019-04-29 02:54,HHA,5136,737-800,20,4,22,4,4,24,,,,,2,4
2019-04-29 02:50,DLC,1493,737-800,14,5,23,5,4,20,,,,,9,6
2019-04-29 02:49,DLC,1785,737-800,13,4,26,6,6,26,,,,,13,13
2019-04-29 02:47,CAN,5137,737-800,26,3,23,3,2,30,,,,,-3,4
2019-04-29 02:46,HAK,1787,737-800,27,1,30,2,2,30,,,,,3,3
2019-04-29 02:43,HAK,1488,737-800,28,6,34,6,5,30,,,,,6,2
2019-04-29 02:43,URC,1325,737-800,15,2,22,4,4,20,,,,,7,5
2019-04-29 02:41,CAN,1538,737-800,26,3,33,5,3,30,,,,,7,4
2019-04-29 02:40,FOC,5503,737-800,20,3,26,3,3,25,,,,,6,5
2019-04-29 02:39,FOC,5503,737-800,23,4,28,4,3,25,,,,,5,2
2019-04-29 02:38,FOC,5503,737-800,23,4,28,3,4,25,,,,,5,2
2019-04-29 02:36,XIY,5406,737-800,15,3,20,6,4,20,,,,,5,5
2019-04-29 02:34,ZGC,5408,737-800,14,4,20,4,3,18,,,,,6,4
2019-04-29 02:28,URC,1569,737-800,20,2,28,2,2,24,,,,,8,4
2019-04-29 02:28,URC,1569,737-800,20,2,28,2,2,24,,,,,8,4
2019-04-29 02:26,HAK,5661,737-800,27,4,31,5,4,34,,,,,4,7
2019-04-29 02:24,HAK,7171,737-800,27,4,36,4,4,31,,,,,9,4
2019-04-29 02:24,URC,7198,737-800,17,4,24,4,4,20,,,,,7,3
2019-04-29 02:21,HAK,1795,737-800,30,4,32,4,4,32,,,,,2,2
2019-04-29 02:20,URC,1322,737-800,17,3,22,2,3,22,,,,,5,5
2019-04-29 02:19,103,5539,737-800,17,3,22,3,3,24,,,,,5,7
2019-04-29 02:14,XIY,1902,737-800,10,4,23,4,5,22,,,,,13,12
2019-04-29 02:14,SYX,206G,737-800,28,4,35,4,4,32,,,,,7,4
2019-04-29 02:14,URC,205T,737-800,18,4,22,4,3,23,,,,,4,5
2019-04-29 02:12,CAN,1375,737-800,25,4,30,4,3,28,,,,,5,3
2019-04-29 02:12,HHA ,5465,737-800,16,2,22,2,3,24,,,,,6,8
2019-04-29 02:11,CAN,5405,737-800,26,5,34,5,5,34,,,,,8,8
2019-04-29 02:10,URC,5371,737-800,16,8,17,5,6,20,,,,,1,4
2019-04-29 02:09,SYX,1347,737-800,25,6,26,5,4,30,,,,,1,5
2019-04-29 02:07,SYX,7379,737-800,28,6,36,6,6,36,,,,,8,8
2019-04-29 02:04,PEK,5153,737-800,12,4,24,4,4,24,,,,,12,12
2019-04-29 02:03,PEK,5139,737-800,17,4,25,7,4,25,,,,,8,8
2019-04-29 02:02,URC,1101,737-800,17,3,29,3,3,23,,,,,12,6
2019-04-29 02:02,FOC,7113,737-800,22,5,20,5,4,24,,,,,-2,2
2019-04-29 02:01,HHA,1729,737-800,14,4,18,4,4,21,,,,,4,7
2019-04-29 01:58,PEK,7398,737-800,20,4,25,3,3,22,,,,,5,2
2019-04-29 01:57,HHA,1797,737-800,15,3,25,4,4,20,,,,,10,5
2019-04-29 01:56,KMG ,1586,737-800,18,3,27,5,4,24,,,,,9,6
2019-04-29 01:52,XIY,1163,737-800,10,3,26,2,2,24,,,,,16,14
2019-04-29 01:47,URC,5797,737-800,15,6,19,5,7,20,,,,,4,5
2019-04-29 01:44,YIH,1348,737-800,12,4,24,5,4,22,,,,,12,10
2019-04-29 01:44,TYN,206F,737-800,15,4,20,3,2,21,,,,,5,6
2019-04-29 01:44,YIH,1435,737-800,12,6,24,5,6,24,,,,,12,12
2019-04-29 01:43,URC,1322,737-800,17,3,22,2,3,32,,,,,5,15
2019-04-29 01:42,KMG,1209,737-800,19,4,26,3,4,25,,,,,7,6
2019-04-29 01:39,CAN,1733,737-800,25,3,29,3,3,25,,,,,4,0
2019-04-29 01:30,PEK,5482,737-800,20,4,22,5,4,22,,,,,2,2
2019-04-29 01:28,CGO,7988,737-800,20,4,25,4,3,20,,,,,5,0
2019-04-29 01:27,HGH,5439,737-800,20,4,23,3,3,24,,,,,3,4
2019-04-29 01:26,TYN,1213,737-800,17,7,22,6,6,24,,,,,5,7
2019-04-29 01:24,PEK,5735,737-800,22,2,16,0,0,20,,,,,-6,-2
2019-04-29 01:23,XIY,1483,737-800,10,5,20,6,6,22,,,,,10,12
2019-04-29 01:13,ÃàÑô,5732,737-800,23,3,25,3,3,23,,,,,2,0
2019-04-29 01:07,DLC,1215,737-800,14,3,26,4,4,22,,,,,12,8
2019-04-29 01:05,PEK,1373,737-800,16,4,23,4,4,28,,,,,7,12
2019-04-29 01:00,HGH,1928,737-800,20,5,20,5,5,22,,,,,0,2
2019-04-29 00:59,XIY,5418,737-800,10,0,14,4,4,20,,,,,4,10
2019-04-29 00:58,FOC,1562,737-800,23,4,28,5,4,29,,,,,5,6
2019-04-29 00:56,HAK,5428,737-800,25,5,30,5,5,28,,,,,5,3
2019-04-29 00:53,HGH,5798,737-800,30,4,24,4,3,22,,,,,-6,-8
2019-04-29 00:53,XIY,5180,737-800,10,6,23,8,8,23,,,,,13,13
2019-04-29 00:48,SYX,6062,737-800,29,4,34,4,4,34,,,,,5,5
2019-04-29 00:47,HAK,5373,737-800,27,6,30,9,9,34,,,,,3,7
2019-04-29 00:41,HAK,1995,737-800,30,6,34,4,4,30,,,,,4,0
2019-04-29 00:41,ÒË²ý,1482,737-800,15,6,13,6,6,16,,,,,-2,1
2019-04-29 00:36,URC,2157,737-800,15,4,24,4,4,24,,,,,9,9
2019-04-29 00:36,DLC,1785,737-800,13,4,26,6,6,26,,,,,13,13
2019-04-29 00:34,HRB,1559,737-800,13,3,24,3,3,24,,,,,11,11
2019-04-29 00:32,URC,5502,737-800,17,4,20,9,8,20,,,,,3,3
2019-04-29 00:32,SZX,6061,737-800,26,1,24,5,5,28,,,,,-2,2
2019-04-29 00:31,CGO,7992,737-800,12,6,25,5,5,22,,,,,13,10
2019-04-29 00:31,URC,1726,737-800,15,4,24,4,4,20,,,,,9,5
2019-04-29 00:29,URC,5358,737-800,17,6,20,6,6,24,,,,,3,7
2019-04-29 00:24,XIY,7173,737-800,10,4,26,4,5,22,,,,,16,12
2019-04-29 00:24,HAK,5636,737-800,27,6,36,5,6,33,,,,,9,6
2019-04-29 00:23,URC,5638,737-800,15,4,23,4,4,24,,,,,8,9
2019-04-29 00:23,PEK,5852,737-800,13,4,22,4,4,24,,,,,9,11
2019-04-29 00:19,CGO,2159,737-800,13,21,3,20,3,3,,,,,-10,-10
2019-04-29 00:16,CKG,1541,737-800,19,4,26,4,5,25,,,,,7,6
2019-04-29 00:16,HAJ,5429,737-800,30,4,32,4,4,32,,,,,2,2
2019-04-29 00:09,URC,1725,737-800,20,4,26,4,4,28,,,,,6,8
2019-04-29 00:08,TYN,5090,737-800,15,2,20,2,2,18,,,,,5,3
2019-04-29 00:05,SZX,1786,737-800,26,4,34,4,5,34,,,,,8,8
2019-04-28 23:58,HAK,1489,737-800,28,4,32,4,4,31,,,,,4,3
2019-04-28 23:58,URC,1568,737-800,15,7,25,7,6,20,,,,,10,5
2019-04-28 23:57,XIY,1495,737-800,12,6,28,6,5,30,,,,,16,18
2019-04-28 23:56,HAK,5520,737-800,28,5,36,6,6,35,,,,,8,7
2019-04-28 23:54,105,6060,737-800,17,4,25,4,3,22,,,,,8,5
2019-04-28 23:51,HAK,1793,737-800,28,5,36,6,4,30,,,,,8,2
2019-04-28 23:47,CAN,1487,737-800,27,4,31,4,4,32,,,,,4,5
2019-04-28 23:47,HRB,7395,737-800,21,4,27,4,5,26,,,,,6,5
2019-04-28 23:47,KMG,6809,737-800,20,4,24,6,6,24,,,,,4,4
2019-04-28 23:46,HAK,5089,737-800,25,5,19,5,5,30,,,,,-6,5
2019-04-28 23:43,HHA,1996,737-800,14,5,22,5,5,24,,,,,8,10
2019-04-28 23:40,PEK,1491,737-800,16,5,25,4,4,26,,,,,9,10
2019-04-28 23:38,XIY,6103,737-800,15,6,22,6,6,22,,,,,7,7
2019-04-28 23:34,URC,1130,737-800,15,2,26,2,2,22,,,,,11,7
2019-04-28 23:33,MIG,5407,737-800,23,3,25,5,4,25,,,,,2,2
2019-04-28 23:30,CGO,205U,737-800,12,4,25,4,4,22,,,,,13,10
2019-04-28 23:21,DLC,5662,737-800,13,4,20,4,6,24,,,,,7,11
2019-04-28 23:18,XIY,1929,737-800,10,4,22,4,4,22,,,,,12,12
2019-04-28 23:17,DLC,5853,737-800,12,4,26,4,4,20,,,,,14,8
2019-04-28 23:17,HAK,5141,737-800,28,7,34,7,7,34,,,,,6,6
2019-04-28 23:08,HHA,1487,737-800,14,2,24,2,2,21,,,,,10,7
2019-04-28 23:05,SYX,1799,737-800,30,4,34,6,6,32,,,,,4,2
2019-04-28 23:05,SZX,5372,737-800,26,8,32,8,8,32,,,,,6,6
2019-04-28 23:03,SZX,5540,737-800,27,5,26,4,4,29,,,,,-1,2
2019-04-28 23:03,SZX,5540,737-800,27,5,26,4,4,29,,,,,-1,2
2019-04-28 23:02,DLC,5662,737-800,13,4,26,4,6,24,,,,,13,11
2019-04-28 22:50,HAK,5637,737-800,27,3,32,6,4,31,,,,,5,4
2019-04-28 22:48,HAK,6016,737-800,28,5,36,4,4,34,,,,,8,6
2019-04-28 22:46,SYX,7618,737-800,25,7,33,7,8,30,,,,,8,5
2019-04-28 22:39,CKG,5135,737-800,21,3,27,3,3,27,,,,,6,6
2019-04-28 22:32,SYX,5579,737-800,29,5,34,6,6,32,,,,,5,3
2019-04-28 22:32,SYX,5579,737-800,29,5,34,6,6,32,,,,,5,3
2019-04-28 22:30,XIY,5346,737-800,12,5,22,6,5,22,,,,,10,10
2019-04-28 22:27,HAK,1103,737-800,28,4,36,5,4,32,,,,,8,4
2019-04-28 22:15,HAK,1735,737-800,28,4,33,5,4,29,,,,,5,1
2019-04-28 22:12,TYN,5337,737-800,17,5,14,6,6,22,,,,,-3,5
2019-04-28 22:07,CAN,1549,737-800,27,6,30,7,6,31,,,,,3,4
2019-04-28 22:07,URC,1323,737-800,19,4,20,4,4,22,,,,,1,3
2019-04-28 22:05,XNN,1498,737-800,15,6,21,6,6,21,,,,,6,6
2019-04-28 22:05,XNN,5467,737-800,15,2,18,2,2,18,,,,,3,3
2019-04-28 21:45,´óÁ¬,6063,737-800,10,6,26,6,4,24,,,,,16,14
2019-04-28 21:38,´óÁ¬,6063,737-800,10,6,26,6,4,24,,,,,16,14
2019-04-28 21:37,HGH,5620,737-800,19,3,0,3,3,24,,,,,-19,5
2019-04-28 20:55,DLC,5466,737-800,13,0,0,2,3,22,,,,,-13,9
2019-04-28 20:33,HAK,203H,737-800,27,3,32,4,4,34,,,,,5,7
2019-04-28 19:54,HAK,5082,737-800,30,8,36,5,5,32,,,,,6,2
2019-04-28 19:53,FOC,1906,737-800,21,6,31,6,6,30,,,,,10,9
2019-04-28 19:22,FOC,1480,737-800,29,4,24,4,4,24,,,,,-5,-5
2019-04-28 19:04,SZX,5540,737-800,27,6,26,4,4,29,,,,,-1,2
2019-04-28 18:58,HRB,1905,737-800,17,3,23,4,3,20,,,,,6,3
2019-04-28 16:55,XUZ,7991,737-800,20,8,26,8,8,24,,,,,6,4
2019-04-28 16:46,URC,6995,737-800,20,4,23,4,4,22,,,,,3,2
2019-04-28 16:36,XIY,1372,737-800,12,4,23,5,5,20,,,,,11,8
2019-04-28 16:06,SZX,1783,737-800,36,4,20,6,4,34,,,,,-16,-2
2019-04-28 15:49,CGO,1728,737-800,23,5,14,5,5,18,,,,,-9,-5
2019-04-28 13:28,TYN,1213,737-800,19,8,27,6,6,23,,,,,8,4
2019-04-28 11:36,CTU,7989,737-800,28,5,30,5,5,28,,,,,2,0
2019-04-28 11:32,HAK,5479,737-800,26,6,30,5,5,32,,,,,4,6
2019-04-28 10:26,KMG,7990,737-800,20,6,26,4,4,24,,,,,6,4
2019-04-28 10:23,MIG,5407,737-800,20,4,28,5,4,28,,,,,8,8
2019-04-28 08:34,SZX,5580,737-800,24,6,26,5,5,26,,,,,2,2
2019-04-28 08:32,SZX,7171,737-800,25,4,30,5,4,30,,,,,5,5
2019-04-28 08:20,URC,1568,737-800,15,4,20,2,3,22,,,,,5,7
2019-04-28 08:19,URC,1322,737-800,15,0,18,3,2,22,,,,,3,7
2019-04-28 08:18,HAK,1103,737-800,28,2,32,3,3,30,,,,,4,2
2019-04-28 08:18,HAK,1735,737-800,28,4,30,3,3,32,,,,,2,4
2019-04-28 08:06,CGO,7992,737-800,12,5,24,5,5,22,,,,,12,10
2019-04-28 08:04,CGO,7992,737-800,12,5,24,5,5,22,,,,,12,10
2019-04-28 08:04,XMN,1131,737-800,23,5,30,4,4,30,,,,,7,7
2019-04-28 08:03,XMN,5408,737-800,23,3,30,3,3,28,,,,,7,5
2019-04-28 08:03,XMN,5686,737-800,22,4,29,3,4,28,,,,,7,6
2019-04-28 08:02,XMN,1996,737-800,22,4,22,4,3,28,,,,,0,6
2019-04-28 08:01,XMN,5625,737-800,20,4,25,5,6,22,,,,,5,2
2019-04-28 07:52,PEK,1490,737-800,10,7,24,5,5,22,,,,,14,12
2019-04-28 07:43,URC,5416,737-800,17,7,25,6,6,26,,,,,8,9
2019-04-28 07:40,URC,5638,737-800,15,5,26,5,6,26,,,,,11,11
2019-04-28 06:30,XMN,5625,737-800,20,4,25,5,6,22,,,,,5,2
2019-04-28 06:29,XMN,5625,737-800,20,4,20,5,6,22,,,,,0,2
2019-04-28 06:21,SHA,1725,737-800,16,5,29,5,5,29,,,,,13,13
2019-04-28 06:01,FOC,1350,737-800,19,4,28,4,4,25,,,,,9,6
2019-04-28 06:00,FOC,1350,737-800,19,5,30,5,5,28,,,,,11,9
2019-04-28 06:00,FOC,5503,737-800,24,4,26,4,4,26,,,,,2,2
2019-04-28 05:57,KHG,1323,737-800,17,2,24,3,4,21,,,,,7,4
2019-04-28 05:45,XIY,1161,737-800,11,8,34,8,8,29,,,,,23,18
2019-04-28 05:44,XIY,1480,737-800,15,5,19,4,4,18,,,,,4,3
2019-04-28 05:36,HGH,5139,737-800,14,4,18,4,3,24,,,,,4,10
2019-04-28 05:36,SZX,1492,737-800,25,2,30,3,4,30,,,,,5,5
2019-04-28 05:36,PEK,5482,737-800,10,1,18,1,1,20,,,,,8,10
2019-04-28 05:21,PEK,5463,737-800,10,7,18,6,6,18,,,,,8,8
2019-04-28 05:16,HAK,5522,737-800,27,5,34,9,9,36,,,,,7,9
2019-04-28 05:03,XIY,5466,737-800,15,4,0,6,8,30,,,,,-15,15
2019-04-28 05:03,XIY,5466,737-800,15,6,0,6,8,30,,,,,-15,15
2019-04-28 05:01,URC,205T,737-800,16,3,20,2,3,22,,,,,4,6
2019-04-28 04:59,ZGC,7379,737-800,15,5,22,3,3,23,,,,,7,8
2019-04-28 04:47,TYN,5372,737-800,5,6,18,6,6,18,,,,,13,13
2019-04-28 04:47,URC,2159,737-800,14,6,20,2,2,20,,,,,6,6
2019-04-28 04:45,URC,6995,737-800,14,6,22,4,6,23,,,,,8,9
2019-04-28 04:44,URC ,5661,737-800,14,5,20,5,6,23,,,,,6,9
2019-04-28 04:43,URC ,5371,737-800,14,6,18,6,6,22,,,,,4,8
2019-04-28 04:42,URC ,5358,737-800,14,5,18,5,5,21,,,,,4,7
2019-04-28 04:42,XIY,5115,737-800,11,4,20,4,5,24,,,,,9,13
2019-04-28 04:41,URC ,1928,737-800,14,5,20,6,6,20,,,,,6,6
2019-04-28 04:40,URC ,1928,737-800,14,5,20,6,6,20,,,,,6,6
2019-04-28 04:39,URC ,6268,737-800,15,4,28,4,4,24,,,,,13,9
2019-04-28 04:39,HAK,5082,737-800,28,6,36,6,6,32,,,,,8,4
2019-04-28 04:37,URC ,5502,737-800,14,4,22,6,4,22,,,,,8,8
2019-04-28 04:31,XIY,5579,737-800,12,4,24,6,4,28,,,,,12,16
2019-04-28 04:29,XIY,5430,737-800,11,6,24,6,6,26,,,,,13,15
2019-04-28 04:25,XIY,5346,737-800,15,5,22,5,5,24,,,,,7,9
2019-04-28 04:25,XIY,5735,737-800,15,0,14,0,0,16,,,,,-1,1
2019-04-28 04:24,,5735,737-800,15,0,14,0,0,16,,,,,-1,1
2019-04-28 04:20,HAK,1927,737-800,26,2,30,7,2,30,,,,,4,4
2019-04-28 04:11,FOC,1929,737-800,19,4,17,4,3,19,,,,,-2,0
2019-04-28 04:04,PEK,5405,737-800,10,5,26,6,5,22,,,,,16,12
2019-04-28 04:03,HHA,1502,737-800,24,3,25,3,4,26,,,,,1,2
2019-04-28 04:02,KMG,1209,737-800,19,3,26,4,4,24,,,,,7,5
2019-04-28 03:56,URC,1997,737-800,17,4,24,3,3,20,,,,,7,3
2019-04-28 03:55,URC,1570,737-800,17,6,20,3,3,18,,,,,3,1
2019-04-28 03:52,URC,1130,737-800,15,2,26,2,2,22,,,,,11,7
2019-04-28 03:43,CAN,5581,737-800,24,5,25,5,4,30,,,,,1,6
2019-04-28 03:42,HHA,5136,737-800,24,4,26,5,5,30,,,,,2,6
2019-04-28 03:39,XIY,1902,737-800,11,4,24,5,5,21,,,,,13,10
2019-04-28 03:36,SHA,7398,737-800,16,4,25,3,3,23,,,,,9,7
2019-04-28 03:35,XIY,1538,737-800,12,2,22,2,2,18,,,,,10,6
2019-04-28 03:30,NGB,1796,737-800,14,4,30,4,4,30,,,,,16,16
2019-04-28 03:24,ZUH,5359,737-800,20,5,30,5,6,25,,,,,10,5
2019-04-28 03:16,XIY,1163,737-800,11,2,23,10,10,30,,1,,1,12,19
2019-04-28 03:14,CKG,5135,737-800,27,2,26,2,3,27,,,,,-1,0
2019-04-28 03:10,SYX,5520,737-800,29,3,31,3,4,32,,,,,2,3
2019-04-28 03:08,KMG,5732,737-800,20,3,24,4,4,23,,,,,4,3
2019-04-28 03:07,SZX,5687,737-800,25,3,0,4,4,30,,,,,-25,5
2019-04-28 03:06,HGH,5462,737-800,17,5,26,5,5,24,,,,,9,7
2019-04-28 03:03,TYN,206F,737-800,7,4,20,4,4,21,,,,,13,14
2019-04-28 02:57,XIY,1162,737-800,11,4,26,2,2,20,,,,,15,9
2019-04-28 02:57,SZX,1786,737-800,25,5,32,4,4,28,,,,,7,3
2019-04-28 02:56,PEK,1491,737-800,15,5,30,5,5,25,,,,,15,10
2019-04-28 02:52,HRB,1433,737-800,14,2,10,2,2,18,,,,,-4,4
2019-04-28 02:52,HRB,1433,737-800,14,2,10,2,2,17,,,,,-4,3
2019-04-28 02:50,HAK,5733,737-800,26,4,33,4,4,34,,,,,7,8
2019-04-28 02:50,URC,1101,737-800,15,2,20,2,2,20,,,,,5,5
2019-04-28 02:44,113»úÎ»,5539,737-800,11,5,22,5,5,23,,,,,11,12
2019-04-28 02:43,HHA,1797,737-800,17,3,23,4,4,23,,,,,6,6
2019-04-28 02:40,HAK,1541,737-800,29,5,32,6,6,31,,,,,3,2
2019-04-28 02:36,HHA,5636,737-800,23,6,28,5,4,26,,,,,5,3
2019-04-28 02:33,FOC,7113,737-800,19,4,27,5,4,24,,,,,8,5
2019-04-28 02:30,KMG,7988,737-800,20,5,26,5,5,24,,,,,6,4
2019-04-28 02:30,XIY,5180,737-800,12,6,23,6,6,22,,,,,11,10
2019-04-28 02:30,CAN,1549,737-800,22,6,30,5,5,29,,,,,8,7
2019-04-28 02:23,SYX,206G,737-800,28,4,35,4,4,32,,,,,7,4
2019-04-28 02:23,PEK,5709,737-800,10,6,26,6,6,22,,,,,16,12
2019-04-28 02:22,PEK,5538,737-800,12,4,26,4,4,32,,,,,14,20
2019-04-28 02:20,SZX,1783,737-800,25,4,30,6,5,34,,,,,5,9
2019-04-28 02:18,XIY,1903,737-800,12,6,27,5,6,28,,,,,15,16
2019-04-28 02:16,112»úÎ»,7172,737-800,11,5,28,5,4,22,,,,,17,11
2019-04-28 02:15,SYX,1799,737-800,27,6,36,6,5,32,,,,,9,5
2019-04-28 02:13,CGO,7639,737-800,12,5,28,4,4,24,,,,,16,12
2019-04-28 02:12,CGO,7639,737-800,12,6,30,4,5,24,,,,,18,12
2019-04-28 02:09,FOC,5182,737-800,20,6,28,6,5,28,,,,,8,8
2019-04-28 02:09,XIY,1501,737-800,11,4,28,4,4,22,,,,,17,11
2019-04-28 02:08,FOC,5182,737-800,20,6,28,6,5,284,,,,,8,264
2019-04-28 02:07,HAK,7175,737-800,26,6,36,5,6,30,,,,,10,4
2019-04-28 02:07,XIY,5116,737-800,11,4,20,4,4,20,,,,,9,9
2019-04-28 02:07,ÃàÑô,5449,737-800,21,5,27,4,5,25,,,,,6,4
2019-04-28 02:06,HAK,6065,737-800,27,4,34,7,7,30,,,,,7,3
2019-04-28 02:04,HGH,5141,737-800,18,6,24,4,4,26,,,,,6,8
2019-04-28 02:02,HAK,5439,737-800,27,6,32,5,4,33,,,,,5,6
2019-04-28 02:01,KMG,1587,737-800,20,2,26,6,4,24,,,,,6,4
2019-04-28 02:01,DLC,5852,737-800,10,4,20,4,3,22,,,,,10,12
2019-04-28 02:01,SYX,1542,737-800,27,4,34,3,4,30,,,,,7,3
2019-04-28 02:00,DLC,5662,737-800,16,3,22,4,4,20,,,,,6,4
2019-04-28 02:00,DLC,6063,737-800,11,5,24,4,4,22,,,,,13,11
2019-04-28 01:59,DLC,5953,737-800,10,4,20,6,6,18,,,,,10,8
2019-04-28 01:58,DLC,1215,737-800,12,4,28,5,5,22,,,,,16,10
2019-04-28 01:57,DLC,7173,737-800,12,5,22,4,6,24,,,,,10,12
2019-04-28 01:56,DLC,1493,737-800,11,4,22,4,4,20,,,,,11,9
2019-04-28 01:56,DLC,1785,737-800,12,2,27,6,6,24,,,,,15,12
2019-04-28 01:54,SZX,6061,737-800,25,6,28,2,3,30,,,,,3,5
2019-04-28 01:52,HGH,5712,737-800,20,1,22,2,1,24,,,,,2,4
2019-04-28 01:50,SYX,6062,737-800,29,4,35,4,4,34,,,,,6,5
2019-04-28 01:47,HHA,1505,737-800,19,3,28,3,3,23,,,,,9,4
2019-04-28 01:46,À¥Ã÷,6016,737-800,21,4,28,4,3,18,,,,,7,-3
2019-04-28 01:45,HGH,5620,737-800,16,3,0,3,4,23,,,,,-16,7
2019-04-28 01:43,FOC,1562,737-800,19,4,30,4,4,28,,,,,11,9
2019-04-28 01:42,SZX,1787,737-800,25,2,30,2,2,28,,,,,5,3
2019-04-28 01:39,XIY,5418,737-800,12,2,16,4,4,20,,,,,4,8
2019-04-28 01:33,HRB,1905,737-800,13,3,22,4,3,18,,,,,9,5
2019-04-28 01:32,CAN,1995,737-800,25,6,30,6,6,30,,,,,5,5
2019-04-28 01:32,YIH,1435,737-800,18,5,24,6,6,23,,,,,6,5
2019-04-28 01:31,SYX,2158,737-800,30,8,30,4,4,28,,,,,0,-2
2019-04-28 01:25,SZX,5580,737-800,24,6,28,5,5,56,,,,,4,32
2019-04-28 01:23,CGO,1586,737-800,11,8,32,6,5,22,,,,,21,11
2019-04-28 01:23,HAK,5375,737-800,27,6,34,6,5,33,,,,,7,6
2019-04-28 01:21,ÃàÑô,5409,737-800,20,4,25,4,4,27,,,,,5,7
2019-04-28 01:21,HAK,795,737-800,26,4,32,2,2,28,,,,,6,2
2019-04-28 01:21,SZX,5580,737-800,24,6,28,5,5,26,,,,,4,2
2019-04-28 01:20,KMG,7991,737-800,20,5,26,6,6,24,,,,,6,4
2019-04-28 01:18,HAK,5373,737-800,28,6,31,7,7,32,,,,,3,4
2019-04-28 01:18,301,5481,737-800,26,6,32,6,6,30,,,,,6,4
2019-04-28 01:18,SZX,5798,737-800,25,2,28,2,3,26,,,,,3,1
2019-04-28 01:14,HAK,1488,737-800,26,3,33,4,5,31,,,,,7,5
2019-04-28 01:07,HAK,1547,737-800,26,6,25,6,6,32,,,,,-1,6
2019-04-28 01:05,KMG,6809,737-800,20,4,22,6,6,24,,,,,2,4
2019-04-28 01:05,YIH,1348,737-800,19,3,27,4,4,24,,,,,8,5
2019-04-28 01:05,TYN,5090,737-800,10,2,20,2,2,20,,,,,10,10
2019-04-28 01:03,CKG,7993,737-800,26,5,30,25,25,20,,,,,4,-6
2019-04-28 01:01,HAK,1489,737-800,28,4,34,4,4,31,,,,,6,3
2019-04-28 01:00,HAK,5540,737-800,28,6,34,6,6,32,,,,,6,4
2019-04-28 00:58,FOC, 7105,737-800,19,4,27,3,4,25,,,,,8,6
2019-04-28 00:58,CAN,5137,737-800,23,4,20,2,2,30,,,,,-3,7
2019-04-28 00:56,KHG,1323,737-800,17,2,24,3,4,21,,,,,7,4
2019-04-28 00:49,ZGC,1733,737-800,15,6,20,4,4,18,,,,,5,3
2019-04-28 00:48,SYX,5138,737-800,29,3,32,3,3,31,,,,,3,2
2019-04-28 00:47,KMG,1208,737-800,20,3,25,3,4,23,,,,,5,3
2019-04-28 00:38,XIY,1495,737-800,12,3,22,3,4,22,,,,,10,10
2019-04-28 00:37,PEK,7400,737-800,8,6,24,6,6,20,,,,,16,12
2019-04-28 00:35,,XIY,737-800,12,4,26,6,6,30,,,,,14,18
2019-04-28 00:34,HAK,5637,737-800,27,2,34,3,2,32,,,,,7,5
2019-04-28 00:32,HGH,5623,737-800,17,7,28,5,5,25,,,,,11,8
2019-04-28 00:31,HGH,5623,737-800,17,7,28,5,5,25,,,,,11,8
2019-04-28 00:29,HGH,1386,737-800,20,3,20,4,3,22,,,,,0,2
2019-04-28 00:29,CKG,7616,737-800,25,4,28,4,5,28,,,,,3,3
2019-04-28 00:20,URC,1569,737-800,15,3,24,4,5,23,,,,,9,8
2019-04-28 00:20,ZGC,5417,737-800,17,7,24,5,5,22,,,,,7,5
2019-04-28 00:20,URC,1347,737-800,15,2,20,2,2,20,,,,,5,5
2019-04-28 00:19,HAK,1793,737-800,27,4,35,4,4,32,,,,,8,5
2019-04-28 00:18,HAK,1726,737-800,26,4,32,4,4,34,,,,,6,8
2019-04-28 00:17,CAN,1729,737-800,24,5,23,5,5,25,,,,,-1,1
2019-04-28 00:16,PEK,1102,737-800,11,4,24,4,4,22,,,,,13,11
2019-04-28 00:10,SYX,5713,737-800,30,5,30,5,6,24,,,,,0,-6
2019-04-28 00:04,CAN,1346,737-800,24,5,32,6,5,27,,,,,8,3
2019-04-28 00:03,CGO,5338,737-800,11,2,17,4,4,22,,,,,6,11
2019-04-28 00:01,HRB,1351,737-800,14,3,23,4,4,18,,,,,9,4
2019-04-27 23:59,CAN,7886,737-800,24,5,32,4,3,32,,,,,8,8
2019-04-27 23:53,HAK,5521,737-800,27,5,29,4,2,28,,,,,2,1
2019-04-27 23:52,XNN,1498,737-800,15,6,23,5,6,24,,,,,8,9
2019-04-27 23:48,CGO,7167,737-800,11,5,25,6,5,22,,,,,14,11
2019-04-27 23:48,XZX,7171,737-800,24,4,30,5,4,30,,,,,6,6
2019-04-27 23:44,TYN,1375,737-800,6,6,26,6,6,25,,,,,20,19
2019-04-27 23:43,XIY,5478,737-800,12,4,27,5,4,22,,,,,15,10
2019-04-27 23:39,HRB,7395,737-800,8,6,24,5,7,21,,,,,16,13
2019-04-27 23:38,HRB,7395,737-800,8,8,24,6,8,23,,,,,16,15
2019-04-27 23:30,HAK,6015,737-800,27,4,36,4,3,32,,,,,9,5
2019-04-27 23:27,CKG,5429,737-800,28,4,27,4,4,26,,,,,-1,-2
2019-04-27 23:24,SZX,5855,737-800,25,6,30,6,6,26,,,,,5,1
2019-04-27 23:16,HAK,5467,737-800,27,2,28,2,2,26,,,,,1,-1
2019-04-27 23:15,HGH,7378,737-800,17,8,24,6,6,26,,,,,7,9
2019-04-27 23:12,SYX,1545,737-800,28,5,34,5,5,32,,,,,6,4
2019-04-27 23:06,URC,1325,737-800,15,3,20,4,3,21,,,,,5,6
2019-04-27 23:06,SYX,7618,737-800,28,5,32,6,6,30,,,,,4,2
2019-04-27 23:05,MIG,1798,737-800,20,7,28,7,6,24,,,,,8,4
2019-04-27 23:03,CAN,1141,737-800,25,6,30,6,6,30,,,,,5,5
2019-04-27 23:00,º£¿Ú,5483,737-800,28,4,36,6,5,35,,,,,8,7
2019-04-27 22:58,HAK,1497,737-800,28,3,28,3,3,32,,,,,0,4
2019-04-27 22:57,HAK,5089,737-800,28,3,28,2,2,32,,,,,0,4
2019-04-27 22:53,XIY,6103,737-800,10,6,20,6,6,22,,,,,10,12
2019-04-27 22:19,CAN,5428,737-800,24,6,29,6,6,30,,,,,5,6
2019-04-27 22:18,FOC,1906,737-800,19,7,29,7,6,26,,,,,10,7
2019-04-27 22:00,CAN,7377,737-800,25,6,30,6,6,32,,,,,5,7
2019-04-27 21:46,XNN,7619,737-800,18,6,20,6,6,21,,,,,2,3
2019-04-27 21:36,CAN,1373,737-800,34,6,28,5,6,26,,,,,-6,-8
2019-04-27 20:30,HGH,5581,737-800,18,4,28,5,5,26,,,,,10,8
2019-04-27 20:18,HAK,1103,737-800,31,4,34,5,5,32,,,,,3,1
2019-04-27 20:04,HAK,206H,737-800,29,4,35,3,4,32,,,,,6,3
2019-04-27 19:51,CAN,1489,737-800,23,4,30,4,6,28,,,,,7,5
2019-04-27 18:32,HAK,1503,737-800,33,1,31,4,3,31,,,,,-2,-2
2019-04-27 18:08,URC,205V,737-800,15,4,26,4,4,22,,,,,11,7
2019-04-27 17:59,FOC,1348,737-800,24,4,30,4,4,26,,,,,6,2
2019-04-27 16:35,SYX,206F,737-800,36,2,30,2,3,25,,,,,-6,-11
2019-04-27 14:52,URC,7198,737-800,19,8,26,6,6,24,,,,,7,5
2019-04-27 14:41,CGO,1586,737-800,14,4,24,4,4,23,,,,,10,9
2019-04-27 13:34,XUZ,1588,737-800,20,3,24,3,3,20,,,,,4,0
2019-04-27 12:25,CTU,7989,737-800,30,6,30,5,6,31,,,,,0,1
2019-04-27 11:07,KMG,6016,737-800,30,4,27,26,27,24,,,,,-3,-6
2019-04-27 09:52,KMG,6015,737-800,20,3,24,4,4,22,,,,,4,2
2019-04-27 09:20,FOC,1351,737-800,22,4,24,4,4,26,,,,,2,4
2019-04-27 08:48,FOC,1348,737-800,20,4,30,4,4,26,,,,,10,6
2019-04-27 08:47,FOC,5182,737-800,23,3,27,4,4,27,,,,,4,4
2019-04-27 08:22,KMG,7993,737-800,20,6,26,7,6,23,,,,,6,3
2019-04-27 08:15,PEK,6103,737-800,14,4,22,5,6,23,,,,,8,9
2019-04-27 08:13,PEK,6103,737-800,14,4,22,5,6,23,,,,,8,9
2019-04-27 08:12,HAK,1491,737-800,28,6,34,6,5,34,,,,,6,6
2019-04-27 08:12,PEK,6103,737-800,14,4,22,5,6,23,,,,,8,9
2019-04-27 08:03,HAK,7616,737-800,28,4,30,4,4,31,,,,,2,3
2019-04-27 07:57,CAN,1729,737-800,23,4,22,5,4,25,,,,,-1,2
2019-04-27 07:53,CGO,5620,737-800,14,5,0,6,6,27,,,,,-14,13
2019-04-27 07:43,XIY,5478,737-800,15,8,32,7,8,30,,,,,17,15
2019-04-27 07:35,CKG,5429,737-800,26,3,28,4,5,27,,,,,2,1
2019-04-27 07:34,SYX ,1103,737-800,30,4,34,4,4,33,,,,,4,3
2019-04-27 07:29,SYX ,1103,737-800,30,4,34,4,4,33,,,,,4,3
2019-04-27 07:26,CKG,1213,737-800,28,7,32,7,7,30,,,,,4,2
2019-04-27 07:13,HAK,5405,737-800,27,4,36,6,5,34,,,,,9,7
2019-04-27 07:08,XIY,1162,737-800,13,2,26,2,2,22,,,,,13,9
2019-04-27 07:07,XIY,5116,737-800,13,2,20,4,4,17,,,,,7,4
2019-04-27 07:06,XIY,1483,737-800,15,5,20,5,5,24,,,,,5,9
2019-04-27 07:05,XIY,5115,737-800,15,2,20,3,4,22,,,,,5,7
2019-04-27 07:02,HRB,1559,737-800,10,2,20,2,2,20,,,,,10,10
2019-04-27 07:00,HAK,1787,737-800,29,1,30,2,2,30,,,,,1,1
2019-04-27 06:49,CAN,7377,737-800,23,6,24,6,6,30,,,,,1,7
2019-04-27 06:39,HAK,1728,737-800,27,4,30,6,6,26,,,,,3,-1
2019-04-27 06:32,FOC,7113,737-800,19,4,27,4,3,26,,,,,8,7
2019-04-27 06:29,PEK,5528,737-800,15,4,30,4,5,24,,,,,15,9
2019-04-27 06:26,XMN,5625,737-800,25,6,30,5,4,28,,,,,5,3
2019-04-27 06:25,PEK,5153,737-800,15,4,24,2,2,22,,,,,9,7
2019-04-27 06:23,XIY,5430,737-800,20,2,22,2,4,24,,,,,2,4
2019-04-27 06:22,FOC,5503,737-800,19,3,25,4,3,25,,,,,6,6
2019-04-27 06:22,XIY,5418,737-800,20,4,24,2,4,26,,,,,4,6
2019-04-27 06:21,XIY,5798,737-800,20,8,24,8,8,26,,,,,4,6
2019-04-27 06:08,CAN,1386,737-800,23,2,30,4,3,28,,,,,7,5
2019-04-27 06:05,HGH,5686,737-800,13,5,22,5,5,21,,,,,9,8
2019-04-27 05:30,CAN,5522,737-800,23,6,30,8,7,30,,,,,7,7
2019-04-27 05:29,HGH,5581,737-800,15,4,18,5,4,22,,,,,3,7
2019-04-27 05:18,KMG,1208,737-800,20,3,24,4,4,22,,,,,4,2
2019-04-27 05:11,ZGC,205U,737-800,10,5,24,4,5,22,,,,,14,12
2019-04-27 04:56,CAN,5439,737-800,23,4,30,4,4,28,,,,,7,5
2019-04-27 04:48,HAK,7639,737-800,26,6,36,6,6,32,,,,,10,6
2019-04-27 04:47,ZGC,5853,737-800,10,6,16,6,7,14,,,,,6,4
2019-04-27 04:46,ZGC,5709,737-800,10,6,24,6,6,20,,,,,14,10
2019-04-27 04:46,HAK,1503,737-800,29,2,33,3,3,32,,,,,4,3
2019-04-27 04:44,ZGC,1346,737-800,7,6,13,5,6,16,,,,,6,9
2019-04-27 04:44,HAK,1927,737-800,25,6,30,6,6,32,,,,,5,7
2019-04-27 04:27,CAN,5579,737-800,23,6,32,6,6,30,,,,,9,7
2019-04-27 04:18,Î÷°²,1727,737-800,13,5,22,6,5,20,,,,,9,7
2019-04-27 04:05,FOC,1562,737-800,20,4,28,5,4,29,,,,,8,9
2019-04-27 04:03,TYN,5090,737-800,11,2,21,2,2,18,,,,,10,7
2019-04-27 03:56,XIY,1163,737-800,13,8,32,8,9,34,1,1,,11,19,21
2019-04-27 03:54,Î÷°²,1903,737-800,13,1,23,2,2,24,,,,,10,11
2019-04-27 03:51,HAK,5483,737-800,25,5,35,7,6,32,,,,,10,7
2019-04-27 03:50,URC,2157,737-800,13,4,22,8,3,21,,,,,9,8
2019-04-27 03:49,FOC,7172,737-800,20,4,27,5,4,26,,,,,7,6
2019-04-27 03:45,XIY,1496,737-800,15,5,26,6,6,24,,,,,11,9
2019-04-27 03:43,HAK,5372,737-800,26,8,33,9,8,33,,,,,7,7
2019-04-27 03:42,HAK,5372,737-800,26,8,33,9,8,33,,,,,7,7
2019-04-27 03:41,PEK,5797,737-800,16,4,20,4,4,28,,,,,4,12
2019-04-27 03:33,XIY,1481,737-800,15,6,26,6,6,26,,,,,11,11
2019-04-27 03:30,CAN,1373,737-800,23,4,30,5,5,25,,,,,7,2
2019-04-27 03:24,XIY,1350,737-800,15,2,24,7,8,24,,,,,9,9
2019-04-27 03:19,HAK,1735,737-800,27,5,30,5,5,26,,,,,3,-1
2019-04-27 03:14,HAK,1793,737-800,26,5,34,6,5,30,,,,,8,4
2019-04-27 03:13,HAK,1793,737-800,26,5,34,6,5,30,,,,,8,4
2019-04-27 03:13,PEK,5538,737-800,20,3,29,3,3,28,,,,,9,8
2019-04-27 03:09,DLC,1785,737-800,12,2,25,7,7,24,,,,,13,12
2019-04-27 03:05,SYX,5713,737-800,28,4,28,6,6,30,,,,,0,2
2019-04-27 03:00,MIG,5449,737-800,30,4,30,4,4,28,,,,,0,-2
2019-04-27 02:56,HRB,1433,737-800,8,2,20,2,2,20,,,,,12,12
2019-04-27 02:54,TYN,7399,737-800,12,4,24,4,4,26,,,,,12,14
2019-04-27 02:53,SYX ,1545,737-800,28,6,36,6,6,32,,,,,8,4
2019-04-27 02:52,PEK,5482,737-800,15,4,24,5,6,23,,,,,9,8
2019-04-27 02:51,URC,1568,737-800,10,6,23,6,6,18,,,,,13,8
2019-04-27 02:49,XIY,1902,737-800,15,4,24,6,5,25,,,,,9,10
2019-04-27 02:47,HHA,5465,737-800,19,4,22,4,4,23,,,,,3,4
2019-04-27 02:47,KMG,1588,737-800,20,4,24,6,5,22,,,,,4,2
2019-04-27 02:46,HHA,5136,737-800,20,4,24,5,5,28,,,,,4,8
2019-04-27 02:45,SYX ,2158,737-800,30,4,26,4,4,28,,,,,-4,-2
2019-04-27 02:45,SYX,1542,737-800,28,4,33,4,4,30,,,,,5,2
2019-04-27 02:44,DLC,1799,737-800,10,4,25,4,5,24,,,,,15,14
2019-04-27 02:43,HGH,5337,737-800,16,3,20,4,4,20,,,,,4,4
2019-04-27 02:43,DLC,1215,737-800,10,4,24,4,4,20,,,,,14,10
2019-04-27 02:41,CGO,1587,737-800,13,2,24,4,4,22,,,,,11,9
2019-04-27 02:40,DLC,1495,737-800,13,2,26,5,5,24,,,,,13,11
2019-04-27 02:38,YIH,1435,737-800,18,6,22,6,6,22,,,,,4,4
2019-04-27 02:37,DLC,7173,737-800,12,4,26,5,5,20,,,,,14,8
2019-04-27 02:35,DLC,6063,737-800,11,2,24,6,6,23,,,,,13,12
2019-04-27 02:34,HAK,1995,737-800,28,6,34,6,6,32,,,,,6,4
2019-04-27 02:33,CGO,7167,737-800,22,4,26,4,4,22,,,,,4,0
2019-04-27 02:29,HAK,1547,737-800,26,6,33,6,6,32,,,,,7,6
2019-04-27 02:25,HHA,5408,737-800,20,3,26,3,3,26,,,,,6,6
2019-04-27 02:20,HAK,7639,737-800,26,6,37,7,7,33,1,,,1,11,7
2019-04-27 02:20,SYX,206G,737-800,28,3,33,4,3,30,,,,,5,2
2019-04-27 02:18,PEK,5539,737-800,15,4,24,5,5,26,,,,,9,11
2019-04-27 02:18,PEK,5539,737-800,15,4,24,5,5,26,,,,,9,11
2019-04-27 02:17,XMN,1489,737-800,23,4,30,6,6,32,,,,,7,9
2019-04-27 02:17,XMN,5636,737-800,23,5,25,7,3,30,,,,,2,7
2019-04-27 02:16,XMN,5661,737-800,20,4,28,3,2,24,,,,,8,4
2019-04-27 02:15,XMN,1996,737-800,22,6,28,6,4,28,,,,,6,6
2019-04-27 02:15,XMN,7379,737-800,24,5,29,8,9,36,,1,,1,5,12
2019-04-27 02:14,PEK,7175,737-800,15,5,26,4,5,22,,,,,11,7
2019-04-27 02:13,URC,1928,737-800,15,3,21,3,3,22,,,,,6,7
2019-04-27 02:11,URC,6995,737-800,10,4,25,4,4,23,,,,,15,13
2019-04-27 02:08,SZX,7171,737-800,30,4,30,4,4,30,,,,,0,0
2019-04-27 02:04,DLC,6060,737-800,12,4,22,4,4,23,,,,,10,11
2019-04-27 02:03,DLC,5359,737-800,11,5,20,5,5,20,,,,,9,9
2019-04-27 02:00,ZUH,1375,737-800,26,5,27,5,4,30,,,,,1,4
2019-04-27 02:00,HSK,5479,737-800,27,5,30,6,6,34,,,,,3,7
2019-04-27 02:00,SZX,1372,737-800,25,5,32,5,4,30,,,,,7,5
2019-04-27 02:00,XIY,1482,737-800,10,2,21,2,3,22,,,,,11,12
2019-04-27 01:57,HAK,5137,737-800,26,5,30,2,2,32,,,,,4,6
2019-04-27 01:52,KMG,7988,737-800,20,4,27,4,5,25,,,,,7,5
2019-04-27 01:44,SYX,6062,737-800,27,4,36,4,4,34,,,,,9,7
2019-04-27 01:44,PEK,1493,737-800,18,6,16,7,6,18,,,,,-2,0
2019-04-27 01:35,SYX,5141,737-800,28,6,30,6,6,31,,,,,2,3
2019-04-27 01:33,HRB,1905,737-800,13,3,20,3,4,19,,,,,7,6
2019-04-27 01:29,HHA,1797,737-800,25,2,22,2,2,24,,,,,-3,-1
2019-04-27 01:27,HAK,5139,737-800,25,6,29,6,4,32,,,,,4,7
2019-04-27 01:26,XIY,1501,737-800,13,4,24,4,4,23,,,,,11,10
2019-04-27 01:23,URC,1992,737-800,10,4,26,4,3,20,,,,,16,10
2019-04-27 01:22,HAK,1549,737-800,28,5,34,4,4,32,,,,,6,4
2019-04-27 01:21,PEK,5852,737-800,16,4,22,4,4,22,,,,,6,6
2019-04-27 01:21,HHA,5637,737-800,21,2,28,2,2,28,,,,,7,7
2019-04-27 01:19,HAK,5428,737-800,28,4,30,6,4,33,,,,,2,5
2019-04-27 01:16,KMG,7990,737-800,23,2,26,4,3,23,,,,,3,0
2019-04-27 01:16,KMG,7990,737-800,23,2,26,4,3,23,,,,,3,0
2019-04-27 01:14,HAK,1541,737-800,28,4,30,7,6,32,,,,,2,4
2019-04-27 01:12,XIY,5180,737-800,13,6,22,6,6,24,,,,,9,11
2019-04-27 01:10,CAN,1141,737-800,23,6,24,5,5,30,,,,,1,7
2019-04-27 01:08,URC,206P,737-800,13,4,22,4,4,18,,,,,9,5
2019-04-27 01:07,XIY,6065,737-800,15,4,24,4,4,22,,,,,9,7
2019-04-27 01:05,HAK,5463,737-800,28,5,33,4,4,26,,,,,5,-2
2019-04-27 01:02,PEK,1733,737-800,15,2,12,2,2,20,,,,,-3,5
2019-04-27 01:02,URC,1322,737-800,13,4,23,4,4,22,,,,,10,9
2019-04-27 01:01,URC,205T,737-800,13,4,24,3,3,22,,,,,11,9
2019-04-27 01:01,URC,205T,737-800,13,4,24,3,3,22,,,,,11,9
2019-04-27 01:01,URC,1374,737-800,15,2,22,3,3,23,,,,,7,8
2019-04-27 00:58,URC,1325,737-800,14,3,20,2,2,20,,,,,6,6
2019-04-27 00:58,URC,5416,737-800,10,6,24,6,6,24,,,,,14,14
2019-04-27 00:57,HAK,7886,737-800,27,4,33,4,4,34,,,,,6,7
2019-04-27 00:57,YIH,7105,737-800,18,4,26,4,4,24,,,,,8,6
2019-04-27 00:57,HGH,5712,737-800,15,2,22,3,3,21,,,,,7,6
2019-04-27 00:56,PEK,5358,737-800,16,4,20,8,8,24,,,,,4,8
2019-04-27 00:55,KHG,1569,737-800,18,2,24,2,2,22,,,,,6,4
2019-04-27 00:54,KMG,7992,737-800,20,6,25,8,7,23,,,,,5,3
2019-04-27 00:54,SZX,1786,737-800,27,4,33,3,3,29,,,,,6,2
2019-04-27 00:51,HHA,1505,737-800,20,5,23,5,4,24,,,,,3,4
2019-04-27 00:46,HAK,5082,737-800,26,5,34,5,4,32,,,,,8,6
2019-04-27 00:46,FOC,1480,737-800,24,6,26,4,2,24,,,,,2,0
2019-04-27 00:44,XIY,1795,737-800,15,3,22,4,4,24,,,,,7,9
2019-04-27 00:44,XIY,5735,737-800,13,2,23,2,3,22,,,,,10,9
2019-04-27 00:43,SZX,5855,737-800,30,6,28,6,6,28,,,,,-2,-2
2019-04-27 00:42,DLC,5662,737-800,12,3,22,4,6,20,,,,,10,8
2019-04-27 00:41,CGO,7991,737-800,13,5,24,5,6,22,,,,,11,9
2019-04-27 00:30,HAK,1726,737-800,30,4,33,4,4,30,,,,,3,0
2019-04-27 00:28,HGH,5462,737-800,14,3,20,5,3,24,,,,,6,10
2019-04-27 00:27,MIG,6809,737-800,27,4,28,4,4,28,,,,,1,1
2019-04-27 00:26,URC,5638,737-800,15,2,21,2,2,21,,,,,6,6
2019-04-27 00:21,PEK,6066,737-800,15,2,25,2,2,23,,,,,10,8
2019-04-27 00:21,HAK,5417,737-800,29,5,31,5,4,32,,,,,2,3
2019-04-27 00:21,XIY,5466,737-800,14,4,0,4,2,20,,,,,-14,6
2019-04-27 00:17,ÉîÛÚ,5687,737-800,28,4,0,4,4,32,,,,,-28,4
2019-04-27 00:15,CGO,1570,737-800,13,6,23,6,6,22,,,,,10,9
2019-04-27 00:14,CGO,1570,737-800,13,6,23,6,6,22,,,,,10,9
2019-04-27 00:09,URC,1488,737-800,14,6,25,5,5,22,,,,,11,8
2019-04-27 00:08,CKG,5429,737-800,25,2,28,2,2,28,,,,,3,3
2019-04-27 00:07,KMG,5407,737-800,20,4,25,5,4,24,,,,,5,4
2019-04-27 00:05,TYN,1783,737-800,12,4,21,4,4,22,,,,,9,10
2019-04-27 00:04,XIY,5346,737-800,13,5,22,5,5,20,,,,,9,7
2019-04-27 00:03,CKG,5336,737-800,26,3,27,4,3,29,,,,,1,3
2019-04-27 00:02,SYX,5623,737-800,28,6,36,6,6,30,,,,,8,2
2019-04-26 23:48,SYX,5138,737-800,28,4,30,5,5,26,,,,,2,-2
2019-04-26 23:47,XIY,5466,737-800,14,4,0,14,2,20,,,,,-14,6
2019-04-26 23:45,PEK,7400,737-800,15,4,28,5,6,26,,,,,13,11
2019-04-26 23:44,URC,7198,737-800,13,4,24,4,4,22,,,,,11,9
2019-04-26 23:41,HRB,7395,737-800,10,4,18,4,5,19,,,,,8,9
2019-04-26 23:38,URC,5733,737-800,13,4,25,4,5,23,,,,,12,10
2019-04-26 23:37,CGO,5135,737-800,16,1,22,2,2,21,,,,,6,5
2019-04-26 23:35,MIG,1798,737-800,28,6,30,6,6,26,,,,,2,-2
2019-04-26 23:33,SZX,1497,737-800,27,4,34,4,4,32,,,,,7,5
2019-04-26 23:18,CGO,7378,737-800,14,5,22,5,5,23,,,,,8,9
2019-04-26 23:17,HHA,5406,737-800,21,4,27,6,6,24,,,,,6,3
2019-04-26 23:16,URC,5502,737-800,14,4,21,6,5,22,,,,,7,8
2019-04-26 23:13,PEK,7398,737-800,16,4,24,4,4,21,,,,,8,5
2019-04-26 23:06,URC,1130,737-800,13,5,28,2,2,21,,,,,15,8
2019-04-26 23:06,URC,1130,737-800,13,5,28,2,2,21,,,,,15,8
2019-04-26 22:55,PEK,1929,737-800,15,4,24,4,5,20,,,,,9,5
2019-04-26 22:55,SZX,5580,737-800,29,5,31,6,6,34,,,,,2,5
2019-04-26 22:47,ÐìÖÝ,1209,737-800,20,7,24,4,5,24,,,,,4,4
2019-04-26 22:41,XNN,1102,737-800,16,3,23,4,4,22,,,,,7,6
2019-04-26 22:34,HAK,5540,737-800,28,6,33,5,5,32,,,,,5,4
2019-04-26 22:34,SYX,7618,737-800,29,6,31,6,6,32,,,,,2,3
2019-04-26 22:26,HAK,5089,737-800,28,3,20,1,1,32,,,,,-8,4
2019-04-26 22:23,MIG,5409,737-800,30,4,28,4,4,30,,,,,-2,0
2019-04-26 22:09,XNN,1498,737-800,16,5,23,5,5,21,,,,,7,5
2019-04-26 22:02,HGH,1487,737-800,14,7,32,8,7,26,,,,,18,12
2019-04-26 21:39,HAK,6061,737-800,26,4,33,5,4,29,,,,,7,3
2019-04-26 21:29,XIY,1102,737-800,16,3,23,4,4,22,,,,,7,6
2019-04-26 21:20,HGH,1725,737-800,14,2,20,4,4,21,,,,,6,7
2019-04-26 19:42,HAK,5481,737-800,35,6,34,6,6,30,,,,,-1,-5
2019-04-26 18:58,HRB,1559,737-800,13,3,23,3,3,22,,,,,10,9
2019-04-26 17:06,HHA,5637,737-800,29,2,34,2,2,32,,,,,5,3
2019-04-26 14:36,WNZ,205V,737-800,27,3,25,5,3,28,,,,,-2,1
2019-04-26 12:52,HRB,1905,737-800,17,3,21,4,5,20,,,,,4,3
2019-04-26 11:07,CTU,7989,737-800,37,7,30,6,5,31,,,,,-7,-6
2019-04-26 10:54,TYN,1496,737-800,12,8,28,8,8,26,,,,,16,14
2019-04-26 09:52,HAK,5855,737-800,27,6,31,7,6,28,,,,,4,1
2019-04-26 09:50,WNZ,1492,737-800,20,5,28,3,3,27,,,,,8,7
2019-04-26 08:54,XIY,5115,737-800,16,4,18,5,5,24,,,,,2,8
2019-04-26 08:19,PEK,1728,737-800,20,5,22,4,5,22,,,,,2,2
2019-04-26 08:10,FOC,1562,737-800,22,4,28,4,4,30,,,,,6,8
2019-04-26 08:04,HAK,5338,737-800,29,2,27,2,3,31,,,,,-2,2
2019-04-26 07:23,SZX,7171,737-800,27,5,31,5,4,31,,,,,4,4
2019-04-26 07:21,DLC,6060,737-800,10,4,24,4,4,22,,,,,14,12
2019-04-26 07:14,CKG,5429,737-800,28,4,26,4,4,27,,,,,-2,-1
2019-04-26 07:13,XIY,5180,737-800,15,6,26,4,6,24,,,,,11,9
2019-04-26 07:09,FOC,1562,737-800,22,4,28,4,4,32,,,,,6,10
2019-04-26 06:57,SZX,5462,737-800,26,4,30,4,6,34,,,,,4,8
2019-04-26 06:43,CGO,7991,737-800,16,6,26,6,6,24,,,,,10,8
2019-04-26 06:25,PEK,1505,737-800,13,3,24,4,4,22,,,,,11,9
2019-04-26 05:41,PEK,5482,737-800,12,2,20,6,6,22,,,,,8,10
2019-04-26 05:40,XMN,5625,737-800,26,4,30,5,5,31,,,,,4,5
2019-04-26 05:40,XMN,5636,737-800,26,4,31,5,4,25,,,,,5,-1
2019-04-26 05:39,XMN,5406,737-800,26,3,26,3,4,28,,,,,0,2
2019-04-26 05:38,XMN,1346,737-800,27,6,31,4,5,30,,,,,4,3
2019-04-26 05:38,XMN,5406,737-800,26,3,26,3,4,28,,,,,0,2
2019-04-26 05:37,XMN,5661,737-800,30,5,30,4,5,28,,,,,0,-2
2019-04-26 05:32,CGO,7991,737-800,16,6,26,6,6,24,,,,,10,8
2019-04-26 05:29,HGH,1503,737-800,17,1,22,3,3,23,,,,,5,6
2019-04-26 05:28,URC,5638,737-800,20,4,22,5,5,22,,,,,2,2
2019-04-26 05:25,HHA,7379,737-800,24,4,32,4,4,32,,,,,8,8
2019-04-26 05:24,SZX,1130,737-800,27,3,35,3,3,32,,,,,8,5
2019-04-26 05:18,CAN,5467,737-800,27,4,30,3,3,29,,,,,3,2
2019-04-26 05:17,HGH,5465,737-800,18,3,27,3,3,24,,,,,9,6
2019-04-26 05:17,HRB,1906,737-800,13,4,28,5,4,25,,,,,15,12
2019-04-26 05:15,URC,5712,737-800,12,2,20,3,2,21,,,,,8,9
2019-04-26 05:08,CAN,1538,737-800,25,2,30,2,3,30,,,,,5,5
2019-04-26 05:08,HAK,1793,737-800,25,5,35,4,4,30,,,,,10,5
2019-04-26 04:54,URC,1997,737-800,14,4,24,4,3,19,,,,,10,5
2019-04-26 04:53,SYX,1542,737-800,29,3,32,4,4,28,,,,,3,-1
2019-04-26 04:52,ZGC,1493,737-800,10,6,22,6,5,20,,,,,12,10
2019-04-26 04:50,FOC,1480,737-800,22,4,24,4,4,24,,,,,2,2
2019-04-26 04:44,PEK,1733,737-800,15,4,23,4,3,22,,,,,8,7
2019-04-26 04:43,URC,206P,737-800,18,4,24,4,4,24,,,,,6,6
2019-04-26 04:43,URC,206P,737-800,18,4,24,4,4,24,,,,,6,6
2019-04-26 04:41,CKG,1213,737-800,28,5,33,33,5,6,,,,,5,-22
2019-04-26 04:36,SYX,5713,737-800,30,6,24,6,6,30,,,,,-6,0
2019-04-26 04:31,HGH,1996,737-800,20,4,22,4,4,24,,,,,2,4
2019-04-26 04:26,URC,1928,737-800,16,4,16,3,5,20,,,,,0,4
2019-04-26 04:23,XIY,1795,737-800,15,4,24,4,3,22,,,,,9,7
2019-04-26 04:20,HGH,5581,737-800,18,4,18,4,6,26,,,,,0,8
2019-04-26 04:13,KMG ,6809,737-800,17,5,23,6,6,20,,,,,6,3
2019-04-26 04:12,KMG ,5732,737-800,17,2,22,3,3,22,,,,,5,5
2019-04-26 04:12,KMG ,1208,737-800,19,3,24,3,4,21,,,,,5,2
2019-04-26 04:10,XIY,5116,737-800,15,5,20,3,4,20,,,,,5,5
2019-04-26 04:09,CAN,1386,737-800,28,3,32,2,2,28,,,,,4,0
2019-04-26 04:09,FOC,6808,737-800,21,0,0,0,0,0,,,,,-21,-21
2019-04-26 04:07,KMG ,6809,737-800,17,5,26,6,6,20,,,,,9,3
2019-04-26 04:06,PEK,5735,737-800,11,0,12,0,0,10,,,,,1,-1
2019-04-26 04:06,XIY,5798,737-800,17,5,22,2,3,22,,,,,5,5
2019-04-26 04:05,XIY,1162,737-800,16,3,26,3,3,27,,,,,10,11
2019-04-26 03:49,5852,PEK,737-800,12,4,20,3,4,22,,,,,8,10
2019-04-26 03:49,À¥Ã÷,5407,737-800,15,3,24,5,4,23,,,,,9,8
2019-04-26 03:48,CAN ,1797,737-800,29,3,32,4,4,28,,,,,3,-1
2019-04-26 03:46,URC,5502,737-800,13,5,23,8,8,27,,,,,10,14
2019-04-26 03:42,CGO,1586,737-800,13,4,24,4,5,22,,,,,11,9
2019-04-26 03:35,URC,205T,737-800,12,2,24,3,3,24,,,,,12,12
2019-04-26 03:31,FOC,1351,737-800,21,4,30,3,3,25,,,,,9,4
2019-04-26 03:30,PEK,5538,737-800,10,2,26,2,2,26,,,,,16,16
2019-04-26 03:28,PEK,1785,737-800,9,2,18,3,4,20,,,,,9,11
2019-04-26 03:27,URC,5620,737-800,13,4,22,4,5,20,,,,,9,7
2019-04-26 03:22,HHA,1729,737-800,25,4,26,4,4,26,,,,,1,1
2019-04-26 03:16,CGO,5521,737-800,12,4,20,0,0,12,,,,,8,0
2019-04-26 03:14,CHO,7993,737-800,13,5,24,4,5,22,,,,,11,9
2019-04-26 03:12,XIY,1903,737-800,15,5,24,4,5,24,,,,,9,9
2019-04-26 03:10,CGO,7993,737-800,13,5,24,4,5,22,,,,,11,9
2019-04-26 03:10,URC,1322,737-800,14,3,23,5,4,24,,,,,9,10
2019-04-26 03:07,CGO,1587,737-800,15,2,20,3,3,20,,,,,5,5
2019-04-26 03:05,CAN,5579,737-800,27,6,35,6,6,33,,,,,8,6
2019-04-26 02:55,URC,6268,737-800,18,3,28,4,4,24,,,,,10,6
2019-04-26 02:52,XIY,5466,737-800,15,3,10,3,3,10,,,,,-5,-5
2019-04-26 02:51,URC,1101,737-800,16,2,28,2,2,22,,,,,12,6
2019-04-26 02:51,SYX,1787,737-800,30,2,32,2,2,31,,,,,2,1
2019-04-26 02:49,URC,2159,737-800,15,7,19,3,3,20,,,,,4,5
2019-04-26 02:47,SYX,206G,737-800,28,2,28,4,5,29,,,,,0,1
2019-04-26 02:47,XIY,1483,737-800,15,5,18,5,5,22,,,,,3,7
2019-04-26 02:46,CGO,5405,737-800,15,4,28,4,4,24,,,,,13,9
2019-04-26 02:46,SYX,7618,737-800,25,2,33,4,5,30,,,,,8,5
2019-04-26 02:42,XIY,1482,737-800,14,6,28,6,6,20,,,,,14,6
2019-04-26 02:36,KMG,7990,737-800,17,2,24,2,2,22,,,,,7,5
2019-04-26 02:36,SYX,6062,737-800,28,4,33,4,3,35,,,,,5,7
2019-04-26 02:35,URC,5502,737-800,13,23,5,8,8,27,,,,,-8,14
2019-04-26 02:34,URC,1568,737-800,15,6,26,6,6,21,,,,,11,6
2019-04-26 02:34,HGH,5337,737-800,25,4,26,4,4,26,,,,,1,1
2019-04-26 02:32,KMG,7167,737-800,19,5,26,6,6,22,,,,,7,3
2019-04-26 02:32,SYX,2158,737-800,28,6,29,4,4,27,,,,,1,-1
2019-04-26 02:30,URC,6103,737-800,15,6,23,6,6,23,,,,,8,8
2019-04-26 02:27,115,5709,737-800,10,4,25,4,4,21,,,,,15,11
2019-04-26 02:22,HAK,1541,737-800,27,2,31,6,5,32,,,,,4,5
2019-04-26 02:15,XIY,1929,737-800,15,4,24,4,4,24,,,,,9,9
2019-04-26 02:12,KMG,1588,737-800,20,3,23,5,4,25,,,,,3,5
2019-04-26 02:10,H?R?B,7395,737-800,7,6,24,6,6,22,,,,,17,15
2019-04-26 02:10,XIY ,5520,737-800,15,6,28,5,5,26,,,,,13,11
2019-04-26 02:08,HAK,1927,737-800,27,4,30,8,4,30,,,,,3,3
2019-04-26 02:07,HAK,1347,737-800,26,4,30,8,7,24,,,,,4,-2
2019-04-26 02:06,SZX,1372,737-800,29,6,32,3,4,30,,,,,3,1
2019-04-26 02:05,SZX,1549,737-800,27,6,31,5,6,21,,,,,4,-6
2019-04-26 02:04,TSN,7378,737-800,15,5,22,5,4,24,,,,,7,9
2019-04-26 02:01,URC,6995,737-800,15,4,25,4,4,24,,,,,10,9
2019-04-26 02:01,HAK,1502,737-800,30,3,31,4,4,31,,,,,1,1
2019-04-26 02:00,KMG,6015,737-800,17,4,24,4,4,22,,,,,7,5
2019-04-26 01:53,HHA,1490,737-800,25,4,28,4,4,28,,,,,3,3
2019-04-26 01:53,ZGC,5141,737-800,15,6,21,6,5,23,,,,,6,8
2019-04-26 01:53,XIY,1435,737-800,15,6,26,5,5,24,,,,,11,9
2019-04-26 01:52,XIY,1902,737-800,14,5,23,6,6,22,,,,,9,8
2019-04-26 01:51,ZGC,5853,737-800,15,7,25,6,7,24,,,,,10,9
2019-04-26 01:51,HAK,5428,737-800,28,4,30,6,4,32,,,,,2,4
2019-04-26 01:51,HAK,5428,737-800,28,4,30,6,4,32,,,,,2,4
2019-04-26 01:50,XIY,1501,737-800,14,4,28,4,4,24,,,,,14,10
2019-04-26 01:48,CAN,1487,737-800,28,3,34,3,3,28,,,,,6,0
2019-04-26 01:45,XIY,7886,737-800,15,4,26,6,4,28,,,,,11,13
2019-04-26 01:43,YIH,1905,737-800,22,4,27,4,3,23,,,,,5,1
2019-04-26 01:42,HAK,7639,737-800,26,5,36,8,7,32,1,,,1,10,6
2019-04-26 01:42,KMG ,1209,737-800,18,3,26,4,4,25,,,,,8,7
2019-04-26 01:41,XIY,5115,737-800,16,18,4,5,5,24,,,,,-12,8
2019-04-26 01:40,HAK,5481,737-800,28,4,31,4,4,30,,,,,3,2
2019-04-26 01:39,HAK,5358,737-800,28,8,33,6,7,32,,,,,5,4
2019-04-26 01:35,XIY,1498,737-800,15,5,25,5,5,27,,,,,10,12
2019-04-26 01:31,HHA,1491,737-800,25,6,32,5,5,32,,,,,7,7
2019-04-26 01:30,FOC,1348,737-800,21,5,32,4,3,28,,,,,11,7
2019-04-26 01:28,PEK,5539,737-800,12,4,22,5,5,24,,,,,10,12
2019-04-26 01:27,´óÁ¬,1495,737-800,16,2,24,2,2,20,,,,,8,4
2019-04-26 01:27,CAN,7377,737-800,30,7,32,6,6,33,,,,,2,3
2019-04-26 01:25,HHA,5408,737-800,25,4,22,6,6,26,,,,,-3,1
2019-04-26 01:24,HGH,1783,737-800,20,4,26,4,5,28,,,,,6,8
2019-04-26 01:23,SZX,5417,737-800,25,4,30,4,4,32,,,,,5,7
2019-04-26 01:21,HAK,1726,737-800,28,4,30,3,3,28,,,,,2,0
2019-04-26 01:19,PEK,5418,737-800,17,4,16,3,4,22,,,,,-1,5
2019-04-26 01:18,TYN,206F,737-800,10,3,22,2,2,20,,,,,12,10
2019-04-26 01:13,CAN,1489,737-800,29,4,32,5,4,31,,,,,3,2
2019-04-26 01:10,PEK,6066,737-800,15,2,22,2,2,21,,,,,7,6
2019-04-26 01:10,HAK,1103,737-800,25,3,31,4,4,31,,,,,6,6
2019-04-26 01:08,,1542,737-800,29,3,32,4,4,28,,,,,3,-1
2019-04-26 01:08,MIG,5449,737-800,30,4,29,5,5,28,,,,,-1,-2
2019-04-26 01:01,HAK,1547,737-800,28,5,31,8,8,26,,,,,3,-2
2019-04-26 01:00,URC,1328,737-800,15,4,26,4,4,20,,,,,11,5
2019-04-26 00:58,HAK,7619,737-800,27,5,28,5,5,28,,,,,1,1
2019-04-26 00:57,XIY,5478,737-800,15,4,22,4,4,21,,,,,7,6
2019-04-26 00:48,CAN,1141,737-800,27,6,35,6,6,31,,,,,8,4
2019-04-26 00:48,HAK,5580,737-800,25,5,35,4,4,30,1,,,1,10,5
2019-04-26 00:47,HAK,5580,737-800,25,6,32,6,6,35,,,,,7,10
2019-04-26 00:45,TYN,5686,737-800,10,2,20,2,2,18,,,,,10,8
2019-04-26 00:43,SYX,5138,737-800,28,4,33,4,4,34,,,,,5,6
2019-04-26 00:37,URC,1488,737-800,15,6,26,6,6,24,,,,,11,9
2019-04-26 00:37,MIG,5409,737-800,30,4,28,4,4,29,,,,,-2,-1
2019-04-26 00:37,URC,1488,737-800,15,6,26,6,6,24,,,,,11,9
2019-04-26 00:36,URC,5371,737-800,15,8,20,7,6,22,,,,,5,7
2019-04-26 00:31,TYN,7399,737-800,15,6,26,6,4,28,,,,,11,13
2019-04-26 00:29,HRB,7105,737-800,8,4,25,5,4,24,,,,,17,16
2019-04-26 00:28,HRB,7105,737-800,8,8,28,7,6,28,,,,,20,20
2019-04-26 00:25,URC,2157,737-800,10,4,24,6,6,20,,,,,14,10
2019-04-26 00:25,URC,5135,737-800,18,1,22,1,1,22,,,,,4,4
2019-04-26 00:23,SZX,1786,737-800,27,4,34,4,4,38,,1,,1,7,11
2019-04-26 00:22,PEK,7616,737-800,12,2,22,4,4,20,,,,,10,8
2019-04-26 00:22,HRB,1433,737-800,9,2,24,4,4,16,,,,,15,7
2019-04-26 00:19,CAN,5797,737-800,27,6,28,6,6,32,,,,,1,5
2019-04-26 00:19,KHG,1323,737-800,21,3,24,3,3,24,,,,,3,3
2019-04-26 00:18,SYX,1545,737-800,29,4,34,4,4,30,,,,,5,1
2019-04-26 00:16,HAK,5463,737-800,28,5,30,6,5,27,,,,,2,-1
2019-04-26 00:16,113,7175,737-800,14,3,25,4,4,21,,,,,11,7
2019-04-26 00:16,HAK,5479,737-800,25,6,29,6,6,31,,,,,4,6
2019-04-26 00:13,DLC,7173,737-800,13,3,26,4,5,24,,,,,13,11
2019-04-26 00:08,PEK,7398,737-800,20,4,22,4,3,20,,,,,2,0
2019-04-26 00:06,FOC,5182,737-800,28,3,25,3,4,26,,,,,-3,-2
2019-04-26 00:04,XIY,5153,737-800,16,2,24,3,3,25,,,,,8,9
2019-04-26 00:00,´óÁ¬,1215,737-800,8,4,26,6,6,20,,,,,18,12
2019-04-26 00:00,XIY ,5346,737-800,18,6,24,5,5,25,,,,,6,7
2019-04-25 23:56,FOC,1351,737-800,21,5,32,5,5,30,,,,,11,9
2019-04-25 23:56,HAK,5540,737-800,28,5,31,4,4,31,,,,,3,3
2019-04-25 23:52,PEK,7400,737-800,20,6,24,6,6,22,,,,,4,2
2019-04-25 23:52,PEK,1373,737-800,18,4,22,3,4,18,,,,,4,0
2019-04-25 23:50,HAK,6061,737-800,28,3,32,5,4,29,,,,,4,1
2019-04-25 23:47,FOC,5503,737-800,22,4,21,4,3,26,,,,,-1,4
2019-04-25 23:45,URC,205U,737-800,15,4,26,4,4,23,,,,,11,8
2019-04-25 23:38,CKG,5139,737-800,28,4,27,6,4,28,,,,,-1,0
2019-04-25 23:37,HGH,1725,737-800,30,5,28,5,5,28,,,,,-2,-2
2019-04-25 23:27,HRB,1559,737-800,8,3,21,2,2,21,,,,,13,13
2019-04-25 23:22,MIG,1798,737-800,30,4,30,5,5,27,,,,,0,-3
2019-04-25 23:21,CAN,1995,737-800,30,6,32,6,7,32,,,,,2,2
2019-04-25 23:19,XIY ,6063 ,737-800,15,6,24,4,4,22,,,,,9,7
2019-04-25 23:18,XIY ,6065,737-800,18,6,26,4,4,25,,,,,8,7
2019-04-25 23:06,PEK,1727,737-800,17,5,24,6,5,20,,,,,7,3
2019-04-25 23:06,HGH,5687,737-800,20,4,0,4,4,26,,,,,-20,6
2019-04-25 23:04,HAK,5089,737-800,29,4,29,9,8,30,,,,,0,1
2019-04-25 22:57,CAN ,5375,737-800,28,3,34,6,6,30,,,,,6,2
2019-04-25 22:50,HAK,5082,737-800,29,6,36,5,5,32,,,,,7,3
2019-04-25 22:37,URC,1569,737-800,14,3,26,3,3,26,,,,,12,12
2019-04-25 22:28,HAK,5522,737-800,29,5,33,4,5,32,,,,,4,3
2019-04-25 22:19,TYN,1735,737-800,10,3,20,8,8,20,,,,,10,10
2019-04-25 22:18,HAK,5136,737-800,28,4,34,4,5,33,,,,,6,5
2019-04-25 22:08,´óÁ¬,5662,737-800,10,2,20,4,6,20,,,,,10,10
2019-04-25 22:01,TYN,1735,737-800,10,0,0,0,0,0,,,,,-10,-10
2019-04-25 21:47,HAK,5373,737-800,30,6,32,8,8,33,,,,,2,3
2019-04-25 21:42,HAK,206H,737-800,29,3,33,3,3,32,,,,,4,3
2019-04-25 21:42,XNN,1102,737-800,19,3,22,4,4,22,,,,,3,3
2019-04-25 21:41,HAK,206H,737-800,29,3,33,3,3,32,,,,,4,3
2019-04-25 21:31,MIG,7988,737-800,29,4,31,3,3,30,,,,,2,1
2019-04-25 21:27,DLC,1375,737-800,13,4,22,3,4,20,,,,,9,7
2019-04-25 21:14,URC,5416,737-800,9,8,25,8,8,25,,,,,16,16
2019-04-25 21:14,URC,5416,737-800,9,8,25,8,8,25,,,,,16,16
2019-04-25 20:29,PEK,7400,737-800,16,6,24,6,6,22,,,,,8,6
2019-04-25 20:14,DLC,7172,737-800,11,5,25,6,5,23,,,,,14,12
2019-04-25 20:04,DLC,1799,737-800,13,4,26,4,4,26,,,,,13,13
2019-04-25 18:52,KMG,6016,737-800,28,4,25,4,5,24,,,,,-3,-4
2019-04-25 18:10,XIY,1481,737-800,30,2,24,2,4,24,,,,,-6,-6
2019-04-25 17:24,CGO,5623,737-800,20,5,25,4,5,25,,,,,5,5
2019-04-25 17:06,CTU,7989,737-800,37,5,34,5,5,32,,,,,-3,-5
2019-04-25 16:09,XIY,5153,737-800,30,2,28,4,4,30,,,,,-2,0
2019-04-25 15:17,URC,1325,737-800,22,4,20,4,4,20,,,,,-2,-2
2019-04-25 14:18,URC,7198,737-800,15,2,22,3,3,23,,,,,7,8
2019-04-25 12:50,XUZ,7992,737-800,15,6,25,5,6,23,,,,,10,8
2019-04-25 11:26,HHA,7379,737-800,24,4,31,4,4,34,,,,,7,10
2019-04-25 11:20,CTU,7989,737-800,37,6,32,6,5,32,,,,,-5,-5
2019-04-25 09:22,HAK,5358,737-800,29,8,32,8,8,35,,,,,3,6
2019-04-25 09:22,HAK,5687,737-800,31,4,0,5,5,32,,,,,-31,1
2019-04-25 09:22,HAK,5687,737-800,31,4,0,5,5,32,,,,,-31,1
2019-04-25 09:03,HAK,5373,737-800,29,8,33,7,7,32,,,,,4,3
2019-04-25 08:08,DLC,5662,737-800,13,2,21,2,5,20,,,,,8,7
2019-04-25 08:03,SZX,5462,737-800,27,4,30,4,5,32,,,,,3,5
2019-04-25 08:02,PEK,1372,737-800,10,5,24,4,4,20,,,,,14,10
2019-04-25 07:56,ZGC,5138,737-800,15,6,21,4,5,22,,,,,6,7
2019-04-25 07:34,ZGC,5853,737-800,20,5,24,6,4,22,,,,,4,2
2019-04-25 07:33,ZGC,5428,737-800,20,4,21,4,4,28,,,,,1,8
2019-04-25 07:24,KMG,1208,737-800,20,3,23,3,2,20,,,,,3,0
2019-04-25 06:55,XMN,5661,737-800,24,6,22,8,8,24,,,,,-2,0
2019-04-25 06:54,XMN,1493,737-800,24,6,30,6,6,28,,,,,6,4
2019-04-25 06:53,XMN,5636,737-800,25,4,22,6,4,20,,,,,-3,-5
2019-04-25 06:53,XMN,5416,737-800,25,8,30,8,8,34,,,,,5,9
2019-04-25 06:52,XMN,5408,737-800,25,3,20,2,3,20,,,,,-5,-5
2019-04-25 06:52,PEK,1728,737-800,11,4,24,4,5,20,,,,,13,9
2019-04-25 06:41,XIY,1350,737-800,18,4,24,4,4,22,,,,,6,4
2019-04-25 06:31,URC,5481,737-800,16,6,27,4,5,26,,,,,11,10
2019-04-25 06:30,URC,7198,737-800,17,6,25,5,5,26,,,,,8,9
2019-04-25 06:26,XIY,5153,737-800,20,4,24,4,4,28,,,,,4,8
2019-04-25 06:18,XIY,5520,737-800,19,5,30,6,5,24,,,,,11,5
2019-04-25 06:11,PEK,5712,737-800,9,3,12,3,3,14,,,,,3,5
2019-04-25 06:07,PEK,5482,737-800,8,9,32,8,9,28,,,,,24,20
2019-04-25 05:42,XIY,1481,737-800,20,5,27,7,6,25,,,,,7,5
2019-04-25 05:35,XIY,5116,737-800,20,4,20,5,4,20,,,,,0,0
2019-04-25 05:28,PEK,5418,737-800,7,4,14,9,3,18,,,,,7,11
2019-04-25 05:21,PEK,5538,737-800,10,7,23,6,7,24,,,,,13,14
2019-04-25 05:07,FOC,1480,737-800,24,5,25,3,4,24,,,,,1,0
2019-04-25 05:05,KMG,1587,737-800,20,3,22,6,4,22,,,,,2,2
2019-04-25 05:05,KMG,1209,737-800,20,3,25,3,3,20,,,,,5,0
2019-04-25 04:58,URC ,205U,737-800,17,6,24,2,3,21,,,,,7,4
2019-04-25 04:56,URC ,5620,737-800,17,4,21,4,4,20,,,,,4,3
2019-04-25 04:55,URC ,5135,737-800,18,0,18,0,0,14,,,,,0,-4
2019-04-25 04:55,URC ,6268 ,737-800,19,4,25,3,4,24,,,,,6,5
2019-04-25 04:54,URC ,206P,737-800,16,4,22,6,4,20,,,,,6,4
2019-04-25 04:53,URC ,5371,737-800,18,6,22,4,5,23,,,,,4,5
2019-04-25 04:53,CKG,5139,737-800,26,4,26,6,4,24,,,,,0,-2
2019-04-25 04:51,CKG,5429,737-800,27,4,26,4,4,28,,,,,-1,1
2019-04-25 04:50,HAK,5405,737-800,28,6,33,6,5,32,,,,,5,4
2019-04-25 04:48,ÐìÖÝ,6016,737-800,20,3,29,3,4,28,,,,,9,8
2019-04-25 04:48,XIY,7113,737-800,18,4,26,5,5,22,,,,,8,4
2019-04-25 04:32,CAN,1141,737-800,27,0,30,0,0,32,,,,,3,5
2019-04-25 04:29,HAK,1502,737-800,27,4,28,7,4,28,,,,,1,1
2019-04-25 04:16,HHA,1346,737-800,26,6,34,5,5,30,,,,,8,4
2019-04-25 04:12,XIY,5115,737-800,20,3,17,6,6,27,,,,,-3,7
2019-04-25 04:11,XIY,1483,737-800,20,5,23,6,6,23,,,,,3,3
2019-04-25 04:05,PEK,5539,737-800,8,4,20,4,4,20,,,,,12,12
2019-04-25 04:03,CGO,1929,737-800,15,2,22,6,8,26,,,,,7,11
2019-04-25 03:56,CAN,5798,737-800,25,3,28,2,2,28,,,,,3,3
2019-04-25 03:52,HAK,1927,737-800,27,4,33,5,4,31,,,,,6,4
2019-04-25 03:50,HAK,5540,737-800,27,3,32,6,6,32,,,,,5,5
2019-04-25 03:45,KMG,7991,737-800,20,6,23,6,7,22,,,,,3,2
2019-04-25 03:44,SZX,1103,737-800,26,4,34,4,4,32,,,,,8,6
2019-04-25 03:42,HAK,5523,737-800,29,5,33,6,5,27,,,,,4,-2
2019-04-25 03:42,YIH,5430,737-800,18,5,28,6,6,30,,,,,10,12
2019-04-25 03:40,SYX,1542,737-800,28,4,33,5,4,32,,,,,5,4
2019-04-25 03:40,SYX,2158,737-800,28,8,31,4,4,28,,,,,3,0
2019-04-25 03:39,HAK,7377,737-800,25,6,32,4,4,32,,,,,7,7
2019-04-25 03:31,FOC,1348,737-800,23,4,32,4,3,28,,,,,9,5
2019-04-25 03:24,KMG,5732,737-800,23,3,22,3,4,21,,,,,-1,-2
2019-04-25 03:22,HHA,5637,737-800,26,2,26,1,1,26,,,,,0,0
2019-04-25 03:21,HGH,1541,737-800,21,5,30,5,4,28,,,,,9,7
2019-04-25 03:17,SZX,6065,737-800,26,6,35,5,5,32,,,,,9,6
2019-04-25 03:16,XIY,6063,737-800,20,6,26,6,6,26,,,,,6,6
2019-04-25 03:11,XIY,1538,737-800,20,2,22,7,8,35,,1,,1,2,15
2019-04-25 03:11,TYN,206F,737-800,11,4,22,4,4,20,,,,,11,9
2019-04-25 03:11,SYX,1545,737-800,28,2,30,6,6,32,,,,,2,4
2019-04-25 03:10,XXIY,1903,737-800,20,2,26,2,2,24,,,,,6,4
2019-04-25 03:10,HAK,6061,737-800,27,4,32,5,5,30,,,,,5,3
2019-04-25 03:08,HHA,1490,737-800,20,5,30,5,5,28,,,,,10,8
2019-04-25 03:08,DLC,5466,737-800,12,4,22,3,4,24,,,,,10,12
2019-04-25 03:07,XIY,1902,737-800,20,4,24,6,5,24,,,,,4,4
2019-04-25 03:06,PEK,5538,737-800,10,3,24,4,4,24,,,,,14,14
2019-04-25 03:04,HGH,5581,737-800,20,6,24,5,5,25,,,,,4,5
2019-04-25 03:03,XIY,1161,737-800,20,2,17,4,6,19,,,,,-3,-1
2019-04-25 02:59,TYN,5686,737-800,10,4,22,5,5,20,,,,,12,10
2019-04-25 02:59,KMG,5449,737-800,20,5,24,5,5,22,,,,,4,2
2019-04-25 02:58,XIY,5623,737-800,17,6,28,6,6,24,,,,,11,7
2019-04-25 02:57,XIY,1163,737-800,21,2,27,2,2,27,,,,,6,6
2019-04-25 02:54,CGO,7993,737-800,15,6,26,7,7,23,,,,,11,8
2019-04-25 02:53,KMG,7992,737-800,18,7,24,6,7,22,,,,,6,4
2019-04-25 02:53,YIH,1905,737-800,18,4,26,4,4,24,,,,,8,6
2019-04-25 02:52,HGH,1996,737-800,25,4,20,3,3,24,,,,,-5,-1
2019-04-25 02:51,KMG,1588,737-800,17,4,22,3,3,20,,,,,5,3
2019-04-25 02:49,SYX,1787,737-800,30,1,31,2,2,30,,,,,1,0
2019-04-25 02:48,HHA,1733,737-800,25,3,28,4,3,24,,,,,3,-1
2019-04-25 02:48,DLC,5662,737-800,13,2,21,2,5,20,,,,,8,7
2019-04-25 02:46,MIG,7988,737-800,25,6,28,4,4,27,,,,,3,2
2019-04-25 02:45,SYX,5713,737-800,30,5,30,6,6,32,,,,,0,2
2019-04-25 02:42,SYX,7619,737-800,28,6,36,6,5,30,,,,,8,2
2019-04-25 02:40,URC,5502,737-800,15,5,22,5,6,18,,,,,7,3
2019-04-25 02:40,PEK,1497,737-800,6,4,22,4,4,24,,,,,16,18
2019-04-25 02:39,PEK,1799,737-800,10,5,27,4,4,28,,,,,17,18
2019-04-25 02:38,URC,5638,737-800,17,6,24,4,4,20,,,,,7,3
2019-04-25 02:38,URC,6103,737-800,15,5,20,5,6,22,,,,,5,7
2019-04-25 02:38,CAN,5855,737-800,27,6,31,6,6,29,,,,,4,2
2019-04-25 02:37,FOC,7400,737-800,23,5,28,4,4,26,,,,,5,3
2019-04-25 02:37,PEK,5709,737-800,6,25,4,5,5,20,,,,,-2,14
2019-04-25 02:36,HAK,7171,737-800,27,7,32,8,6,31,,,,,5,4
2019-04-25 02:36,FOC,7400,737-800,23,6,30,4,5,30,,,,,7,7
2019-04-25 02:35,URC,2159,737-800,20,4,24,2,2,20,,,,,4,0
2019-04-25 02:33,SZX,5417,737-800,27,4,30,4,4,31,,,,,3,4
2019-04-25 02:33,DLC,5346,737-800,15,5,20,5,6,21,,,,,5,6
2019-04-25 02:27,XIY,1735,737-800,20,4,23,5,5,22,,,,,3,2
2019-04-25 02:24,HGH,5733,737-800,20,6,26,4,4,26,,,,,6,6
2019-04-25 02:22,CAN,1213,737-800,27,10,39,4,4,34,1,,,1,12,7
2019-04-25 02:20,HAK,1786,737-800,28,4,33,3,4,30,,,,,5,2
2019-04-25 02:16,XIY,1795,737-800,25,4,26,5,5,25,,,,,1,0
2019-04-25 02:11,SYX,5337,737-800,28,3,31,3,4,32,,,,,3,4
2019-04-25 02:09,HAK,5338,737-800,25,4,26,5,6,21,,,,,1,-4
2019-04-25 01:59,DLC,7172,737-800,11,4,26,5,4,24,,,,,15,13
2019-04-25 01:57,HAK,5797,737-800,27,4,26,3,4,26,,,,,-1,-1
2019-04-25 01:57,SYX,206G,737-800,28,4,34,2,4,32,,,,,6,4
2019-04-25 01:54,DLC,7173,737-800,20,4,18,5,5,20,,,,,-2,0
2019-04-25 01:52,DLC,1415,737-800,15,4,24,4,4,22,,,,,9,7
2019-04-25 01:51,FOC,1562,737-800,24,4,28,4,4,29,,,,,4,5
2019-04-25 01:50,DLC,1375,737-800,20,5,22,6,5,24,,,,,2,4
2019-04-25 01:47,MIG,6809,737-800,26,5,26,5,5,27,,,,,0,1
2019-04-25 01:46,CAN,5467,737-800,27,2,32,2,1,24,,,,,5,-3
2019-04-25 01:42,DLC,1215,737-800,10,4,18,4,4,20,,,,,8,10
2019-04-25 01:41,HGH,7616,737-800,20,4,24,2,2,24,,,,,4,4
2019-04-25 01:37,HAK,1995,737-800,25,4,26,6,4,26,,,,,1,1
2019-04-25 01:33,TYN,1130,737-800,10,2,24,2,2,18,,,,,14,8
2019-04-25 01:29,HRB,7395,737-800,6,5,21,5,6,20,,,,,15,14
2019-04-25 01:25,PEK,1785,737-800,7,0,24,8,8,22,,,,,17,15
2019-04-25 01:22,HGH,1131,737-800,22,4,30,3,3,30,,,,,8,8
2019-04-25 01:22,XIY,5180,737-800,21,6,26,8,6,26,,,,,5,5
2019-04-25 01:17,CGO,1570,737-800,19,6,25,4,6,20,,,,,6,1
2019-04-25 01:17,1373,1373,737-800,22,4,24,4,4,20,,,,,2,-2
2019-04-25 01:14,PEK,1505,737-800,5,3,20,3,3,21,,,,,15,16
2019-04-25 01:13,HAK,1102,737-800,25,6,33,10,9,28,,,,,8,3
2019-04-25 01:12,HAK,1347,737-800,29,4,35,4,4,30,,,,,6,1
2019-04-25 01:11,XIY,1482,737-800,21,4,28,4,4,24,,,,,7,3
2019-04-25 01:10,TYN,7399,737-800,10,4,24,4,4,24,,,,,14,14
2019-04-25 01:07,KMG,7990,737-800,19,2,26,4,3,24,,,,,7,5
2019-04-25 01:04,CGO,1586,737-800,20,0,20,4,4,25,,,,,0,5
2019-04-25 01:03,HAK,7639,737-800,28,6,36,6,6,32,,,,,8,4
2019-04-25 01:02,CAN,1489,737-800,27,3,32,4,4,31,,,,,5,4
2019-04-25 01:00,CAN,1487,737-800,25,3,32,3,3,30,,,,,7,5
2019-04-25 00:59,CTU,5372,737-800,30,8,26,6,6,25,,,,,-4,-5
2019-04-25 00:57,HAK,5479,737-800,25,6,28,9,8,30,,,,,3,5
2019-04-25 00:55,HRB,7105,737-800,10,4,20,4,4,20,,,,,10,10
2019-04-25 00:54,URC,1325,737-800,22,4,20,4,4,20,,,,,-2,-2
2019-04-25 00:53,SYX,6062,737-800,28,7,36,4,4,36,,,,,8,8
2019-04-25 00:53,PEK,5735,737-800,5,0,9,0,0,10,,,,,4,5
2019-04-25 00:43,CAN,1797,737-800,28,4,32,4,4,30,,,,,4,2
2019-04-25 00:42,CAN,5375,737-800,26,4,32,6,6,30,,,,,6,4
2019-04-25 00:41,CGO,6015,737-800,20,4,30,4,4,26,,,,,10,6
2019-04-25 00:38,KHG,1569,737-800,23,4,26,3,3,25,,,,,3,2
2019-04-25 00:37,SZX,1549,737-800,27,5,34,5,4,32,,,,,7,5
2019-04-25 00:36,HAK,5439,737-800,27,6,32,4,4,32,,,,,5,5
2019-04-25 00:33,HHA,5579,737-800,27,6,33,6,7,32,,,,,6,5
2019-04-25 00:32,PEK,1501,737-800,10,6,24,5,7,25,,,,,14,15
2019-04-25 00:32,HHA,5579,737-800,27,6,33,6,7,32,,,,,6,5
2019-04-25 00:30,SYX,7378,737-800,28,6,30,6,6,30,,,,,2,2
2019-04-25 00:29,CGO,5521,737-800,20,5,24,3,4,20,,,,,4,0
2019-04-25 00:23,CAN,1491,737-800,28,6,32,4,5,33,,,,,4,5
2019-04-25 00:16,CAN,1386,737-800,28,3,32,4,3,28,,,,,4,0
2019-04-25 00:15,HAK,5089,737-800,30,4,28,1,2,32,,,,,-2,2
2019-04-25 00:13,SZX,1726,737-800,26,4,32,4,4,30,,,,,6,4
2019-04-25 00:12,URC,1488,737-800,20,4,23,4,5,24,,,,,3,4
2019-04-25 00:10,HAK,5407,737-800,27,6,36,4,4,34,,,,,9,7
2019-04-25 00:10,HAK,5407,737-800,27,6,36,4,4,34,,,,,9,7
2019-04-25 00:06,HGH,5625,737-800,28,4,30,4,4,26,,,,,2,-2
2019-04-25 00:03,PEK,6060,737-800,7,6,24,6,5,22,,,,,17,15
2019-04-25 00:01,HAK,1793,737-800,27,5,36,4,4,30,,,,,9,3
2019-04-25 00:00,PEK,7175,737-800,6,5,25,6,5,20,,,,,19,14
2019-04-24 23:56,HRB,1559,737-800,7,2,7,2,2,14,,,,,0,7
2019-04-24 23:54,CGO,7167,737-800,21,4,27,4,4,25,,,,,6,4
2019-04-24 23:48,URC,1322,737-800,19,4,22,4,4,23,,,,,3,4
2019-04-24 23:46,URC ,1323,737-800,20,4,24,4,3,25,,,,,4,5
2019-04-24 23:46,CKG,7618,737-800,26,6,28,6,4,27,,,,,2,1
2019-04-24 23:44,XIY,1727,737-800,23,6,28,5,6,22,,,,,5,-1
2019-04-24 23:33,HHA,1729,737-800,26,5,26,5,5,26,,,,,0,0
2019-04-24 23:27,URC,205T,737-800,20,2,24,2,2,24,,,,,4,4
2019-04-24 23:26,MIG,1798,737-800,28,6,28,5,5,25,,,,,0,-3
2019-04-24 23:16,HAK,6066,737-800,28,3,35,4,4,31,,,,,7,3
2019-04-24 23:16,HAK,5090,737-800,28,2,32,3,3,31,,,,,4,3
2019-04-24 23:04,HAK,5082,737-800,28,6,35,4,4,32,,,,,7,4
2019-04-24 23:00,XNN,1498,737-800,19,6,22,6,6,0,,,,,3,-19
2019-04-24 22:58,URC,1997,737-800,20,3,21,3,4,20,,,,,1,0
2019-04-24 22:50,HAK,206H,737-800,28,4,29,4,5,30,,,,,1,2
2019-04-24 22:46,XIY,7886,737-800,20,2,18,3,6,21,,,,,-2,1
2019-04-24 22:45,XIY,5359,737-800,23,4,22,6,4,24,,,,,-1,1
2019-04-24 22:31,FOC,5182,737-800,25,3,27,4,3,26,,,,,2,1
2019-04-24 21:58,TYN,1496,737-800,10,5,22,4,5,21,,,,,12,11
2019-04-24 21:55,HRB,1433,737-800,10,3,13,3,3,17,,,,,3,7
2019-04-24 21:45,XNN,5463,737-800,19,5,24,5,4,16,,,,,5,-3
2019-04-24 20:38,HHA,1796,737-800,25,6,26,4,4,24,,,,,1,-1
2019-04-24 20:25,HAK,5136,737-800,30,4,34,6,6,34,,,,,4,4
2019-04-24 19:44,FOC,1906,737-800,26,6,34,6,7,31,,,,,8,5
2019-04-24 19:43,FOC,1906,737-800,26,6,34,6,7,31,,,,,8,5
2019-04-24 18:31,CGO,5141,737-800,25,5,26,6,6,27,,,,,1,2
2019-04-24 18:08,HGH,1783,737-800,26,4,26,4,4,32,,,,,0,6
2019-04-24 18:07,HGH,1783,737-800,26,4,26,4,4,32,,,,,0,6
2019-04-24 18:06,HGH,1783,737-800,26,4,26,4,4,32,,,,,0,6
2019-04-24 17:19,URC,6995,737-800,21,4,24,8,8,22,,,,,3,1
2019-04-24 16:04,URC,1928,737-800,22,4,22,5,5,24,,,,,0,2
2019-04-24 12:06,CAN,5855,737-800,28,7,30,7,7,30,,,,,2,2
2019-04-24 10:48,CTU,7989,737-800,40,6,32,6,4,31,,,,,-8,-9
2019-04-24 09:50,XIY,1735,737-800,19,4,25,5,4,22,,,,,6,3
2019-04-24 09:50,XIY,5430,737-800,19,4,22,3,4,23,,,,,3,4
2019-04-24 09:22,XIY,1483,737-800,20,5,23,5,5,29,,,,,3,9
2019-04-24 09:18,HAK,1491,737-800,26,5,34,4,4,33,,,,,8,7
2019-04-24 09:16,HAK,1491,737-800,26,5,34,5,5,34,,,,,8,8
2019-04-24 08:56,KMG,6016,737-800,20,4,25,4,4,25,,,,,5,5
2019-04-24 08:55,KMG,5732,737-800,20,2,22,2,2,22,,,,,2,2
2019-04-24 08:36,HAK,1548.,737-800,27,5,30,5,5,0,,,,,3,-27
2019-04-24 08:36,PEK,6060,737-800,19,5,28,4,4,25,,,,,9,6
2019-04-24 08:27,CKG,7618,737-800,22,6,29,6,6,28,,,,,7,6
2019-04-24 08:01,HAK,5540,737-800,27,4,6,6,6,32,,,,,-21,5
2019-04-24 07:40,ZGC,1493,737-800,15,3,22,4,3,22,,,,,7,7
2019-04-24 07:38,ZGC,5428,737-800,15,4,24,3,4,24,,,,,9,9
2019-04-24 07:36,ZGC,7378,737-800,15,8,22,6,7,23,,,,,7,8
2019-04-24 07:32,HAK,7399,737-800,30,2,32,4,5,33,,,,,2,3
2019-04-24 07:31,HAK,6065,737-800,30,5,36,5,4,32,,,,,6,2
2019-04-24 07:29,HHA,5637,737-800,22,3,22,3,3,23,,,,,0,1
2019-04-24 07:02,XMN,1102,737-800,23,5,26,5,5,28,,,,,3,5
2019-04-24 07:01,XMN,5636,737-800,23,4,25,5,7,27,,,,,2,4
2019-04-24 06:59,XMN,5416,737-800,23,5,27,4,6,28,,,,,4,5
2019-04-24 06:59,XIY,1350,737-800,18,3,26,4,4,22,,,,,8,4
2019-04-24 06:58,XMN,5138,737-800,28,3,31,4,3,34,,,,,3,6
2019-04-24 06:57,XMN,1103,737-800,25,3,30,3,3,30,,,,,5,5
2019-04-24 06:17,CKG,1726,737-800,20,4,29,4,4,26,,,,,9,6
2019-04-24 05:40,HAK,5089,737-800,30,6,32,3,3,30,,,,,2,0
2019-04-24 05:37,FOC,1562,737-800,24,4,30,4,4,30,,,,,6,6
2019-04-24 05:01,URC,5502,737-800,16,3,20,3,2,21,,,,,4,5
2019-04-24 05:00,FOC,1559,737-800,24,3,32,3,3,28,,,,,8,4
2019-04-24 05:00,FOC,1435,737-800,23,5,30,6,5,26,,,,,7,3
2019-04-24 04:45,DLC,1795,737-800,15,4,24,4,4,24,,,,,9,9
2019-04-24 04:34,PEK,5538,737-800,20,3,30,2,2,29,,,,,10,9
2019-04-24 04:34,KMG,7988,737-800,20,5,24,5,4,24,,,,,4,4
2019-04-24 04:31,HAK,1548,737-800,27,5,30,5,5,0,,,,,3,-27
2019-04-24 04:29,FOC,5182,737-800,24,3,30,3,4,28,,,,,6,4
2019-04-24 04:26,XIY,5180,737-800,22,6,28,6,6,26,,,,,6,4
2019-04-24 04:21,CAN,5798,737-800,28,2,26,3,2,26,,,,,-2,-2
2019-04-24 04:16,HHA,1505,737-800,25,2,28,3,4,26,,,,,3,1
2019-04-24 04:04,SYX,1542,737-800,27,4,34,4,4,32,,,,,7,5
2019-04-24 04:03,URC,1568,737-800,9,6,25,5,6,25,,,,,16,16
2019-04-24 04:00,SYX,2158,737-800,27,8,30,4,4,28,,,,,3,1
2019-04-24 03:59,SHA,1928,737-800,23,5,22,6,4,25,,,,,-1,2
2019-04-24 03:59,SHA,1503,737-800,25,4,29,4,3,28,,,,,4,3
2019-04-24 03:57,CAN,1799,737-800,28,5,34,5,4,32,,,,,6,4
2019-04-24 03:57,XOY,1902,737-800,19,4,24,4,4,23,,,,,5,4
2019-04-24 03:45,PEK,1372,737-800,23,6,28,4,4,26,,,,,5,3
2019-04-24 03:45,PEK,1372,737-800,23,6,28,4,4,26,,,,,5,3
2019-04-24 03:45,KMG,1208,737-800,20,5,24,6,6,12,,,,,4,-8
2019-04-24 03:43,XIY,1163,737-800,20,2,28,2,2,28,,,,,8,8
2019-04-24 03:43,HHA,1733,737-800,23,3,26,4,4,26,,,,,3,3
2019-04-24 03:40,HHA,1729,737-800,20,4,22,4,4,22,,,,,2,2
2019-04-24 03:40,SYX,5358,737-800,29,4,30,4,3,32,,,,,1,3
2019-04-24 03:31,KMG,5407,737-800,20,4,24,6,4,23,,,,,4,3
2019-04-24 03:28,SZX,5852,737-800,28,5,35,3,4,34,,,,,7,6
2019-04-24 03:24,HGH,1785,737-800,25,4,28,4,4,29,,,,,3,4
2019-04-24 03:22,HHA,1213,737-800,22,6,32,6,6,30,1,,,1,10,8
2019-04-24 03:21,DLC,5466,737-800,14,2,20,8,2,16,,,,,6,2
2019-04-24 03:20,DLC,5466,737-800,14,2,20,8,2,16,,,,,6,2
2019-04-24 03:17,CAN,5338,737-800,27,2,28,3,3,32,,,,,1,5
2019-04-24 03:16,DLC,1490,737-800,20,5,24,6,5,22,,,,,4,2
2019-04-24 03:16,DLC,1490,737-800,20,5,24,6,5,22,,,,,4,2
2019-04-24 03:12,HAK,6061,737-800,26,4,34,5,4,30,,,,,8,4
2019-04-24 03:10,DLC,7172,737-800,13,3,26,4,4,25,,,,,13,12
2019-04-24 03:09,XIY,5115,737-800,20,4,18,3,2,20,,,,,-2,0
2019-04-24 03:07,DLC,1375,737-800,13,4,22,4,3,22,,,,,9,9
2019-04-24 03:06,HAK,5797,737-800,26,5,27,6,6,30,,,,,1,4
2019-04-24 03:05,URC,1725,737-800,15,4,26,5,4,26,,,,,11,11
2019-04-24 03:01,URC,6268,737-800,15,4,24,4,5,24,,,,,9,9
2019-04-24 03:01,URC,2159,737-800,15,4,24,4,5,25,,,,,9,10
2019-04-24 02:55,SZX,1549,737-800,25,6,30,6,6,32,,,,,5,7
2019-04-24 02:54,KMG,7992,737-800,19,6,24,8,7,23,,,,,5,4
2019-04-24 02:54,CAN,1727,737-800,28,5,35,5,5,30,,,,,7,2
2019-04-24 02:52,HNA,5429,737-800,27,2,31,2,3,32,,,,,4,5
2019-04-24 02:50,HNA,7639,737-800,27,7,34,8,7,32,,,,,7,5
2019-04-24 02:47,XIY,206H,737-800,18,3,24,2,2,24,,,,,6,6
2019-04-24 02:47,PEK,5482,737-800,22,2,27,3,3,27,,,,,5,5
2019-04-24 02:46,URC,1501,737-800,15,6,20,5,5,22,,,,,5,7
2019-04-24 02:45,SYX,5581,737-800,28,9,30,6,4,36,,,,,2,8
2019-04-24 02:43,DLC,1131,737-800,13,4,32,7,8,30,1,,,1,19,17
2019-04-24 02:39,CKG,5139,737-800,20,3,27,6,4,27,,,,,7,7
2019-04-24 02:38,TYN,1130,737-800,15,5,12,6,6,13,,,,,-3,-2
2019-04-24 02:38,CAN,1786,737-800,26,4,33,4,4,30,,,,,7,4
2019-04-24 02:35,CGO,7167,737-800,20,5,28,5,5,26,,,,,8,6
2019-04-24 02:34,SYX,5337,737-800,27,4,34,6,5,34,,,,,7,7
2019-04-24 02:34,URC,2157,737-800,9,4,22,8,6,26,,,,,13,17
2019-04-24 02:33,KMG,7993,737-800,20,6,25,7,7,23,,,,,5,3
2019-04-24 02:31,PEK,7377,737-800,21,6,27,6,5,28,,,,,6,7
2019-04-24 02:30,CGO,6015,737-800,19,4,25,4,4,24,,,,,6,5
2019-04-24 02:27,URC,5623,737-800,14,6,24,4,5,23,,,,,10,9
2019-04-24 02:27,URC,205T,737-800,15,3,22,3,3,23,,,,,7,8
2019-04-24 02:25,XIY,1373,737-800,21,4,24,4,5,23,,,,,3,2
2019-04-24 02:25,PEK ,1502,737-800,21,3,28,4,4,25,,,,,7,4
2019-04-24 02:23,XIY,6063,737-800,20,6,28,6,6,28,,,,,8,8
2019-04-24 02:22,XIY,5116,737-800,20,4,20,4,4,28,,,,,0,8
2019-04-24 02:20,URC,6995,737-800,15,3,24,4,4,24,,,,,9,9
2019-04-24 02:19,HHA,1346,737-800,24,5,31,5,5,28,,,,,7,4
2019-04-24 02:09,HGH,5479,737-800,20,4,26,4,3,26,,,,,6,6
2019-04-24 02:09,XIY,1482,737-800,21,5,26,4,5,25,,,,,5,4
2019-04-24 02:09,URC,1997,737-800,16,3,23,1,2,21,,,,,7,5
2019-04-24 02:07,KMG,7990,737-800,20,4,25,6,4,22,,,,,5,2
2019-04-24 02:05,FOC,5625,737-800,24,4,29,4,4,29,,,,,5,5
2019-04-24 02:04,TYN ,5686,737-800,20,4,24,6,6,22,,,,,4,2
2019-04-24 02:04,CAN,1386,737-800,27,3,30,4,3,28,,,,,3,1
2019-04-24 02:01,URC,6103,737-800,9,6,22,6,6,22,,,,,13,13
2019-04-24 02:00,TYN,206F,737-800,18,4,24,2,2,22,,,,,6,4
2019-04-24 01:59,SZX,5153,737-800,25,3,34,4,4,33,,,,,9,8
2019-04-24 01:58,SZX,1492,737-800,26,2,30,2,2,30,,,,,4,4
2019-04-24 01:50,URC,5971,737-800,13,8,18,6,6,21,,,,,5,8
2019-04-24 01:50,CAN,5372,737-800,25,8,34,8,8,30,,,,,9,5
2019-04-24 01:49,XIY,1162,737-800,20,3,24,2,2,24,,,,,4,4
2019-04-24 01:48,SZX,1496,737-800,30,6,34,5,5,36,,,,,4,6
2019-04-24 01:46,XIY,5478,737-800,20,4,26,5,5,28,,,,,6,8
2019-04-24 01:46,URC,1997,737-800,16,3,23,1,2,21,,,,,7,5
2019-04-24 01:45,HAK,1793,737-800,27,5,34,4,4,32,,,,,7,5
2019-04-24 01:43,CGO,1586,737-800,20,3,28,3,3,26,,,,,8,6
2019-04-24 01:41,XIY,5359,737-800,22,4,28,3,3,24,,,,,6,2
2019-04-24 01:41,YIH,1905,737-800,30,3,27,3,3,23,,,,,-3,-7
2019-04-24 01:41,HAK,5580,737-800,29,7,34,7,7,35,,,,,5,6
2019-04-24 01:41,PEK,5638,737-800,23,4,26,4,4,28,,,,,3,5
2019-04-24 01:40,MIG,1587,737-800,24,5,27,3,3,25,,,,,3,1
2019-04-24 01:40,HAK,6065,737-800,30,5,36,5,4,32,,,,,6,2
2019-04-24 01:40,MIG,1798,737-800,25,6,27,4,4,25,,,,,2,0
2019-04-24 01:40,MIG,1587,737-800,24,5,27,3,3,25,,,,,3,1
2019-04-24 01:39,HAK,6066,737-800,28,2,32,2,2,30,,,,,4,2
2019-04-24 01:38,HAK,1487,737-800,28,4,32,4,4,31,,,,,4,3
2019-04-24 01:36,HGH,5462,737-800,25,4,29,5,4,29,,,,,4,4
2019-04-24 01:33,HAK,5136,737-800,27,5,32,4,4,36,,,,,5,9
2019-04-24 01:32,URC,1322,737-800,16,3,22,3,4,23,,,,,6,7
2019-04-24 01:32,HAK,7400,737-800,27,5,30,5,5,31,,,,,3,4
2019-04-24 01:31,HAK,5522,737-800,28,5,35,9,8,34,,,,,7,6
2019-04-24 01:29,CGO,7991,737-800,20,6,28,6,6,27,,,,,8,7
2019-04-24 01:27,URC,5620,737-800,15,4,24,3,4,22,,,,,9,7
2019-04-24 01:24,URC,5135,737-800,15,3,23,2,3,22,,,,,8,7
2019-04-24 01:21,XIY,5406,737-800,20,2,27,5,6,29,,,,,7,9
2019-04-24 01:19,HHA,1796,737-800,20,6,30,4,4,26,,,,,10,6
2019-04-24 01:19,HAK,5439,737-800,29,7,34,4,4,34,,,,,5,5
2019-04-24 01:18,SZX,1347,737-800,26,4,34,4,4,29,,,,,8,3
2019-04-24 01:15,XIY,1538,737-800,20,2,18,2,2,20,,,,,-2,0
2019-04-24 01:14,SYX,5713,737-800,29,6,22,6,6,20,,,,,-7,-9
2019-04-24 01:12,PEK,5539,737-800,21,5,27,5,5,27,,,,,6,6
2019-04-24 01:11,PEK,7398,737-800,21,8,21,5,5,18,,,,,0,-3
2019-04-24 01:11,HGH,1996,737-800,26,4,23,4,4,28,,,,,-3,2
2019-04-24 01:08,FOC,1348,737-800,24,4,32,4,4,29,,,,,8,5
2019-04-24 01:08,HAK,5465,737-800,26,4,30,6,5,33,,,,,4,7
2019-04-24 01:05,HAK,5137,737-800,27,4,30,3,2,32,,,,,3,5
2019-04-24 01:05,CGO,1787,737-800,20,2,24,2,2,24,,,,,4,4
2019-04-24 01:05,HRB,1433,737-800,12,6,18,4,4,21,,,,,6,9
2019-04-24 01:02,URC,5620,737-800,15,4,24,3,4,22,,,,,9,7
2019-04-24 01:02,URC,1569,737-800,15,8,28,4,3,22,,,,,13,7
2019-04-24 01:01,PEK,5712,737-800,20,2,22,2,2,20,,,,,2,0
2019-04-24 01:00,HHA,5579,737-800,24,5,30,5,5,29,,,,,6,5
2019-04-24 00:58,XIY,1481,737-800,20,4,28,6,6,26,,,,,8,6
2019-04-24 00:57,HGH,5853,737-800,25,6,30,6,6,29,,,,,5,4
2019-04-24 00:54,CAN,5467,737-800,26,3,30,2,1,28,,,,,4,2
2019-04-24 00:48,CAN,5408,737-800,28,7,34,6,6,30,,,,,6,2
2019-04-24 00:48,URC,5481,737-800,16,4,24,3,3,22,,,,,8,6
2019-04-24 00:44,URC,1541,737-800,16,4,28,5,4,24,,,,,12,8
2019-04-24 00:43,XIY,1497,737-800,20,5,28,4,4,28,,,,,8,8
2019-04-24 00:42,SYX,7619,737-800,28,5,31,6,6,32,,,,,3,4
2019-04-24 00:42,SZX,5417,737-800,27,4,30,5,4,32,,,,,3,5
2019-04-24 00:34,YIH,7113,737-800,35,4,30,5,5,26,,,,,-5,-9
2019-04-24 00:34,PEK,5735,737-800,21,0,15,0,0,14,,,,,-6,-7
2019-04-24 00:31,URC,1488,737-800,15,6,28,5,6,24,,,,,13,9
2019-04-24 00:30,CAN,1141,737-800,24,6,35,5,5,30,1,,,1,11,6
2019-04-24 00:29,URC,1323,737-800,16,4,26,4,4,26,,,,,10,10
2019-04-24 00:25,KHG,205U,737-800,24,2,25,2,2,24,,,,,1,0
2019-04-24 00:24,SZX,5687,737-800,25,4,0,4,4,32,,,,,-25,7
2019-04-24 00:23,PEK,5418,737-800,22,2,22,4,4,24,,,,,0,2
2019-04-24 00:15,MIG,6809,737-800,26,5,26,5,5,26,,,,,0,0
2019-04-24 00:15,HAK,1995,737-800,27,4,36,6,6,36,,,,,9,9
2019-04-24 00:11,HRB,7105,737-800,15,4,22,5,5,22,,,,,7,7
2019-04-24 00:11,CGO,1570,737-800,21,2,25,3,4,22,,,,,4,1
2019-04-24 00:07,HAK,7171,737-800,28,5,30,4,4,30,,,,,2,2
2019-04-24 00:05,HGH,5661,737-800,25,4,28,4,6,31,,,,,3,6
2019-04-24 00:01,SYX ,1545,737-800,28,6,34,6,5,32,,,,,6,4
2019-04-24 00:00,CAN,1489,737-800,27,3,32,4,3,31,,,,,5,4
2019-04-23 23:52,PEK,5709,737-800,28,6,26,7,6,26,,,,,-2,-2
2019-04-23 23:52,TYN,5090,737-800,19,2,24,3,4,21,,,,,5,2
2019-04-23 23:46,PEK,7175,737-800,23,7,28,4,5,25,,,,,5,2
2019-04-23 23:46,XIY,5375,737-800,20,1,20,4,3,22,,,,,0,2
2019-04-23 23:45,PEK,7886,737-800,22,4,30,2,2,30,,,,,8,8
2019-04-23 23:44,XNN,5463,737-800,18,5,20,5,4,16,,,,,2,-2
2019-04-23 23:43,HAK,1728,737-800,27,4,32,3,3,30,,,,,5,3
2019-04-23 23:42,HAK,1927,737-800,28,3,36,9,2,30,,,,,8,2
2019-04-23 23:39,URC,205V,737-800,18,3,28,4,4,24,,,,,10,6
2019-04-23 23:38,CGO,5141,737-800,20,5,28,5,5,28,,,,,8,8
2019-04-23 23:35,HAK,1929,737-800,28,4,32,8,8,26,,,,,4,-2
2019-04-23 23:35,HAK,7379,737-800,28,4,36,6,6,39,,,,,8,11
2019-04-23 23:21,XIY,5662,737-800,20,3,24,4,2,24,,,,,4,4
2019-04-23 23:18,HAK,6800,737-800,27,4,36,4,4,30,,,,,9,3
2019-04-23 23:11,SYX,5521,737-800,29,4,30,3,5,29,,,,,1,0
2019-04-23 23:04,HGH,1783,737-800,24,3,16,3,3,28,,,,,-8,4
2019-04-23 23:04,PEK,1547,737-800,23,6,29,6,6,28,,,,,6,5
2019-04-23 23:02,DLC,1215,737-800,15,2,26,4,4,24,,,,,11,9
2019-04-23 22:58,XIY,1903,737-800,20,1,24,2,1,29,,,,,4,9
2019-04-23 22:58,HRB,1351,737-800,12,3,18,5,5,20,,,,,6,8
2019-04-23 22:57,CKG,1726,737-800,20,4,29,4,4,26,,,,,9,6
2019-04-23 22:55,HAK,1995,737-800,27,9,37,5,4,30,,,,,10,3
2019-04-23 22:52,SZX,7616,737-800,27,2,30,4,4,32,,,,,3,5
2019-04-23 22:43,HRB,1480,737-800,20,4,20,4,4,20,,,,,0,0
2019-04-23 22:42,HRB,7395,737-800,18,6,22,6,6,22,,,,,4,4
2019-04-23 22:38,HGH,5373,737-800,25,6,29,2,4,29,,,,,4,4
2019-04-23 22:35,DLC,1797,737-800,15,3,23,2,3,20,,,,,8,5
2019-04-23 22:30,HAK,1101,737-800,30,3,30,3,3,27,,,,,0,-3
2019-04-23 22:22,URC,1325,737-800,15,4,25,4,4,20,,,,,10,5
2019-04-23 22:11,DLC,7173,737-800,15,6,24,4,6,24,,,,,9,9
2019-04-23 21:51,FOC,1906,737-800,24,8,30,7,7,30,,,,,6,6
2019-04-23 21:41,MIG,5409,737-800,25,4,27,4,4,28,,,,,2,3
2019-04-23 21:32,XNN,1498,737-800,18,6,23,6,6,0,,,,,5,-18
2019-04-23 20:16,HGH,1495,737-800,25,4,28,4,4,30,,,,,3,5
2019-04-23 20:04,SYX,1130,737-800,30,2,36,2,2,32,,,,,6,2
2019-04-23 18:53,FOC,1433,737-800,25,3,29,2,2,23,,,,,4,-2
2019-04-23 18:03,FOC,5638,737-800,27,4,29,17,17,32,,,,,2,5
2019-04-23 17:58,HAK,206G,737-800,33,2,36,4,4,34,,,,,3,1
2019-04-23 17:12,FOC,5638,737-800,27,4,29,17,17,32,,,,,2,5
2019-04-23 14:16,XUZ,1588,737-800,25,2,26,3,3,28,,,,,1,3
2019-04-23 14:12,URC,7198,737-800,16,4,24,4,5,22,,,,,8,6
2019-04-23 12:55,FOC,5182,737-800,33,3,30,3,3,30,,,,,-3,-3
2019-04-23 12:47,CTU,7989,737-800,37,5,31,6,5,31,,,,,-6,-6
2019-04-23 12:28,TYN,5687,737-800,20,4,0,6,4,24,,,,,-20,4
2019-04-23 12:08,FOC,1906,737-800,26,6,28,6,5,28,,,,,2,2
2019-04-23 12:02,FOC,1480,737-800,28,5,30,5,4,26,,,,,2,-2
2019-04-23 09:50,XIY,5430,737-800,17,6,28,5,5,30,,,,,11,13
2019-04-23 09:30,XIY ,1483,737-800,17,4,22,4,5,23,,,,,5,6
2019-04-23 09:29,XIY ,1161,737-800,18,4,25,3,4,23,,,,,7,5
2019-04-23 09:27,HAK,5082,737-800,27,4,32,4,4,30,,,,,5,3
2019-04-23 09:19,FOC,1435,737-800,22,4,32,5,5,28,,,,,10,6
2019-04-23 09:06,HAK,1541,737-800,20,5,30,5,5,28,,,,,10,8
2019-04-23 08:45,FOC,1562,737-800,30,8,30,6,5,28,,,,,0,-2
2019-04-23 08:37,ZGC,7378,737-800,15,5,22,5,6,24,,,,,7,9
2019-04-23 08:10,CGO,6015,737-800,16,4,28,3,3,25,,,,,12,9
2019-04-23 08:04,SYX,7619,737-800,30,5,30,6,5,30,,,,,0,0
2019-04-23 07:46,PEK,6060,737-800,20,6,28,4,4,25,,,,,8,5
2019-04-23 07:27,XIY,6063,737-800,20,6,26,5,5,25,,,,,6,5
2019-04-23 07:05,HAK,1927,737-800,27,3,30,6,4,29,,,,,3,2
2019-04-23 06:55,XMN,1503,737-800,20,4,29,8,8,20,,,,,9,0
2019-04-23 06:53,XMN,5090,737-800,24,6,35,8,7,31,1,,,1,11,7
2019-04-23 06:53,XMN,5428,737-800,24,4,30,6,5,32,,,,,6,8
2019-04-23 06:52,XMN,1103,737-800,24,6,30,6,6,30,,,,,6,6
2019-04-23 06:51,XMN,1505,737-800,27,8,34,4,4,28,,,,,7,1
2019-04-23 06:51,XMN,5138,737-800,18,4,32,5,4,28,,,,,14,10
2019-04-23 06:48,MIG,6016,737-800,25,4,28,4,4,27,,,,,3,2
2019-04-23 06:37,URC,5620,737-800,10,3,20,4,5,22,,,,,10,12
2019-04-23 06:37,Z?G?C,5358,737-800,20,4,28,6,6,20,,,,,8,0
2019-04-23 06:36,HAK,1787,737-800,26,6,32,5,5,33,,,,,6,7
2019-04-23 06:29,URC,5481,737-800,15,2,16,2,2,22,,,,,1,7
2019-04-23 06:28,TYN,5713,737-800,12,6,22,6,4,24,,,,,10,12
2019-04-23 06:23,XIY,1902,737-800,20,4,24,5,4,24,,,,,4,4
2019-04-23 06:17,XIY,1735,737-800,20,4,24,5,4,22,,,,,4,2
2019-04-23 06:01,CGO,1323,737-800,18,3,22,2,3,21,,,,,4,3
2019-04-23 05:10,HAK,7886,737-800,26,4,33,4,3,33,,,,,7,7
2019-04-23 05:06,HAK,5139,737-800,28,8,34,8,5,32,,,,,6,4
2019-04-23 05:05,HHA,5416,737-800,25,7,25,6,7,28,,,,,0,3
2019-04-23 05:00,SZX,5153,737-800,27,3,32,4,4,32,,,,,5,5
2019-04-23 05:00,SZX,1492,737-800,28,5,30,3,4,30,,,,,2,2
2019-04-23 04:58,CAN,5338,737-800,24,6,27,5,5,30,,,,,3,6
2019-04-23 04:35,CAN,1929,737-800,24,4,31,4,4,26,,,,,7,2
2019-04-23 04:28,CGO,5522,737-800,20,5,24,4,3,20,,,,,4,0
2019-04-23 04:23,SYX,5462,737-800,28,4,32,6,4,34,,,,,4,6
2019-04-23 04:09,HHA,1346,737-800,21,2,25,4,4,26,,,,,4,5
2019-04-23 04:04,XIY,1903,737-800,20,2,26,2,2,26,,,,,6,6
2019-04-23 03:58,CKG,1347,737-800,25,3,26,2,2,26,,,,,1,1
2019-04-23 03:58,SYX,2158,737-800,28,7,30,5,4,28,,,,,2,0
2019-04-23 03:57,PEK,5538,737-800,20,2,30,2,4,33,,1,,1,10,13
2019-04-23 03:54,XIY,1101,737-800,18,4,24,3,4,25,,,,,6,7
2019-04-23 03:52,PEK ,5735,737-800,23,2,20,2,2,10,,,,,-3,-13
2019-04-23 03:48,KMG,7990,737-800,15,3,23,4,3,22,,,,,8,7
2019-04-23 03:47,HAK,5625,737-800,27,6,30,6,5,34,,,,,3,7
2019-04-23 03:46,KMG,1586,737-800,19,3,22,5,4,22,,,,,3,3
2019-04-23 03:43,KMG,6800,737-800,19,4,18,4,4,20,,,,,-1,1
2019-04-23 03:42,KMG,1209,737-800,19,3,26,4,4,22,,,,,7,3
2019-04-23 03:40,HGH,1785,737-800,25,1,27,6,7,28,,,,,2,3
2019-04-23 03:38,XIY,1497,737-800,25,6,21,5,4,20,,,,,-4,-5
2019-04-23 03:34,HAK,1498,737-800,27,6,34,6,6,0,,,,,7,-27
2019-04-23 03:28,CAN,5408,737-800,27,4,31,5,5,27,,,,,4,0
2019-04-23 03:26,HAK,7639,737-800,27,6,35,7,7,32,,,,,8,5
2019-04-23 03:22,HAK,1489,737-800,27,4,32,4,4,30,,,,,5,3
2019-04-23 03:20,URC,5371,737-800,12,6,20,5,6,21,,,,,8,9
2019-04-23 03:16,CAN,5375,737-800,24,2,23,4,3,26,,,,,-1,2
2019-04-23 03:15,URC,6268,737-800,15,4,26,4,4,24,,,,,11,9
2019-04-23 03:15,HGH,5479,737-800,22,5,28,6,5,28,,,,,6,6
2019-04-23 03:06,TYN,1538,737-800,15,3,21,3,2,20,,,,,6,5
2019-04-23 03:02,URC,6995,737-800,14,4,26,5,5,21,,,,,12,7
2019-04-23 02:59,HGH,5373,737-800,26,5,26,5,5,25,,,,,0,-1
2019-04-23 02:56,KMG,1586,737-800,15,3,21,4,3,20,,,,,6,5
2019-04-23 02:54,HAK,5853,737-800,28,7,34,7,6,29,,,,,6,1
2019-04-23 02:54,HAK,5089,737-800,30,4,30,2,2,33,,,,,0,3
2019-04-23 02:52,HAK,1496,737-800,26,6,35,6,6,36,,,,,9,10
2019-04-23 02:51,Z?G?C,5580,737-800,15,4,30,6,6,24,,,,,15,9
2019-04-23 02:51,SYX,5337,737-800,25,3,34,5,4,34,,,,,9,9
2019-04-23 02:48,SYX,1542,737-800,28,2,28,3,4,28,,,,,0,0
2019-04-23 02:36,CAN,5372,737-800,24,8,31,8,7,30,,,,,7,6
2019-04-23 02:35,HRB,7105,737-800,18,4,26,5,4,26,,,,,8,8
2019-04-23 02:33,SZX,5852,737-800,27,4,30,4,4,30,,,,,3,3
2019-04-23 02:33,FOC,5503,737-800,24,6,26,4,4,24,,,,,2,0
2019-04-23 02:33,KMG,5732,737-800,18,4,22,6,4,22,,,,,4,4
2019-04-23 02:32,XIY,5116,737-800,18,3,22,4,4,22,,,,,4,4
2019-04-23 02:30,URC,5623,737-800,18,6,24,6,6,26,,,,,6,8
2019-04-23 02:28,URC,7198,737-800,14,4,20,4,5,22,,,,,6,8
2019-04-23 02:19,KMG,5407,737-800,19,4,22,6,4,24,,,,,3,5
2019-04-23 02:19,URC,1488,737-800,15,3,24,3,4,22,,,,,9,7
2019-04-23 02:18,XIY,5115,737-800,18,4,20,5,5,24,,,,,2,6
2019-04-23 02:16,ÃàÑô,5409,737-800,23,4,26,4,3,26,,,,,3,3
2019-04-23 02:16,SYX,206G,737-800,30,3,34,4,4,31,,,,,4,1
2019-04-23 02:13,URC,205T,737-800,18,4,24,4,4,24,,,,,6,6
2019-04-23 02:10,TYN,206F,737-800,16,4,22,2,2,22,,,,,6,6
2019-04-23 02:09,HAK,1995,737-800,29,7,35,6,6,32,,,,,6,3
2019-04-23 02:08,XIY,1482,737-800,19,6,28,6,6,22,,,,,9,3
2019-04-23 02:05,URC,5636,737-800,13,5,24,5,5,24,,,,,11,11
2019-04-23 02:03,CAN,5661,737-800,25,4,28,5,4,32,,,,,3,7
2019-04-23 02:02,XIY,5180,737-800,20,6,26,6,6,26,,,,,6,6
2019-04-23 01:59,URC,5135,737-800,14,5,23,5,4,22,,,,,9,8
2019-04-23 01:55,HHA,1733,737-800,22,4,23,3,3,21,,,,,1,-1
2019-04-23 01:55,KMG,7993,737-800,20,5,24,5,5,22,,,,,4,2
2019-04-23 01:54,HAK,6065,737-800,28,5,36,4,5,33,,,,,8,5
2019-04-23 01:52,CGO,5141,737-800,18,5,24,6,6,27,,,,,6,9
2019-04-23 01:47,CAN,1141,737-800,24,5,32,6,6,30,,,,,8,6
2019-04-23 01:44,YIH,1348,737-800,19,4,30,4,4,26,,,,,11,7
2019-04-23 01:43,PEK,5581,737-800,19,5,19,5,3,26,,,,,0,7
2019-04-23 01:40,HAK,7398,737-800,28,6,32,4,4,28,,,,,4,0
2019-04-23 01:39,XIY,,737-800,1350,4,26,4,4,24,,,,,-1324,-1326
2019-04-23 01:37,HHA,1796,737-800,20,5,29,4,4,27,,,,,9,7
2019-04-23 01:32,URC,6103,737-800,14,6,22,6,6,22,,,,,8,8
2019-04-23 01:31,URC,1568,737-800,14,6,24,6,6,22,,,,,10,8
2019-04-23 01:30,HAK,7400,737-800,28,5,33,6,6,31,,,,,5,3
2019-04-23 01:30,HGH,1727,737-800,22,5,27,5,4,26,,,,,5,4
2019-04-23 01:29,URC,1569,737-800,13,3,16,3,3,16,,,,,3,3
2019-04-23 01:28,XIY,5520,737-800,18,5,30,7,5,20,,,,,12,2
2019-04-23 01:27,CAN,1799,737-800,25,4,32,5,5,30,,,,,7,5
2019-04-23 01:25,SYX,6062,737-800,25,2,24,2,2,25,,,,,-1,0
2019-04-23 01:21,XIY,1481,737-800,20,6,26,6,6,26,,,,,6,6
2019-04-23 01:19,SZX,1493,737-800,26,6,30,6,6,28,,,,,4,2
2019-04-23 01:18,CGO,7992,737-800,20,7,26,6,6,24,,,,,6,4
2019-04-23 01:14,´óÁ¬,1797,737-800,13,2,24,2,2,24,,,,,11,11
2019-04-23 01:14,HGH,6061,737-800,26,4,27,4,4,25,,,,,1,-1
2019-04-23 01:12,CKG,1726,737-800,23,4,27,4,4,26,,,,,4,3
2019-04-23 01:11,XIY,5478,737-800,20,4,30,6,5,22,,,,,10,2
2019-04-23 01:10,HHA,5662,737-800,20,4,27,4,6,28,,,,,7,8
2019-04-23 01:07,PEK,5482,737-800,20,0,24,4,4,26,,,,,4,6
2019-04-23 01:03,DLC,7175,737-800,12,4,26,4,5,22,,,,,14,10
2019-04-23 00:59,XIY,1162,737-800,20,3,27,3,3,22,,,,,7,2
2019-04-23 00:59,URC,5137,737-800,15,3,17,2,2,22,,,,,2,7
2019-04-23 00:58,PEK,5712,737-800,22,2,25,8,7,33,,1,,1,3,11
2019-04-23 00:56,CAN,5429,737-800,26,3,30,3,3,29,,,,,4,3
2019-04-23 00:51,KHG,1570,737-800,20,4,20,4,4,20,,,,,0,0
2019-04-23 00:51,KHG,1570,737-800,20,4,20,4,4,20,,,,,0,0
2019-04-23 00:46,HAK,1793,737-800,27,4,35,6,4,30,,,,,8,3
2019-04-23 00:44,DLC,1795,737-800,14,4,24,5,4,24,,,,,10,10
2019-04-23 00:44,URC,205V,737-800,12,3,30,4,4,22,,,,,18,10
2019-04-23 00:42,HAK,1386,737-800,27,4,31,3,3,28,,,,,4,1
2019-04-23 00:39,CAN,5467,737-800,25,2,28,4,2,26,,,,,3,1
2019-04-23 00:38,URC,5709,737-800,12,6,22,6,7,23,,,,,10,11
2019-04-23 00:36,HHA,1213,737-800,20,6,30,5,5,28,,,,,10,8
2019-04-23 00:35,HGH,1728,737-800,25,4,30,4,4,26,,,,,5,1
2019-04-23 00:35,106,5539,737-800,20,3,25,3,3,24,,,,,5,4
2019-04-23 00:34,PEK,7172,737-800,20,5,30,4,5,21,,,,,10,1
2019-04-23 00:34,CAN,1141,737-800,24,5,32,6,6,30,,,,,8,6
2019-04-23 00:29,XIY,5520,737-800,18,5,30,14,14,20,,,,,12,2
2019-04-23 00:25,SYX,5521,737-800,28,5,30,4,2,28,,,,,2,0
2019-04-23 00:21,HRB,1351,737-800,19,4,24,4,4,28,,,,,5,9
2019-04-23 00:20,URC,5466,737-800,15,2,18,8,2,18,,,,,3,3
2019-04-23 00:12,HAK,5733,737-800,27,5,32,7,6,30,,,,,5,3
2019-04-23 00:10,ZUH,5686,737-800,24,8,40,6,8,32,1,,,1,16,8
2019-04-23 00:07,CGO,7988,737-800,20,5,29,5,4,28,,,,,9,8
2019-04-23 00:06,HHA,1783,737-800,20,4,20,4,4,36,,1,,1,0,16
2019-04-23 00:03,URC,5466,737-800,15,2,18,8,2,18,,,,,3,3
2019-04-23 00:02,HGH ,1215,737-800,24,4,26,4,5,26,,,,,2,2
2019-04-23 00:01,CTU,5405,737-800,27,4,29,5,4,29,,,,,2,2
2019-04-22 23:56,HHA,5637,737-800,23,2,27,2,2,26,,,,,4,3
2019-04-22 23:54,CGO,7991,737-800,18,6,28,5,5,25,,,,,10,7
2019-04-22 23:54,KMG,6800,737-800,20,4,18,4,4,20,,,,,-2,0
2019-04-22 23:48,URC,1322,737-800,15,4,22,4,4,22,,,,,7,7
2019-04-22 23:45,URC,1488,737-800,11,4,28,6,4,22,,,,,17,11
2019-04-22 23:45,XIY,5346,737-800,20,3,22,2,2,22,,,,,2,2
2019-04-22 23:41,SZX,5439,737-800,28,8,34,4,4,34,,,,,6,6
2019-04-22 23:37,ÃàÑô,1798,737-800,25,6,28,6,5,26,,,,,3,1
2019-04-22 23:36,ÃàÑô,1798,737-800,25,6,28,6,5,26,,,,,3,1
2019-04-22 23:33,SYX,1545,737-800,28,2,30,2,3,28,,,,,2,0
2019-04-22 23:31,XIY,5359,737-800,19,5,24,4,5,25,,,,,5,6
2019-04-22 23:27,XIY,5406,737-800,20,4,28,3,2,28,,,,,8,8
2019-04-22 23:26,´óÁ¬,1375,737-800,12,4,22,4,4,20,,,,,10,8
2019-04-22 23:24,HRB,7395,737-800,18,6,24,6,6,24,,,,,6,6
2019-04-22 23:22,CAN,5798,737-800,25,2,25,3,2,26,,,,,0,1
2019-04-22 23:21,XIY,7173,737-800,20,4,28,4,6,26,,,,,8,6
2019-04-22 23:19,HGH,1102,737-800,30,4,28,4,3,28,,,,,-2,-2
2019-04-22 23:14,CAN,1786,737-800,24,4,32,4,4,28,,,,,8,4
2019-04-22 23:11,HAK,7379,737-800,28,5,36,4,4,35,,,,,8,7
2019-04-22 23:05,URC,5466,737-800,18,1,18,2,1,20,,,,,0,2
2019-04-22 23:04,URC,7198,737-800,20,2,20,2,2,22,,,,,0,2
2019-04-22 23:03,PEK,1372,737-800,22,6,28,5,4,24,,,,,6,2
2019-04-22 23:03,URC,7198,737-800,20,2,20,2,2,22,,,,,0,2
2019-04-22 22:59,HET,1501,737-800,10,6,27,6,8,30,,,,,17,20
2019-04-22 22:59,CKG,7618,737-800,22,4,26,4,4,26,,,,,4,4
2019-04-22 22:56,DLC,1131,737-800,15,8,20,6,5,24,,,,,5,9
2019-04-22 22:54,PEK,7377,737-800,21,6,28,6,6,28,,,,,7,7
2019-04-22 22:43,XNN,7171,737-800,18,5,20,5,4,21,,,,,2,3
2019-04-22 22:43,DLC,1373,737-800,14,3,22,3,4,18,,,,,8,4
2019-04-22 22:42,HAK,7167,737-800,29,6,32,6,5,32,,,,,3,3
2019-04-22 22:39,URC,1568,737-800,13,6,24,6,6,22,,,,,11,9
2019-04-22 22:35,HAK,206H,737-800,28,1,33,3,3,34,,,,,5,6
2019-04-22 22:31,PEK,5418,737-800,22,5,21,5,3,27,,,,,-1,5
2019-04-22 22:14,PEK,1729,737-800,20,5,20,5,5,20,,,,,0,0
2019-04-22 22:00,ÃàÑô,6809,737-800,26,5,26,6,6,26,,,,,0,0
2019-04-22 21:54,XNN,5463,737-800,18,5,23,5,5,16,,,,,5,-2
2019-04-22 21:53,PEK,1928,737-800,24,7,26,6,6,24,,,,,2,0
2019-04-22 20:23,KMG,1208,737-800,22,3,23,3,3,21,,,,,1,-1
2019-04-22 19:44,HRB,1559,737-800,19,2,24,4,3,24,,,,,5,5
2019-04-22 17:53,ÐìÖÝ,1588,737-800,10,3,26,3,3,24,,,,,16,14
2019-04-22 17:00,PEK,1997,737-800,25,3,26,4,3,22,,,,,1,-3
2019-04-22 15:21,XIY,1490,737-800,24,5,26,6,6,25,,,,,2,1
2019-04-22 15:01,HAK,1491,737-800,42,6,36,4,4,34,,,,,-6,-8
2019-04-22 14:31,PEK,1502,737-800,20,4,20,4,5,22,,,,,0,2
2019-04-22 14:16,PEK,1729,737-800,30,5,20,6,5,24,,,,,-10,-6
2019-04-22 12:28,PEK,6066,737-800,25,2,23,3,3,22,,,,,-2,-3
2019-04-22 11:07,CTU,7989,737-800,28,8,30,5,5,28,,,,,2,0
2019-04-22 09:17,PEK,7400,737-800,20,6,26,5,5,20,,,,,6,0
2019-04-22 09:17,CAN,1786,737-800,25,4,32,4,4,28,,,,,7,3
2019-04-22 08:59,PEK,5540,737-800,15,5,28,5,5,26,,,,,13,11
2019-04-22 07:51,SZX,6061,737-800,27,9,35,5,5,30,,,,,8,3
2019-04-22 07:37,PEK,1346,737-800,19,5,25,5,5,20,,,,,6,1
2019-04-22 07:13,HAK,1927,737-800,30,6,22,9,7,22,,,,,-8,-8
2019-04-22 07:12,HAK,6800,737-800,30,6,34,6,6,32,,,,,4,2
2019-04-22 07:08,XIY,5478,737-800,16,4,28,4,4,24,,,,,12,8
2019-04-22 06:40,XMN,1547,737-800,22,6,30,6,6,30,,,,,8,8
2019-04-22 06:39,XMN,1547,737-800,22,6,30,6,6,30,,,,,8,8
2019-04-22 06:38,XMN,5580,737-800,23,6,32,6,6,34,,1,,1,9,11
2019-04-22 06:37,XMN,1503,737-800,25,3,32,4,3,30,,,,,7,5
2019-04-22 06:36,XMN,5428,737-800,24,8,30,8,8,31,,,,,6,7
2019-04-22 06:19,SZX,5439,737-800,27,4,22,4,5,24,,,,,-5,-3
2019-04-22 05:43,HAK,206H,737-800,26,3,33,3,2,33,,,,,7,7
2019-04-22 05:31,HHA,1733,737-800,24,2,24,4,4,20,,,,,0,-4
2019-04-22 05:27,HGH,1496,737-800,20,4,26,4,4,28,,,,,6,8
2019-04-22 05:27,HGH,1496,737-800,20,4,26,4,4,28,,,,,6,8
2019-04-22 05:26,HGH,1496,737-800,20,4,26,4,4,28,,,,,6,8
2019-04-22 05:23,HAK,5405,737-800,27,5,34,5,4,33,,,,,7,6
2019-04-22 05:22,HAK,5480,737-800,28,7,33,5,3,31,,,,,5,3
2019-04-22 05:06,URC,6995,737-800,18,4,26,6,4,23,,,,,8,5
2019-04-22 05:02,URC,7639,737-800,18,6,26,6,6,26,,,,,8,8
2019-04-22 05:01,HAK,5082,737-800,25,6,29,5,5,29,,,,,4,4
2019-04-22 04:56,URC ,1325,737-800,17,6,21,4,4,20,,,,,4,3
2019-04-22 04:55,URC ,7639 ,737-800,17,6,28,6,6,26,,,,,11,9
2019-04-22 04:53,URC ,1372,737-800,15,6,24,3,4,20,,,,,9,5
2019-04-22 04:53,XIY,1163,737-800,17,3,27,2,2,24,,,,,10,7
2019-04-22 04:52,URC ,1322,737-800,14,4,24,4,4,24,,,,,10,10
2019-04-22 04:51,URC ,5481 ,737-800,15,5,26,4,5,20,,,,,11,5
2019-04-22 04:50,URC ,2157,737-800,14,4,24,4,5,22,,,,,10,8
2019-04-22 04:49,URC ,5636 ,737-800,15,4,24,6,4,24,,,,,9,9
2019-04-22 04:48,URC ,6995,737-800,16,4,26,4,4,22,,,,,10,6
2019-04-22 04:47,URC ,205U,737-800,17,4,25,4,4,23,,,,,8,6
2019-04-22 04:35,XIY,5686,737-800,17,5,26,4,4,22,,,,,9,5
2019-04-22 04:33,KMG,6016,737-800,19,4,26,4,4,24,,,,,7,5
2019-04-22 04:25,SZX,5579,737-800,27,6,34,6,5,32,,,,,7,5
2019-04-22 04:19,HGH,7379,737-800,20,4,26,3,3,26,,,,,6,6
2019-04-22 04:18,HGH,7379,737-800,20,4,26,3,3,26,,,,,6,6
2019-04-22 04:18,HGH,7379,737-800,20,4,26,3,3,26,,,,,6,6
2019-04-22 04:17,XIY,1101,737-800,20,2,28,2,2,24,,,,,8,4
2019-04-22 04:16,URC,5481,737-800,16,5,22,4,5,20,,,,,6,4
2019-04-22 04:15,XIY,1101,737-800,15,2,28,2,2,24,,,,,13,9
2019-04-22 04:11,URC,5620,737-800,15,4,20,2,4,20,,,,,5,5
2019-04-22 04:11,URC,5502,737-800,15,6,22,4,6,20,,,,,7,5
2019-04-22 04:06,CAN,1141,737-800,26,4,34,6,5,30,,,,,8,4
2019-04-22 04:05,HGH,5138,737-800,20,4,28,4,4,28,,,,,8,8
2019-04-22 04:02,Î÷°²,1902,737-800,17,6,18,6,6,20,,,,,1,3
2019-04-22 03:54,KMG,1208,737-800,20,3,24,4,4,22,,,,,4,2
2019-04-22 03:50,SYX,1545,737-800,29,5,34,6,6,34,,,,,5,5
2019-04-22 03:49,HGH,1103,737-800,21,2,32,4,4,22,,,,,11,1
2019-04-22 03:42,DLC,1102,737-800,14,3,24,3,4,22,,,,,10,8
2019-04-22 03:35,CAN,1799,737-800,25,4,33,5,4,32,,,,,8,7
2019-04-22 03:31,CKG,7618,737-800,26,6,28,6,5,26,,,,,2,0
2019-04-22 03:17,FOC,1480,737-800,24,4,25,4,4,24,,,,,1,0
2019-04-22 03:16,FOC,1433,737-800,23,2,30,2,2,23,,,,,7,0
2019-04-22 03:15,CGO,7991,737-800,18,6,28,6,4,24,,,,,10,6
2019-04-22 03:09,KMG,1586,737-800,18,3,23,3,3,22,,,,,5,4
2019-04-22 03:06,DLC,1501,737-800,10,4,18,4,4,22,,,,,8,12
2019-04-22 03:02,ZGC,1542,737-800,15,3,24,3,3,18,,,,,9,3
2019-04-22 03:01,XIY,5430,737-800,20,6,26,8,6,35,,,,,6,15
2019-04-22 03:01,XIY,1903,737-800,17,1,26,1,1,27,,,,,9,10
2019-04-22 03:00,HAK,1386,737-800,24,3,28,4,3,32,,,,,4,8
2019-04-22 02:59,DLC,1131,737-800,12,6,26,4,3,24,,,,,14,12
2019-04-22 02:58,16,5733,737-800,30,4,34,7,6,34,,,,,4,4
2019-04-22 02:58,HGH,1492,737-800,21,4,16,2,4,16,,,,,-5,-5
2019-04-22 02:58,HAK,7398,737-800,28,6,34,5,4,30,,,,,6,2
2019-04-22 02:56,KMG,7988,737-800,15,4,24,5,4,24,,,,,9,9
2019-04-22 02:56,DLC,7175,737-800,14,5,24,5,5,22,,,,,10,8
2019-04-22 02:51,PEK,1502,737-800,15,3,26,4,4,24,,,,,11,9
2019-04-22 02:51,SYX,2158,737-800,29,6,32,6,6,33,,,,,3,4
2019-04-22 02:51,PEK,5538,737-800,15,2,30,2,2,28,,,,,15,13
2019-04-22 02:49,CAN,1799,737-800,23,6,26,24,4,22,,,,,3,-1
2019-04-22 02:46,YIH,1348,737-800,23,4,29,4,3,25,,,,,6,2
2019-04-22 02:43,DLC,5346,737-800,12,4,24,4,4,22,,,,,12,10
2019-04-22 02:43,CAN,5338,737-800,26,3,26,4,3,30,,,,,0,4
2019-04-22 02:42,SYX,1795,737-800,30,4,33,4,4,32,,,,,3,2
2019-04-22 02:40,DLC,1375,737-800,13,3,23,4,4,22,,,,,10,9
2019-04-22 02:37,URC,2159,737-800,14,3,19,2,2,20,,,,,5,6
2019-04-22 02:37,KMG,5407,737-800,20,4,22,4,4,24,,,,,2,4
2019-04-22 02:33,SZX,5153,737-800,27,4,34,4,4,33,,,,,7,6
2019-04-22 02:28,HAK,1549,737-800,29,6,34,6,5,32,,,,,5,3
2019-04-22 02:28,HAK,6065,737-800,26,4,30,4,6,32,,,,,4,6
2019-04-22 02:26,HAK,6065,737-800,26,4,30,4,6,32,,,,,4,6
2019-04-22 02:25,HGH,5479,737-800,20,2,24,2,2,22,,,,,4,2
2019-04-22 02:25,CGO,1587,737-800,15,5,26,4,3,23,,,,,11,8
2019-04-22 02:24,HGH,5373,737-800,20,4,24,4,4,26,,,,,4,6
2019-04-22 02:24,HGH,5373,737-800,20,4,24,4,4,26,,,,,4,6
2019-04-22 02:24,XIY,7173,737-800,18,4,27,4,4,24,,,,,9,6
2019-04-22 02:23,KMG,7167,737-800,18,5,24,4,4,24,,,,,6,6
2019-04-22 02:21,HAK,1493,737-800,27,4,29,4,4,30,,,,,2,3
2019-04-22 02:17,XIY,1162,737-800,17,4,22,3,2,20,,,,,5,3
2019-04-22 02:17,XIY,1162,737-800,17,4,22,3,2,20,,,,,5,3
2019-04-22 02:17,XIY,1481,737-800,17,5,28,5,5,26,,,,,11,9
2019-04-22 02:15,ÃàÑô,6809,737-800,22,5,24,6,5,25,,,,,2,3
2019-04-22 02:14,FOC,1906,737-800,23,7,32,7,7,30,,,,,9,7
2019-04-22 02:14,FOC,1906,737-800,23,7,32,7,7,30,,,,,9,7
2019-04-22 02:14,HAK,5375,737-800,27,2,32,8,8,32,,,,,5,5
2019-04-22 02:13,HHA,1783,737-800,20,5,28,5,4,29,,,,,8,9
2019-04-22 02:10,DLC,1501,737-800,10,4,18,4,4,22,,,,,8,12
2019-04-22 02:09,FOC,1490,737-800,23,5,28,5,5,27,,,,,5,4
2019-04-22 02:08,XIY,5686,737-800,16,5,26,4,4,0,,,,,10,-16
2019-04-22 02:06,HHA,1796,737-800,21,5,29,4,4,27,,,,,8,6
2019-04-22 02:05,FOC,1351,737-800,26,4,30,4,4,27,,,,,4,1
2019-04-22 02:05,Î÷°²,5116,737-800,17,4,20,4,4,20,,,,,3,3
2019-04-22 02:01,TYN,1538,737-800,17,2,16,2,2,20,,,,,-1,3
2019-04-22 01:59,URC,5135,737-800,20,3,24,3,2,21,,,,,4,1
2019-04-22 01:57,HRB,1562,737-800,10,4,21,4,4,20,,,,,11,10
2019-04-22 01:56,PEK,1498,737-800,14,6,24,6,6,22,,,,,10,8
2019-04-22 01:55,HGH,1373,737-800,22,4,28,4,4,24,,,,,6,2
2019-04-22 01:54,SYX,206G,737-800,30,3,35,4,4,33,,,,,5,3
2019-04-22 01:53,CAN,5408,737-800,25,4,32,5,5,28,,,,,7,3
2019-04-22 01:53,PEK,7172,737-800,15,4,32,5,4,23,,,,,17,8
2019-04-22 01:48,17,1729,737-800,20,5,37,5,4,31,,,,,17,11
2019-04-22 01:44,XIY,1161,737-800,17,4,25,3,3,22,,,,,8,5
2019-04-22 01:41,URC,206P,737-800,17,4,24,4,4,20,,,,,7,3
2019-04-22 01:39,XIY,5686,737-800,16,5,26,4,4,0,,,,,10,-16
2019-04-22 01:39,HAK,1929,737-800,31,4,34,4,4,30,,,,,3,-1
2019-04-22 01:38,CAN,1995,737-800,26,6,34,6,6,32,,,,,8,6
2019-04-22 01:36,MIG,1798,737-800,25,6,28,6,6,24,,,,,3,-1
2019-04-22 01:33,XIY,1350,737-800,18,3,26,3,3,23,,,,,8,5
2019-04-22 01:32,HHA,5416,737-800,26,7,24,8,9,28,,,,,-2,2
2019-04-22 01:31,HHA,1213,737-800,24,6,30,6,6,28,,,,,6,4
2019-04-22 01:29,PEK,5539,737-800,16,5,22,5,5,24,,,,,6,8
2019-04-22 01:29,PEK,7172,737-800,15,18,32,5,4,23,,,,,17,8
2019-04-22 01:27,XIY,1735,737-800,17,5,20,5,5,22,,,,,3,5
2019-04-22 01:26,PEK,5482,737-800,10,0,20,6,6,22,,,,,10,12
2019-04-22 01:21,KMG,7990,737-800,19,3,25,4,3,23,,,,,6,4
2019-04-22 01:19,XIY,5180,737-800,17,6,26,6,6,26,,,,,9,9
2019-04-22 01:17,SYX,1130,737-800,29,3,34,4,4,32,,,,,5,3
2019-04-22 01:17,TYN,1785,737-800,17,6,26,6,6,26,,,,,9,9
2019-04-22 01:15,URC,5371,737-800,18,4,30,4,4,22,,,,,12,4
2019-04-22 01:13,URC,5371,737-800,16,9,20,6,6,22,,,,,4,6
2019-04-22 01:11,KMG,7992,737-800,18,7,25,8,7,23,,,,,7,5
2019-04-22 01:11,SZX,7886,737-800,28,3,36,3,4,36,,,,,8,8
2019-04-22 01:11,PEK,5637,737-800,16,2,24,3,2,20,,,,,8,4
2019-04-22 01:09,HAK,5358,737-800,28,8,32,9,9,34,,,,,4,6
2019-04-22 01:06,URC,1727,737-800,20,5,26,4,5,22,,,,,6,2
2019-04-22 01:05,CAN,5661,737-800,26,3,30,4,4,34,,,,,4,8
2019-04-22 01:03,SYX,5462,737-800,29,4,35,5,5,34,,,,,6,5
2019-04-22 01:02,TYN,5090,737-800,15,2,22,2,2,22,,,,,7,7
2019-04-22 01:00,FOC,5503,737-800,25,3,26,4,4,26,,,,,1,1
2019-04-22 00:56,HAK,1793,737-800,26,4,35,6,5,32,,,,,9,6
2019-04-22 00:55,HAK,5798,737-800,25,3,29,4,3,27,,,,,4,2
2019-04-22 00:53,HRB,7105,737-800,7,4,24,6,6,23,,,,,17,16
2019-04-22 00:50,ZGC,7378,737-800,18,6,16,6,7,18,,,,,-2,0
2019-04-22 00:49,XIY,1162,737-800,20,7,20,5,6,18,,,,,0,-2
2019-04-22 00:49,CAN,1489,737-800,27,4,32,4,4,30,,,,,5,3
2019-04-22 00:48,XIY,5406,737-800,15,3,24,6,4,23,,,,,9,8
2019-04-22 00:48,PEK,1997,737-800,16,4,22,4,4,24,,,,,6,8
2019-04-22 00:44,MIG,5409,737-800,25,4,26,4,4,28,,,,,1,3
2019-04-22 00:44,YIH,1905,737-800,20,3,25,3,3,21,,,,,5,1
2019-04-22 00:44,SZX,1487,737-800,27,3,30,4,3,30,,,,,3,3
2019-04-22 00:43,HGH,1215,737-800,22,4,28,4,4,30,,,,,6,8
2019-04-22 00:41,SYX,5521,737-800,29,3,33,3,4,33,,,,,4,4
2019-04-22 00:38,TYN,206F,737-800,15,2,25,2,2,22,,,,,10,7
2019-04-22 00:37,XIY,5115,737-800,18,4,17,4,4,26,,,,,-1,8
2019-04-22 00:36,CAN,5418,737-800,25,7,29,5,4,31,,,,,4,6
2019-04-22 00:24,CGO,5139,737-800,16,4,23,4,3,24,,,,,7,8
2019-04-22 00:22,PEK,5638,737-800,19,4,22,4,4,21,,,,,3,2
2019-04-22 00:22,FOC,1435,737-800,25,4,24,4,5,22,,,,,-1,-3
2019-04-22 00:19,HAK,1996,737-800,28,4,29,6,5,32,,,,,1,4
2019-04-22 00:19,KHG,1569,737-800,25,2,24,2,2,24,,,,,-1,-1
2019-04-22 00:17,CGO,1728,737-800,16,4,22,4,4,22,,,,,6,6
2019-04-22 00:16,DLC,6062,737-800,14,2,24,3,2,24,,,,,10,10
2019-04-22 00:14,CKG,1347,737-800,25,4,29,16,14,24,,1,,1,4,-1
2019-04-22 00:11,CGO,1323,737-800,15,3,30,3,3,27,,,,,15,12
2019-04-22 00:09,XIY,6063,737-800,17,6,27,6,6,26,,,,,10,9
2019-04-22 00:07,CKG,5852,737-800,22,6,24,6,6,24,,,,,2,2
2019-04-22 00:07,PEK,5465,737-800,16,3,22,4,3,21,,,,,6,5
2019-04-22 00:06,XIY,1928,737-800,16,5,20,6,6,22,,,,,4,6
2019-04-22 00:01,HHA,5853,737-800,21,6,30,5,5,26,,,,,9,5
2019-04-21 23:49,HAK,1541,737-800,25,5,30,6,5,31,,,,,5,6
2019-04-21 23:47,PEK,6060,737-800,15,6,25,4,4,23,,,,,10,8
2019-04-21 23:46,CGO,6015,737-800,15,4,26,3,3,24,,,,,11,9
2019-04-21 23:40,DLC,1495,737-800,13,4,24,4,4,22,,,,,11,9
2019-04-21 23:40,CAN,5520,737-800,25,5,32,6,6,32,,,,,7,7
2019-04-21 23:40,HRB,7113,737-800,9,4,23,4,3,25,,,,,14,16
2019-04-21 23:39,XIY,7377,737-800,20,6,25,6,8,35,,,,,5,15
2019-04-21 23:36,MIG,5732,737-800,25,4,28,4,4,26,,,,,3,1
2019-04-21 23:34,URC,1568,737-800,20,6,28,6,6,24,,,,,8,4
2019-04-21 23:34,HAK,5687,737-800,29,4,28,4,5,32,,,,,-1,3
2019-04-21 23:34,PEK,5623,737-800,19,6,22,6,6,22,,,,,3,3
2019-04-21 23:26,FOC,5182,737-800,27,4,27,4,4,29,,,,,0,2
2019-04-21 23:26,HHA,5712,737-800,23,1,24,1,1,24,,,,,1,1
2019-04-21 23:18,HRB,7395,737-800,6,6,21,6,6,20,,,,,15,14
2019-04-21 23:18,URC,6103,737-800,17,4,24,4,4,24,,,,,7,7
2019-04-21 23:15,SYX,7619,737-800,29,6,31,6,5,30,,,,,2,1
2019-04-21 23:07,PEK,1797,737-800,22,2,20,4,4,20,,,,,-2,-2
2019-04-21 23:04,,206H,737-800,29,3,35,3,2,33,,,,,6,4
2019-04-21 23:03,SYX,5141,737-800,29,6,32,8,8,32,,,,,3,3
2019-04-21 23:02,SYX,5141,737-800,29,6,32,8,8,32,,,,,3,3
2019-04-21 22:58,HAK,5137,737-800,29,5,28,3,3,29,,,,,-1,0
2019-04-21 22:54,XMN,1505,737-800,24,4,26,6,6,29,,,,,2,5
2019-04-21 22:51,XIY,5359,737-800,17,4,23,4,4,23,,,,,6,6
2019-04-21 22:50,CGO,1209,737-800,16,4,26,2,3,24,,,,,10,8
2019-04-21 22:49,HAK,5522,737-800,30,6,34,10,12,34,,1,,1,4,4
2019-04-21 22:35,XNN,7171,737-800,17,4,20,5,4,22,,,,,3,5
2019-04-21 22:29,HAK,5662,737-800,29,4,34,7,8,29,,,,,5,0
2019-04-21 22:24,DLC,1497,737-800,14,4,24,4,4,25,,,,,10,11
2019-04-21 22:18,HAK,1726,737-800,30,4,26,6,4,31,,,,,-4,1
2019-04-21 22:10,HAK,1787,737-800,29,2,34,4,4,31,,,,,5,2
2019-04-21 22:07,URC ,1570,737-800,18,6,20,4,5,20,,,,,2,2
2019-04-21 22:02,SYX,5337,737-800,29,5,35,6,5,35,,,,,6,6
2019-04-21 22:01,TYN,5713,737-800,20,6,27,6,6,22,,,,,7,2
2019-04-21 22:01,ZGC,1548,737-800,15,3,22,4,2,24,,,,,7,9
2019-04-21 22:00,XIY,5417,737-800,18,5,23,4,4,23,,,,,5,5
2019-04-21 21:57,CAN,5429,737-800,26,3,30,3,3,30,,,,,4,4
2019-04-21 21:49,PEK,5735,737-800,18,0,12,0,0,9,,,,,-6,-9
2019-04-21 21:48,PEK,5736,737-800,18,0,12,0,0,9,,,,,-6,-9
2019-04-21 21:45,XNN,1491,737-800,17,5,28,6,5,25,,,,,11,8
2019-04-21 21:45,XNN,1491,737-800,17,5,28,6,5,25,,,,,11,8
2019-04-21 21:42,HAK,5136,737-800,29,5,33,6,6,35,,,,,4,6
2019-04-21 21:37,CAN,5467,737-800,25,4,28,4,4,24,,,,,3,-1
2019-04-21 20:49,HAK,5625,737-800,30,8,35,6,5,35,,,,,5,5
2019-04-21 20:39,HAK,5625,737-800,30,8,35,6,5,35,,,,,5,5
2019-04-21 20:21,HAK,5089,737-800,30,5,28,0,0,32,,,,,-2,2
2019-04-21 19:12,HRB,1559,737-800,12,7,24,4,4,24,,,,,12,12
2019-04-21 18:59,´óÁ¬,5346,737-800,12,4,24,4,4,22,,,,,12,10
2019-04-21 17:33,SZX ,7616,737-800,28,4,30,4,4,24,,,,,2,-4
2019-04-21 17:27,KMG,1588,737-800,29,4,22,5,4,21,,,,,-7,-8
2019-04-21 17:15,XUZ,7993,737-800,19,4,26,4,5,24,,,,,7,5
2019-04-21 14:10,CTU,7989,737-800,32,5,28,6,5,28,,,,,-4,-4
2019-04-21 13:29,XIY,5687,737-800,23,4,0,4,4,24,,,,,-23,1
2019-04-21 10:28,XIY,1902,737-800,15,5,28,5,5,22,,,,,13,7
2019-04-21 08:24,HAK,5466,737-800,28,6,18,8,6,28,,,,,-10,0
2019-04-21 08:23,HAK,1213,737-800,28,7,36,6,6,34,,,,,8,6
2019-04-21 08:07,KMG,7993,737-800,20,6,24,5,5,20,,,,,4,0
2019-04-21 08:03,PEK,1502,737-800,20,3,24,4,4,25,,,,,4,5
2019-04-21 07:01,PE?K,5620,737-800,15,4,20,4,5,18,,,,,5,3
2019-04-21 06:46,XIY,1161,737-800,16,4,21,4,4,22,,,,,5,6
2019-04-21 06:05,HAK,5638,737-800,39,4,35,4,5,34,,,,,-4,-5
2019-04-21 05:40,XMN,1542,737-800,23,4,28,4,4,30,,,,,5,7
2019-04-21 05:39,XMN,1505,737-800,23,3,35,3,3,28,,,,,12,5
2019-04-21 05:38,XMN,1505,737-800,23,3,35,3,3,28,,,,,12,5
2019-04-21 05:37,XMN,1547,737-800,21,3,20,2,4,21,,,,,-1,0
2019-04-21 05:35,XMN,5853,737-800,21,3,20,2,4,21,,,,,-1,0
2019-04-21 05:34,XMN,5853,737-800,21,3,20,2,4,21,,,,,-1,0
2019-04-21 05:33,XMN,5428,737-800,22,4,28,5,6,30,,,,,6,8
2019-04-21 05:33,KMG,1798,737-800,15,6,25,6,6,22,,,,,10,7
2019-04-21 05:29,CAN,5337,737-800,23,4,32,6,4,32,,,,,9,9
2019-04-21 05:28,CAN,5337,737-800,23,4,32,6,4,32,,,,,9,9
2019-04-21 05:27,URC,5709,737-800,20,6,26,6,6,26,,,,,6,6
2019-04-21 05:27,CAN,5337,737-800,23,4,32,6,4,32,,,,,9,9
2019-04-21 05:09,PEK,5338,737-800,15,4,24,6,6,20,,,,,9,5
2019-04-21 04:42,HHA,5798,737-800,22,4,24,3,2,23,,,,,2,1
2019-04-21 04:30,SYX,7619,737-800,29,6,30,8,8,27,,,,,1,-2
2019-04-21 04:26,FOC,1797,737-800,20,4,30,4,4,28,,,,,10,8
2019-04-21 04:24,URC,5636,737-800,20,4,24,4,5,22,,,,,4,2
2019-04-21 04:23,URC,5371,737-800,19,8,20,6,7,22,,,,,1,3
2019-04-21 04:19,FOC,1906,737-800,20,8,32,7,6,30,,,,,12,10
2019-04-21 04:15,HGH,5580,737-800,25,5,30,5,5,30,,,,,5,5
2019-04-21 04:04,URC,6995,737-800,19,4,26,5,5,22,,,,,7,3
2019-04-21 04:04,KMG,1586,737-800,20,8,26,4,8,20,,,,,6,0
2019-04-21 03:58,CAN,1995,737-800,24,6,30,6,6,30,,,,,6,6
2019-04-21 03:47,HAK,1101,737-800,25,3,36,3,3,35,1,1,,11,11,10
2019-04-21 03:46,XIY,1530,737-800,14,3,22,3,4,26,,,,,8,12
2019-04-21 03:46,URC,5502,737-800,20,4,22,6,6,24,,,,,2,4
2019-04-21 03:45,URC,6268,737-800,19,3,26,4,4,25,,,,,7,6
2019-04-21 03:44,XIY,1928,737-800,20,2,22,2,2,22,,,,,2,2
2019-04-21 03:35,SYX,5141,737-800,30,8,36,8,8,36,,,,,6,6
2019-04-21 03:34,SYX,5141,737-800,30,8,36,8,8,36,,,,,6,6
2019-04-21 03:33,CAN,5465,737-800,24,3,28,2,3,26,,,,,4,2
2019-04-21 03:20,CAN,1997,737-800,24,4,30,3,3,28,,,,,6,4
2019-04-21 03:13,XIY,5178,737-800,17,4,29,4,3,22,,,,,12,5
2019-04-21 03:13,KMG,7991,737-800,19,6,22,7,6,23,,,,,3,4
2019-04-21 03:12,XIY,5430,737-800,16,6,26,5,4,28,,,,,10,12
2019-04-21 03:12,XIY,5430,737-800,16,6,26,5,4,28,,,,,10,12
2019-04-21 03:10,SZX,5417,737-800,25,4,27,4,4,30,,,,,2,5
2019-04-21 03:06,XIY,1903,737-800,18,2,26,2,2,27,,,,,8,9
2019-04-21 02:59,DLC,1490,737-800,10,5,24,4,5,21,,,,,14,11
2019-04-21 02:54,TYN,206F,737-800,14,4,24,4,4,24,,,,,10,10
2019-04-21 02:54,URC,1727,737-800,8,5,25,4,4,20,,,,,17,12
2019-04-21 02:53,PEK,5539,737-800,16,6,25,4,5,27,,,,,9,11
2019-04-21 02:52,HAK,5463,737-800,27,9,30,7,6,28,,,,,3,1
2019-04-21 02:52,HAK,5153,737-800,25,8,36,4,4,34,,,,,11,9
2019-04-21 02:51,CGO,1588,737-800,21,4,25,5,4,25,,,,,4,4
2019-04-21 02:49,SYX,206G,737-800,28,4,36,4,4,32,,,,,8,4
2019-04-21 02:47,HAK,1386,737-800,28,2,31,6,4,32,,,,,3,4
2019-04-21 02:47,HGH,5712,737-800,22,2,24,2,2,24,,,,,2,2
2019-04-21 02:45,DLC,7175,737-800,11,5,25,5,4,20,,,,,14,9
2019-04-21 02:45,DLC,7175,737-800,11,5,25,5,4,20,,,,,14,9
2019-04-21 02:45,HAK,5625,737-800,29,6,34,5,4,34,,,,,5,5
2019-04-21 02:45,HHA,1796,737-800,20,6,30,4,4,26,,,,,10,6
2019-04-21 02:40,XIY,1163,737-800,16,2,26,0,0,28,,,,,10,12
2019-04-21 02:40,XIY,6061,737-800,17,4,25,3,3,25,,,,,8,8
2019-04-21 02:39,XIY,5180,737-800,20,6,24,5,7,26,,,,,4,6
2019-04-21 02:38,CGO,1209,737-800,21,3,29,4,4,25,,,,,8,4
2019-04-21 02:37,XIY,7173,737-800,20,4,26,4,4,24,,,,,6,4
2019-04-21 02:37,XIY,1482,737-800,20,4,28,4,4,22,,,,,8,2
2019-04-21 02:36,CGO,6015,737-800,18,4,28,4,4,26,,,,,10,8
2019-04-21 02:36,HAK,5358,737-800,29,8,30,8,8,36,,,,,1,7
2019-04-21 02:36,HAK,5358,737-800,29,8,30,8,8,36,,,,,1,7
2019-04-21 02:33,URC,1795,737-800,17,4,22,4,4,23,,,,,5,6
2019-04-21 02:28,PEK,5538,737-800,16,2,24,4,4,25,,,,,8,9
2019-04-21 02:25,KMG,7992,737-800,20,7,24,7,7,22,,,,,4,2
2019-04-21 02:24,HHA,1503,737-800,22,4,24,4,4,24,,,,,2,2
2019-04-21 02:24,HAK,206H,737-800,25,2,36,2,2,34,,,,,11,9
2019-04-21 02:23,DLC,1497,737-800,10,2,23,4,4,20,,,,,13,10
2019-04-21 02:22,DLC,1495,737-800,10,2,20,4,4,20,,,,,10,10
2019-04-21 02:22,DLC,1495,737-800,10,2,20,4,4,20,,,,,10,10
2019-04-21 02:22,URC,1569,737-800,21,1,27,2,2,23,,,,,6,2
2019-04-21 02:22,URC,1569,737-800,21,1,27,2,2,23,,,,,6,2
2019-04-21 02:22,SZX,5439,737-800,25,4,26,4,4,28,,,,,1,3
2019-04-21 02:21,DLC,6062,737-800,12,4,23,3,3,22,,,,,11,10
2019-04-21 02:16,HAK,5429,737-800,29,6,31,7,6,32,,,,,2,3
2019-04-21 02:12,URC,1568,737-800,20,5,24,6,5,22,,,,,4,2
2019-04-21 02:12,HAK,5735,737-800,30,0,29,1,2,28,,,,,-1,-2
2019-04-21 02:08,KMG,6800,737-800,19,3,21,5,5,21,,,,,2,2
2019-04-21 02:08,CAN,,737-800,1929,3,30,4,4,26,,,,,-1899,-1903
2019-04-21 02:08,KMG,6800,737-800,19,3,21,5,5,21,,,,,2,2
2019-04-21 02:05,URC,5375,737-800,15,8,26,5,4,21,,,,,11,6
2019-04-21 02:04,SZX,5405,737-800,24,4,36,5,4,34,,,,,12,10
2019-04-21 02:02,PEK,1498,737-800,16,5,25,6,6,22,,,,,9,6
2019-04-21 02:00,SZX,5733,737-800,25,6,32,7,6,33,,,,,7,8
2019-04-21 01:56,XIY,1483,737-800,17,4,25,6,5,23,,,,,8,6
2019-04-21 01:53,TYN,5090,737-800,14,2,24,2,3,21,,,,,10,7
2019-04-21 01:53,YIH,1433,737-800,18,4,27,3,2,22,,,,,9,4
2019-04-21 01:48,HGH,1488,737-800,23,2,28,5,4,25,,,,,5,2
2019-04-21 01:44,FOC,1435,737-800,25,6,28,6,6,27,,,,,3,2
2019-04-21 01:43,YIH,1433,737-800,18,4,27,3,2,22,,,,,9,4
2019-04-21 01:43,HAK,5082,737-800,25,8,36,5,5,30,1,,,1,11,5
2019-04-21 01:42,YIH,1348,737-800,18,4,26,4,4,24,,,,,8,6
2019-04-21 01:39,SYX,5521,737-800,29,6,32,6,4,30,,,,,3,1
2019-04-21 01:35,HGH,1496,737-800,25,4,31,6,6,32,,,,,6,7
2019-04-21 01:34,SYX,5418,737-800,29,10,33,5,4,33,,,,,4,4
2019-04-21 01:32,DLC,1102,737-800,10,2,24,2,2,20,,,,,14,10
2019-04-21 01:26,HGH,5579,737-800,24,5,29,5,5,29,,,,,5,5
2019-04-21 01:20,HAK,5797,737-800,30,4,28,6,6,30,,,,,-2,0
2019-04-21 01:19,XIY,1162,737-800,18,3,28,2,2,22,,,,,10,4
2019-04-21 01:18,URC,1372,737-800,8,5,24,4,4,20,,,,,16,12
2019-04-21 01:18,HAK,5137,737-800,30,8,28,2,2,32,,,,,-2,2
2019-04-21 01:18,XIY,1162,737-800,18,3,28,2,2,22,,,,,10,4
2019-04-21 01:16,URC,206P,737-800,21,1,20,2,1,20,,,,,-1,-1
2019-04-21 01:11,HRB,1559,737-800,6,5,19,4,4,18,,,,,13,12
2019-04-21 01:11,URC,5135,737-800,19,3,23,3,2,22,,,,,4,3
2019-04-21 01:10,HHA,1787,737-800,20,2,27,2,3,24,,,,,7,4
2019-04-21 01:09,HAK,1492,737-800,28,4,34,3,3,32,,,,,6,4
2019-04-21 01:08,XIY,5115,737-800,17,6,26,6,6,27,,,,,9,10
2019-04-21 01:07,HAK,1493,737-800,30,4,32,4,3,34,,,,,2,4
2019-04-21 01:06,ZGC,5462,737-800,15,6,14,4,4,18,,,,,-1,3
2019-04-21 01:05,HHA,5416,737-800,22,6,25,5,6,26,,,,,3,4
2019-04-21 01:04,KMG,7990,737-800,20,2,24,3,3,22,,,,,4,2
2019-04-21 01:04,ZGC,7378,737-800,20,7,22,8,8,26,,,,,2,6
2019-04-21 01:03,HHA,5416,737-800,22,6,25,5,6,26,,,,,3,4
2019-04-21 01:03,MIG,5732,737-800,20,4,26,2,2,24,,,,,6,4
2019-04-21 01:00,SZX,1927,737-800,25,4,28,8,5,29,,,,,3,4
2019-04-21 01:00,DLC,7377,737-800,9,6,22,6,6,25,,,,,13,16
2019-04-21 00:59,URC,5502,737-800,19,4,22,6,6,24,,,,,3,5
2019-04-21 00:59,SYX,1545,737-800,29,6,36,6,6,34,,,,,7,5
2019-04-21 00:57,HAK,7616,737-800,28,3,30,4,4,30,,,,,2,2
2019-04-21 00:57,PEK,6066,737-800,15,6,24,2,4,23,,,,,9,8
2019-04-21 00:56,SZX,1215,737-800,24,4,30,4,4,34,,,,,6,10
2019-04-21 00:55,HGH,5580,737-800,25,5,30,5,5,30,,,,,5,5
2019-04-21 00:52,ZGC,7378,737-800,20,7,22,8,8,26,,,,,2,6
2019-04-21 00:51,SYX,1541,737-800,29,5,32,6,5,34,,,,,3,5
2019-04-21 00:50,KMG,7993,737-800,20,6,24,5,5,20,,,,,4,0
2019-04-21 00:49,HGH,1487,737-800,25,4,28,2,2,26,,,,,3,1
2019-04-21 00:47,CAN,1996,737-800,24,4,23,5,5,29,,,,,-1,5
2019-04-21 00:46,MIG,5409,737-800,20,3,25,3,4,25,,,,,5,5
2019-04-21 00:43,HHA,1549,737-800,20,5,28,5,5,26,,,,,8,6
2019-04-21 00:40,CAN,1735,737-800,24,4,30,4,4,26,,,,,6,2
2019-04-21 00:39,CAN,1489,737-800,24,4,29,4,4,29,,,,,5,5
2019-04-21 00:37,CAN,1489,737-800,24,4,31,4,4,29,,,,,7,5
2019-04-21 00:37,CAN,1489,737-800,24,4,31,4,4,29,,,,,7,5
2019-04-21 00:37,KHG,1570,737-800,24,5,24,4,4,22,,,,,0,-2
2019-04-21 00:36,KHG,1570,737-800,24,5,24,4,4,22,,,,,0,-2
2019-04-21 00:36,KHG,1570,737-800,24,5,24,4,4,22,,,,,0,-2
2019-04-21 00:35,CGO,1323,737-800,21,4,27,3,3,20,,,,,6,-1
2019-04-21 00:34,HAK,1548,737-800,29,4,33,4,5,35,,,,,4,6
2019-04-21 00:34,CAN,1799,737-800,24,5,30,5,5,30,,,,,6,6
2019-04-21 00:34,HAK,1548,737-800,29,4,33,4,5,35,,,,,4,6
2019-04-21 00:34,CAN,1799,737-800,24,5,30,5,5,30,,,,,6,6
2019-04-21 00:34,HAK,1785,737-800,29,4,34,8,8,35,,,,,5,6
2019-04-21 00:32,CKG,5852,737-800,20,5,21,4,4,23,,,,,1,3
2019-04-21 00:28,FOC,1905,737-800,20,3,26,4,4,24,,,,,6,4
2019-04-21 00:23,MIG,6809,737-800,20,4,24,4,4,25,,,,,4,5
2019-04-21 00:22,HAK,1141,737-800,29,6,35,8,7,32,,,,,6,3
2019-04-21 00:22,XIY,1538,737-800,20,3,24,2,2,22,,,,,4,2
2019-04-21 00:16,SYX,2158,737-800,29,9,32,4,4,30,,,,,3,1
2019-04-21 00:16,HRB,7395,737-800,12,6,22,6,6,20,,,,,10,8
2019-04-21 00:08,URC,5481,737-800,15,6,24,6,6,23,,,,,9,8
2019-04-21 00:06,KMG,1208,737-800,20,1,20,2,1,21,,,,,0,1
2019-04-21 00:05,URC,1373,737-800,20,3,26,4,4,20,,,,,6,0
2019-04-20 23:54,CKG,7618,737-800,20,5,26,7,6,35,,1,,1,6,15
2019-04-20 23:54,URC ,205V ,737-800,15,4,25,4,3,24,,,,,10,9
2019-04-20 23:52,XIY,5406,737-800,18,6,28,7,4,14,,,,,10,-4
2019-04-20 23:51,SZX,5713,737-800,25,5,33,6,6,28,,,,,8,3
2019-04-20 23:50,SZX,6063,737-800,24,6,22,6,6,30,,,,,-2,6
2019-04-20 23:50,PEK,5540,737-800,22,5,26,5,6,23,,,,,4,1
2019-04-20 23:49,HGH,5138,737-800,24,3,26,2,2,27,,,,,2,3
2019-04-20 23:49,HAK,5662,737-800,30,3,30,4,6,30,,,,,0,0
2019-04-20 23:45,CGO,5661,737-800,20,4,20,6,6,24,,,,,0,4
2019-04-20 23:40,XIY,5359,737-800,17,3,22,3,5,26,,,,,5,9
2019-04-20 23:36,SYX ,1130,737-800,29,2,36,3,2,33,,,,,7,4
2019-04-20 23:36,CGO,7379,737-800,20,4,28,3,4,29,,,,,8,9
2019-04-20 23:30,FOC,1351,737-800,22,4,30,3,4,26,,,,,8,4
2019-04-20 23:28,CGO,1323,737-800,21,4,27,8,8,20,,,,,6,-1
2019-04-20 23:27,HAK,1725,737-800,29,5,36,5,5,36,,,,,7,7
2019-04-20 23:22,PEK,7400,737-800,16,5,25,4,5,23,,,,,9,7
2019-04-20 23:15,PEK,1375,737-800,15,3,22,4,5,22,,,,,7,7
2019-04-20 23:10,HRB,7105,737-800,7,4,21,3,4,19,,,,,14,12
2019-04-20 23:05,DLC,1497,737-800,10,2,23,4,4,20,,,,,13,10
2019-04-20 23:05,MIG,5407,737-800,20,3,28,3,3,22,,,,,8,2
2019-04-20 23:04,MIG,5407,737-800,20,3,28,3,3,22,,,,,8,2
2019-04-20 23:03,DLC,1501,737-800,10,4,25,4,5,22,,,,,15,12
2019-04-20 23:03,XIY,7886,737-800,18,3,28,3,3,28,,,,,10,10
2019-04-20 23:02,DLC,1501,737-800,10,4,25,4,5,22,,,,,15,12
2019-04-20 23:02,CAN,5520,737-800,24,6,34,6,6,30,,,,,10,6
2019-04-20 23:01,CKG,1729,737-800,20,5,25,5,4,24,,,,,5,4
2019-04-20 22:49,URC,205U,737-800,21,3,26,4,4,24,,,,,5,3
2019-04-20 22:44,HHA,1783,737-800,25,4,26,4,4,30,,,,,1,5
2019-04-20 22:42,HAK,7988,737-800,29,6,36,5,4,35,,,,,7,6
2019-04-20 22:38,HAK,5089,737-800,30,6,32,2,2,32,,,,,2,2
2019-04-20 22:35,CAN,5467,737-800,24,1,28,2,1,24,,,,,4,0
2019-04-20 22:34,XIY,5136,737-800,18,5,22,3,4,25,,,,,4,7
2019-04-20 22:32,PEK,6065,737-800,15,4,25,4,5,23,,,,,10,8
2019-04-20 22:30,PEK,6065,737-800,15,4,25,4,5,0,,,,,10,-15
2019-04-20 22:30,PEK,6065,737-800,15,4,25,4,5,23,,,,,10,8
2019-04-20 22:25,CAN,5408,737-800,24,4,32,6,4,28,,,,,8,4
2019-04-20 22:22,HAK,5139,737-800,29,9,30,9,7,32,,,,,1,3
2019-04-20 22:16,XNN,1491,737-800,16,5,26,6,5,24,,,,,10,8
2019-04-20 22:16,PEK,1346,737-800,15,6,27,5,6,24,,,,,12,9
2019-04-20 22:14,XNN,1491,737-800,16,6,26,6,5,24,,,,,10,8
2019-04-20 22:13,XNN,7171,737-800,16,4,20,5,4,22,,,,,4,6
2019-04-20 22:10,HGH,1103,737-800,25,4,30,4,4,28,,,,,5,3
2019-04-20 22:06,PEK,7172,737-800,15,4,26,5,4,24,,,,,11,9
2019-04-20 22:05,ZGC,1347,737-800,20,7,27,5,5,24,,,,,7,4
2019-04-20 22:03,ZGC,1347,737-800,20,7,27,5,5,24,,,,,7,4
2019-04-20 21:47,HGH,5373,737-800,24,5,26,6,6,26,,,,,2,2
2019-04-20 21:37,CAN,1786,737-800,24,5,30,3,3,27,,,,,6,3
2019-04-20 21:15,TYN,5479,737-800,15,5,18,7,7,24,,,,,3,9
2019-04-20 21:14,FOC,7113,737-800,22,6,28,5,5,27,,,,,6,5
2019-04-20 21:13,FOC,7113,737-800,22,6,28,5,5,27,,,,,6,5
2019-04-20 20:41,HAK,1793,737-800,30,4,29,5,6,31,,,,,-1,1
2019-04-20 20:14,PEK,5855,737-800,10,6,22,8,7,22,,,,,12,12
2019-04-20 19:39,HAK,5581,737-800,30,6,32,6,6,34,,,,,2,4
2019-04-20 19:37,HAK,5480,737-800,31,7,33,6,4,31,,,,,2,0
2019-04-20 19:16,DLC,1131,737-800,12,4,25,4,4,24,,,,,13,12
2019-04-20 18:17,XIY,1786,737-800,20,2,22,4,4,22,,,,,2,2
2019-04-20 15:01,URC,7198,737-800,20,5,26,6,4,20,,,,,6,0
2019-04-20 11:17,CTU,7989,737-800,17,6,29,6,5,27,,,,,12,10
2019-04-20 11:05,CGO,1586,737-800,34,6,27,5,4,24,,,,,-7,-10
2019-04-20 08:43,TYN,5686,737-800,15,6,20,4,4,0,,,,,5,-15
2019-04-20 08:37,PEK,7400,737-800,10,5,24,5,5,20,,,,,14,10
2019-04-20 08:35,CAN,1799,737-800,20,6,30,6,5,30,,,,,10,10
2019-04-20 08:01,KMG,6016,737-800,15,4,22,4,4,20,,,,,7,5
2019-04-20 07:29,XMN,5428,737-800,22,3,28,4,3,30,,,,,6,8
2019-04-20 07:28,XMN,5623,737-800,20,5,31,4,4,28,,,,,11,8
2019-04-20 07:28,XMN,5462,737-800,22,3,27,4,3,28,,,,,5,6
2019-04-20 07:27,XMN,1783,737-800,20,5,22,5,7,25,,,,,2,5
2019-04-20 07:22,HAK,5522,737-800,28,6,32,6,6,30,,,,,4,2
2019-04-20 07:16,KMG,1208,737-800,21,3,23,4,4,21,,,,,2,0
2019-04-20 07:14,KMG,7988,737-800,20,3,23,4,4,23,,,,,3,3
2019-04-20 07:02,SHA,5580,737-800,21,6,28,6,6,32,,,,,7,11
2019-04-20 06:59,SYX,5141,737-800,30,6,32,7,6,34,,,,,2,4
2019-04-20 06:50,SYX,7619,737-800,25,4,24,6,6,32,,,,,-1,7
2019-04-20 06:49,SYX,7619,737-800,25,4,24,6,6,32,,,,,-1,7
2019-04-20 06:44,CAN,5337,737-800,22,4,30,6,5,30,,,,,8,8
2019-04-20 06:41,SZX,6065,737-800,24,5,33,5,5,31,,,,,9,7
2019-04-20 06:40,PEK,5338,737-800,11,4,16,3,2,21,,,,,5,10
2019-04-20 06:35,TYN,1927,737-800,10,4,22,6,4,26,,,,,12,16
2019-04-20 06:28,HAK,206H,737-800,27,1,30,2,2,32,,,,,3,5
2019-04-20 06:25,FOC,1435,737-800,21,3,26,3,3,26,,,,,5,5
2019-04-20 06:24,FOC,1435,737-800,21,4,28,4,4,26,,,,,7,5
2019-04-20 06:19,HAK,1793,737-800,28,8,32,6,7,30,,,,,4,2
2019-04-20 06:06,XIY,5115,737-800,15,4,26,2,4,28,,,,,11,13
2019-04-20 05:37,HGH,5373,737-800,22,6,26,6,6,25,,,,,4,3
2019-04-20 05:27,URC,6103,737-800,15,6,20,6,7,22,,,,,5,7
2019-04-20 05:09,HAK,5089,737-800,28,4,30,0,0,32,,,,,2,4
2019-04-20 04:55,CAN,1929,737-800,24,4,30,4,3,26,,,,,6,2
2019-04-20 04:55,PEK,5735,737-800,10,2,15,2,3,18,,,,,5,8
2019-04-20 04:53,CAN,5465,737-800,22,3,27,3,3,30,,,,,5,8
2019-04-20 04:43,HGH,1547,737-800,25,7,30,6,6,28,,,,,5,3
2019-04-20 04:42,URC,1505,737-800,15,3,22,3,3,20,,,,,7,5
2019-04-20 04:37,KMG,6015,737-800,20,4,24,4,4,22,,,,,4,2
2019-04-20 04:36,HGH,1487,737-800,20,2,28,2,2,26,,,,,8,6
2019-04-20 04:32,PEK,5540,737-800,16,4,28,6,6,26,,,,,12,10
2019-04-20 04:30,XIY,1483,737-800,15,6,22,4,3,22,,,,,7,7
2019-04-20 04:20,FOC,5182,737-800,20,3,24,3,3,24,,,,,4,4
2019-04-20 04:19,URC,2157,737-800,16,4,24,4,4,24,,,,,8,8
2019-04-20 04:18,FOC,7105,737-800,21,4,30,4,4,28,,,,,9,7
2019-04-20 04:15,HAK,1489,737-800,28,5,32,5,5,30,,,,,4,2
2019-04-20 04:14,HAK,7379,737-800,27,4,36,4,4,36,,,,,9,9
2019-04-20 04:14,HET,5712,737-800,15,2,22,2,1,20,,,,,7,5
2019-04-20 04:11,YIH,1351,737-800,21,4,26,3,3,24,,,,,5,3
2019-04-20 04:08,KMG,7991,737-800,19,6,24,6,6,22,,,,,5,3
2019-04-20 04:03,HGH,1487,737-800,20,2,28,2,2,26,,,,,8,6
2019-04-20 04:01,SYX,5418,737-800,29,8,30,5,4,28,,,,,1,-1
2019-04-20 04:01,XIY ,1928 ,737-800,15,4,20,4,4,21,,,,,5,6
2019-04-20 04:00,XIY ,5406,737-800,17,6,22,5,5,22,,,,,5,5
2019-04-20 03:51,URC,1727,737-800,20,4,24,4,4,20,,,,,4,0
2019-04-20 03:37,CGO,1209,737-800,20,4,26,4,4,23,,,,,6,3
2019-04-20 03:33,S?Z?X,5405,737-800,25,4,31,5,6,29,,,,,6,4
2019-04-20 03:30,SZX,5733,737-800,24,6,30,6,6,30,,,,,6,6
2019-04-20 03:25,SZX,5417,737-800,24,5,30,6,7,29,,,,,6,5
2019-04-20 03:23,FOC,1797,737-800,20,2,26,3,4,18,,,,,6,-2
2019-04-20 03:19,PEK,5637,737-800,9,3,20,3,2,18,,,,,11,9
2019-04-20 03:16,XIY,1482,737-800,17,6,30,6,6,23,,,,,13,6
2019-04-20 03:14,MIG,1798,737-800,22,6,30,6,5,26,,,,,8,4
2019-04-20 03:14,XIY,5478,737-800,15,3,26,8,8,20,,,,,11,5
2019-04-20 03:14,XIY,5358,737-800,10,5,22,6,4,24,,,,,12,14
2019-04-20 03:12,HHA,1787,737-800,24,3,28,2,2,25,,,,,4,1
2019-04-20 03:07,XIY,5430,737-800,17,7,26,5,5,28,,,,,9,11
2019-04-20 03:05,SZX,1215,737-800,24,4,30,4,4,30,,,,,6,6
2019-04-20 03:01,XIY,1350,737-800,17,4,24,4,4,23,,,,,7,6
2019-04-20 02:58,XIY,5116,737-800,17,4,20,4,4,20,,,,,3,3
2019-04-20 02:54,URC,1570,737-800,20,6,16,6,6,18,,,,,-4,-2
2019-04-20 02:53,HHA,1733,737-800,24,2,27,3,3,24,,,,,3,0
2019-04-20 02:51,HAK,5137,737-800,28,5,26,3,3,31,,,,,-2,3
2019-04-20 02:48,XIY,1902,737-800,17,6,24,6,6,22,,,,,7,5
2019-04-20 02:48,SZX,1492,737-800,24,3,31,2,3,27,,,,,7,3
2019-04-20 02:46,XIY,1162,737-800,16,3,26,4,3,24,,,,,10,8
2019-04-20 02:45,HAK,7992,737-800,28,6,32,7,6,32,,,,,4,4
2019-04-20 02:44,HGH,1725,737-800,22,5,24,4,4,26,,,,,2,4
2019-04-20 02:39,HHA,1549,737-800,24,4,28,4,4,27,,,,,4,3
2019-04-20 02:39,URC,1568,737-800,15,3,23,3,4,22,,,,,8,7
2019-04-20 02:39,HAK,5625,737-800,27,5,34,4,5,32,,,,,7,5
2019-04-20 02:34,HAK,1498,737-800,27,5,31,6,5,30,,,,,4,3
2019-04-20 02:33,HAK,5713,737-800,27,3,25,5,4,27,,,,,-2,0
2019-04-20 02:32,SYX,206G,737-800,30,4,36,5,4,33,,,,,6,3
2019-04-20 02:29,SYX,5661,737-800,25,4,34,5,6,36,,1,,1,9,11
2019-04-20 02:29,TYN,206F,737-800,10,2,18,2,2,16,,,,,8,6
2019-04-20 02:27,CGO,1729,737-800,18,5,18,4,4,19,,,,,0,1
2019-04-20 02:26,PEK,1542,737-800,12,4,24,8,7,30,,,,,12,18
2019-04-20 02:26,PEK,5463,737-800,14,4,24,4,4,16,,,,,10,2
2019-04-20 02:20,SYX,2158,737-800,28,8,35,5,4,30,,,,,7,2
2019-04-20 02:18,KMG,7167,737-800,20,6,26,7,6,22,,,,,6,2
2019-04-20 02:17,S?Z?X,5479,737-800,24,5,26,7,6,30,,,,,2,6
2019-04-20 02:16,HAK,1496,737-800,28,7,36,6,6,36,,,,,8,8
2019-04-20 02:15,URC,6268,737-800,15,4,22,4,6,22,,,,,7,7
2019-04-20 02:15,PEK,5539,737-800,15,4,22,4,4,22,,,,,7,7
2019-04-20 02:12,FOC,1348,737-800,21,4,30,3,4,26,,,,,9,5
2019-04-20 02:10,URC,5636,737-800,20,4,22,4,4,20,,,,,2,0
2019-04-20 02:08,HAK,1386,737-800,27,4,33,4,3,30,,,,,6,3
2019-04-20 02:06,PEK,5482,737-800,21,1,20,6,6,21,,,,,-1,0
2019-04-20 02:04,HAK,1502,737-800,27,3,32,4,4,32,,,,,5,5
2019-04-20 02:04,PEK,7639,737-800,12,6,28,6,5,23,,,,,16,11
2019-04-20 02:03,HRB,1559,737-800,16,4,27,4,5,28,,,,,11,12
2019-04-20 02:02,HRB,1562,737-800,15,8,28,4,5,28,,,,,13,13
2019-04-20 02:01,KMG,7993,737-800,20,6,25,7,7,21,,,,,5,1
2019-04-20 02:00,HRB,7395,737-800,5,6,23,8,8,25,,,,,18,20
2019-04-20 01:58,XIY,1903,737-800,17,5,20,4,2,24,,,,,3,7
2019-04-20 01:57,SYX,1488,737-800,29,3,34,6,6,26,,,,,5,-3
2019-04-20 01:55,CAN,5638,737-800,23,4,30,4,4,30,,,,,7,7
2019-04-20 01:54,CAN,5797,737-800,23,6,24,6,5,27,,,,,1,4
2019-04-20 01:53,CGO,6800,737-800,14,4,22,4,4,22,,,,,8,8
2019-04-20 01:50,SHA,6066,737-800,21,3,30,2,2,26,,,,,9,5
2019-04-20 01:50,URC,205T,737-800,17,2,23,3,3,24,,,,,6,7
2019-04-20 01:47,HRB,7113,737-800,8,5,24,5,4,20,,,,,16,12
2019-04-20 01:46,HRB,1480,737-800,5,8,20,8,7,20,,,,,15,15
2019-04-20 01:44,HGH,5346,737-800,20,4,28,4,4,26,,,,,8,6
2019-04-20 01:37,URC,6995,737-800,16,4,24,6,6,20,,,,,8,4
2019-04-20 01:37,URC,5135,737-800,16,2,20,2,3,20,,,,,4,4
2019-04-20 01:36,XIY,1161,737-800,17,4,22,3,3,20,,,,,5,3
2019-04-20 01:29,HHA,1548,737-800,25,2,28,2,2,28,,,,,3,3
2019-04-20 01:27,FOC,5182,737-800,20,3,25,3,3,25,,,,,5,5
2019-04-20 01:26,SYX,1541,737-800,30,5,34,5,4,33,,,,,4,3
2019-04-20 01:21,CGO,6800,737-800,14,4,22,4,4,22,,,,,8,8
2019-04-20 01:18,HAK,1141,737-800,28,5,34,6,6,33,,,,,6,5
2019-04-20 01:17,HGH,1795,737-800,25,5,28,5,5,28,,,,,3,3
2019-04-20 01:16,103,5538,737-800,12,1,25,1,1,25,,,,,13,13
2019-04-20 01:15,XIY,1163,737-800,20,8,15,5,4,14,,,,,-5,-6
2019-04-20 01:14,FOC,1905,737-800,21,3,26,3,3,24,,,,,5,3
2019-04-20 01:09,HHA,5853,737-800,25,6,32,6,6,28,,,,,7,3
2019-04-20 01:09,HAK,1996,737-800,25,4,30,5,4,30,,,,,5,5
2019-04-20 01:08,URC,1727,737-800,20,4,24,4,4,20,,,,,4,0
2019-04-20 01:07,XIY,6061,737-800,16,4,25,4,5,24,,,,,9,8
2019-04-20 01:02,XIY,5687,737-800,17,4,23,4,4,22,,,,,6,5
2019-04-20 01:02,HHA,7616,737-800,25,4,28,3,4,29,,,,,3,4
2019-04-20 01:01,URC,1373,737-800,18,4,22,4,4,16,,,,,4,-2
2019-04-20 00:58,XIY,7886,737-800,20,2,22,3,3,22,,,,,2,2
2019-04-20 00:57,CKG,5521,737-800,21,4,25,4,4,25,,,,,4,4
2019-04-20 00:56,URC,1322,737-800,15,4,22,4,4,24,,,,,7,9
2019-04-20 00:55,HAK,7398,737-800,27,6,34,4,4,30,,,,,7,3
2019-04-20 00:52,CAN,1728,737-800,22,4,30,4,4,26,,,,,8,4
2019-04-20 00:50,DLC,7377,737-800,12,5,20,6,5,21,,,,,8,9
2019-04-20 00:49,CAN,1995,737-800,23,5,30,6,6,30,,,,,7,7
2019-04-20 00:48,YIH,1433,737-800,24,4,26,3,3,22,,,,,2,-2
2019-04-20 00:48,KMG ,6809,737-800,28,5,20,6,6,21,,,,,-8,-7
2019-04-20 00:48,CGO,1587,737-800,13,3,23,4,2,20,,,,,10,7
2019-04-20 00:47,PEK,5620,737-800,10,4,26,2,4,20,,,,,16,10
2019-04-20 00:47,URC,5709,737-800,20,4,26,6,6,24,,,,,6,4
2019-04-20 00:46,TYN,5090,737-800,15,2,20,2,2,18,,,,,5,3
2019-04-20 00:44,XIY,5136,737-800,17,4,24,4,4,26,,,,,7,9
2019-04-20 00:42,CGO,5480,737-800,14,4,22,4,6,21,,,,,8,7
2019-04-20 00:38,FOC,1906,737-800,22,6,30,6,6,28,,,,,8,6
2019-04-20 00:36,XIY,5180,737-800,17,6,26,7,7,24,,,,,9,7
2019-04-20 00:24,DLC,1102,737-800,14,4,24,4,4,22,,,,,10,8
2019-04-20 00:23,KHG,205U,737-800,23,4,26,2,2,22,,,,,3,-1
2019-04-20 00:22,MIG,5409,737-800,22,4,26,7,6,28,,,,,4,6
2019-04-20 00:21,SYX,1130,737-800,29,2,36,3,2,34,,,,,7,5
2019-04-20 00:16,PEK,1346,737-800,15,4,26,4,4,20,,,,,11,5
2019-04-20 00:15,HAK,5138,737-800,28,3,32,7,6,36,,,,,4,8
2019-04-20 00:12,URC,5371,737-800,15,7,20,5,6,21,,,,,5,6
2019-04-20 00:09,CKG,7618,737-800,22,4,28,6,5,26,,,,,6,4
2019-04-20 00:06,URC,205V,737-800,21,5,28,4,4,25,,,,,7,4
2019-04-20 00:03,ZGC,1347,737-800,10,8,25,9,8,27,,,,,15,17
2019-04-20 00:01,URC,5855,737-800,17,7,21,6,6,22,,,,,4,5
2019-04-19 23:55,PEK,5375,737-800,17,1,14,3,3,20,,,,,-3,3
2019-04-19 23:52,URC,5502,737-800,20,5,20,5,4,22,,,,,0,2
2019-04-19 23:50,104,7175,737-800,16,3,23,4,3,21,,,,,7,5
2019-04-19 23:43,HAK,5581,737-800,28,9,32,6,6,37,,,,,4,9
2019-04-19 23:43,DLC,5359,737-800,12,4,18,4,4,20,,,,,6,8
2019-04-19 23:41,HAK,5082,737-800,27,6,36,5,4,32,,,,,9,5
2019-04-19 23:37,CGO,1568,737-800,20,3,23,2,2,22,,,,,3,2
2019-04-19 23:36,HAK,5852,737-800,29,4,32,6,6,31,,,,,3,2
2019-04-19 23:34,XIY,5136,737-800,17,4,24,4,4,26,,,,,7,9
2019-04-19 23:33,DLC,6062,737-800,13,2,22,2,2,22,,,,,9,9
2019-04-19 23:29,MIG,5407,737-800,24,4,22,6,6,28,,,,,-2,4
2019-04-19 23:23,URC,1372,737-800,18,4,14,4,4,18,,,,,-4,0
2019-04-19 23:22,SZX ,6063,737-800,23,5,30,4,5,30,,,,,7,7
2019-04-19 23:17,SZX,5429,737-800,21,2,29,3,3,30,,,,,8,9
2019-04-19 23:14,URC,1325,737-800,17,4,20,4,4,18,,,,,3,1
2019-04-19 23:07,HAK,5416,737-800,28,8,31,9,9,30,,,,,3,2
2019-04-19 23:06,HHA,1503,737-800,24,3,29,3,3,28,,,,,5,4
2019-04-19 23:01,´óÁ¬,1497,737-800,12,5,22,4,4,21,,,,,10,9
2019-04-19 23:00,HAK,5467,737-800,28,3,36,3,2,26,,,,,8,-2
2019-04-19 22:53,SYX,1735,737-800,30,4,34,6,4,30,,,,,4,0
2019-04-19 22:53,HHA,5798,737-800,25,3,23,2,2,25,,,,,-2,0
2019-04-19 22:52,XIY,5439,737-800,18,5,20,4,5,20,,,,,2,2
2019-04-19 22:50,HAK,5662,737-800,28,5,32,4,6,30,,,,,4,2
2019-04-19 22:46,HAK,5139,737-800,28,8,36,7,6,33,,,,,8,5
2019-04-19 22:44,HGH,5579,737-800,30,5,29,5,5,28,,,,,-1,-2
2019-04-19 22:39,XIY,1375,737-800,20,3,22,2,2,24,,,,,2,4
2019-04-19 22:37,MIG,5732,737-800,22,2,26,3,3,26,,,,,4,4
2019-04-19 22:30,CAN,1493,737-800,22,6,28,6,6,26,,,,,6,4
2019-04-19 22:29,CAN,1538,737-800,22,3,30,5,2,28,,,,,8,6
2019-04-19 22:27,CAN,1799,737-800,20,6,30,6,5,30,,,,,10,10
2019-04-19 22:24,HAK,5372,737-800,28,8,35,8,8,33,,,,,7,5
2019-04-19 22:20,URC,1323,737-800,23,4,24,4,4,24,,,,,1,1
2019-04-19 22:20,FOC,5503,737-800,21,4,26,4,3,26,,,,,5,5
2019-04-19 22:16,XNN,1491,737-800,15,6,26,6,6,25,,,,,11,10
2019-04-19 22:16,HAK,7173,737-800,30,6,36,7,6,35,,,,,6,5
2019-04-19 22:08,ZGC,7378,737-800,15,8,19,7,8,20,,,,,4,5
2019-04-19 21:37,XNN,7171,737-800,15,4,22,5,4,22,,,,,7,7
2019-04-19 20:47,HAK,5153,737-800,35,7,35,5,5,36,,,,,0,1
2019-04-19 20:06,DLC,7172,737-800,15,5,26,4,4,24,,,,,11,9
2019-04-19 19:40,DLC,1545,737-800,16,6,22,6,4,22,,,,,6,6
2019-04-19 19:39,DLC,1501,737-800,20,4,24,3,4,22,,,,,4,2
2019-04-19 19:39,HAK,206H,737-800,29,4,35,3,3,34,,,,,6,5
2019-04-19 19:36,DLC,1501,737-800,20,4,24,3,4,22,,,,,4,2
2019-04-19 19:35,DLC,1501,737-800,20,4,24,3,4,22,,,,,4,2
2019-04-19 19:35,DLC,1501,737-800,20,4,24,3,4,22,,,,,4,2
2019-04-19 18:34,ZGC,1490,737-800,15,6,21,4,5,20,,,,,6,5
2019-04-19 18:15,CAN,1997,737-800,24,4,30,3,3,25,,,,,6,1
2019-04-19 18:11,HGH,1103,737-800,25,4,21,4,4,26,,,,,-4,1
2019-04-19 18:08,URC,5735,737-800,22,4,23,3,3,22,,,,,1,0
2019-04-19 18:08,URC,5735,737-800,22,4,23,3,3,22,,,,,1,0
2019-04-19 18:07,URC,1725,737-800,22,4,22,4,4,20,,,,,0,-2
2019-04-19 18:06,URC,1725,737-800,22,4,22,4,4,20,,,,,0,-2
2019-04-19 17:35,KMG,6809,737-800,28,5,20,6,6,21,,,,,-8,-7
2019-04-19 17:04,XUZ,7990,737-800,20,2,24,4,3,23,,,,,4,3
2019-04-19 14:40,PEK,6060,737-800,20,6,19,5,5,23,,,,,-1,3
2019-04-19 13:39,HAK,5713,737-800,37,9,30,8,8,32,,,,,-7,-5
2019-04-19 11:10,CTU,7989,737-800,20,5,21,5,4,29,,,,,1,9
2019-04-19 10:29,CAN,1728,737-800,25,4,30,5,4,27,,,,,5,2
2019-04-19 10:07,PEK,5539,737-800,12,3,23,3,4,22,,,,,11,10
2019-04-19 08:55,SZX,1489,737-800,26,4,30,4,4,30,,,,,4,4
2019-04-19 08:49,PEK,7639,737-800,20,8,28,7,7,24,,,,,8,4
2019-04-19 08:42,PEK ,7639,737-800,20,8,28,7,7,24,,,,,8,4
2019-04-19 08:18,HGH,1795,737-800,20,4,24,6,4,26,,,,,4,6
2019-04-19 08:03,ÖØÇì,5522,737-800,27,6,30,7,5,26,,,,,3,-1
2019-04-19 07:43,HAK,5405,737-800,27,5,36,6,4,35,,,,,9,8
2019-04-19 07:38,ZGC,7377,737-800,15,6,2,6,6,22,,,,,-13,7
2019-04-19 07:05,PEK,5463,737-800,17,4,26,4,4,18,,,,,9,1
2019-04-19 06:41,XMN,5580,737-800,20,6,32,6,6,32,1,1,,11,12,12
2019-04-19 06:40,XMN,1541,737-800,20,6,26,6,6,28,,,,,6,8
2019-04-19 06:40,XMN,5580,737-800,20,6,32,6,6,32,,,,,12,12
2019-04-19 06:39,XMN,1783,737-800,18,5,24,6,6,25,,,,,6,7
2019-04-19 06:13,PEK,1141,737-800,13,4,28,7,7,30,,,,,15,17
2019-04-19 06:09,XIY,5115,737-800,20,4,16,5,5,26,,,,,-4,6
2019-04-19 05:51,HAK,5141,737-800,28,6,32,6,6,30,,,,,4,2
2019-04-19 05:32,SYX,5375,737-800,28,3,30,3,3,31,,,,,2,3
2019-04-19 05:31,FOC,5182,737-800,23,3,28,4,4,26,,,,,5,3
2019-04-19 05:31,FOC,5182,737-800,23,3,28,4,4,26,,,,,5,3
2019-04-19 05:27,KMG,5409,737-800,15,4,24,4,4,24,,,,,9,9
2019-04-19 05:26,HHA,7616,737-800,23,4,28,4,4,30,,,,,5,7
2019-04-19 05:15,HRB,1562,737-800,3,4,22,4,4,21,,,,,19,18
2019-04-19 05:11,FOC,5503,737-800,23,5,25,4,4,25,,,,,2,2
2019-04-19 05:09,FOC,7105,737-800,22,4,30,5,4,28,,,,,8,6
2019-04-19 05:09,PEK,5540,737-800,15,1,20,1,2,22,,,,,5,7
2019-04-19 04:57,KMG,7990,737-800,18,5,22,4,4,24,,,,,4,6
2019-04-19 04:56,PEK,5482,737-800,13,0,16,2,2,18,,,,,3,5
2019-04-19 04:55,HAK,7992,737-800,26,7,30,7,7,30,,,,,4,4
2019-04-19 04:53,ZGC,1490,737-800,15,4,18,5,6,19,,,,,3,4
2019-04-19 04:45,HHA,1787,737-800,19,2,28,1,1,24,,,,,9,5
2019-04-19 04:44,HGH,5798,737-800,20,3,24,2,1,23,,,,,4,3
2019-04-19 04:44,HAK,1793,737-800,28,4,34,5,4,32,,,,,6,4
2019-04-19 04:38,KMG,1588,737-800,18,4,24,4,4,24,,,,,6,6
2019-04-19 04:36,HGH,1487,737-800,21,3,26,3,3,24,,,,,5,3
2019-04-19 04:34,URC,1498,737-800,19,5,24,5,5,22,,,,,5,3
2019-04-19 04:32,HAK,5467,737-800,28,0,28,0,0,22,,,,,0,-6
2019-04-19 04:18,SYX,5661,737-800,28,4,32,8,8,32,,,,,4,4
2019-04-19 04:18,XIY,5430,737-800,21,6,28,5,5,28,,,,,7,7
2019-04-19 04:16,CAN,5620,737-800,21,2,30,2,3,26,,,,,9,5
2019-04-19 04:12,SYX,2158,737-800,28,8,32,5,5,29,,,,,4,1
2019-04-19 04:09,HGH,1103,737-800,24,3,31,3,3,26,,,,,7,2
2019-04-19 04:08,XIY,1903,737-800,20,2,26,2,2,28,,,,,6,8
2019-04-19 04:08,CKG,7618,737-800,25,6,28,6,6,28,,,,,3,3
2019-04-19 04:07,FOC,1350,737-800,20,4,26,5,5,24,,,,,6,4
2019-04-19 04:01,CGO,6015,737-800,17,4,24,4,4,22,,,,,7,5
2019-04-19 03:55,HAK,7173,737-800,27,5,22,6,5,22,,,,,-5,-5
2019-04-19 03:51,HAK,5337,737-800,26,4,34,5,5,34,,,,,8,8
2019-04-19 03:51,FOC,1433,737-800,20,4,24,3,3,24,,,,,4,4
2019-04-19 03:43,CAN,1538,737-800,25,3,32,4,3,28,,,,,7,3
2019-04-19 03:39,URC,1322,737-800,20,2,22,4,2,24,,,,,2,4
2019-04-19 03:38,XIY,5180,737-800,25,6,28,6,6,27,,,,,3,2
2019-04-19 03:37,KMG,7167,737-800,19,4,24,6,6,22,,,,,5,3
2019-04-19 03:35,HAK,1793,737-800,26,4,34,5,4,32,,,,,8,6
2019-04-19 03:34,URC,5636,737-800,18,2,24,2,2,25,,,,,6,7
2019-04-19 03:34,URC,1568,737-800,18,6,24,6,6,21,,,,,6,3
2019-04-19 03:33,SZX,6063,737-800,25,6,30,5,6,30,,,,,5,5
2019-04-19 03:25,XIY,5136,737-800,22,4,24,4,5,28,,,,,2,6
2019-04-19 03:23,HAK,5521,737-800,27,4,31,4,2,27,,,,,4,0
2019-04-19 03:22,URC,5709,737-800,18,5,26,3,5,27,,,,,8,9
2019-04-19 03:22,SZX,1496,737-800,25,6,34,6,5,33,,,,,9,8
2019-04-19 03:21,URC,1547,737-800,16,4,25,3,5,27,,,,,9,11
2019-04-19 03:21,HAK,1502,737-800,27,3,32,4,4,32,,,,,5,5
2019-04-19 03:18,DLC,7172,737-800,12,4,23,4,4,21,,,,,11,9
2019-04-19 03:15,HHA,5138,737-800,26,2,26,4,4,29,,,,,0,3
2019-04-19 03:14,YIH,1435,737-800,20,4,26,4,4,24,,,,,6,4
2019-04-19 03:13,HGH,7378,737-800,21,5,26,5,5,28,,,,,5,7
2019-04-19 03:12,HHA,1503,737-800,22,1,24,4,3,28,,,,,2,6
2019-04-19 03:11,XIY,5116,737-800,21,4,24,4,4,26,,,,,3,5
2019-04-19 03:11,CGO,1729,737-800,15,4,20,4,4,18,,,,,5,3
2019-04-19 03:11,XIY,1548,737-800,21,4,4,4,4,26,,,,,-17,5
2019-04-19 03:09,SZX,1386,737-800,25,4,31,4,4,28,,,,,6,3
2019-04-19 03:07,HHA,1549,737-800,21,4,30,4,4,28,,,,,9,7
2019-04-19 03:05,URC,5481,737-800,19,6,24,5,5,22,,,,,5,3
2019-04-19 03:04,CGO,1208,737-800,16,3,23,4,3,22,,,,,7,6
2019-04-19 03:04,TYN,5418,737-800,10,4,24,4,4,26,,,,,14,16
2019-04-19 03:02,FOC,1375,737-800,20,4,28,4,4,25,,,,,8,5
2019-04-19 03:00,URC,5481,737-800,19,6,24,5,5,22,,,,,5,3
2019-04-19 02:57,HAK,5090,737-800,27,1,30,2,2,30,,,,,3,3
2019-04-19 02:49,KMG,1209,737-800,19,4,27,4,4,22,,,,,8,3
2019-04-19 02:46,SYX,1735,737-800,39,4,32,4,4,28,,,,,-7,-11
2019-04-19 02:45,HGH,1505,737-800,20,3,30,4,4,24,,,,,10,4
2019-04-19 02:44,HGH,1505,737-800,20,3,30,4,4,24,,,,,10,4
2019-04-19 02:43,CAN,1493,737-800,22,5,30,5,5,28,,,,,8,6
2019-04-19 02:43,HRB,7395,737-800,5,6,21,6,6,20,,,,,16,15
2019-04-19 02:38,XIY,1903,737-800,20,6,27,2,3,22,,,,,7,2
2019-04-19 02:37,XIY,1902,737-800,20,6,27,2,3,22,,,,,7,2
2019-04-19 02:37,XIY,1902,737-800,20,6,27,2,3,22,,,,,7,2
2019-04-19 02:36,XIY,5115,737-800,20,4,20,5,4,18,,,,,0,-2
2019-04-19 02:34,URC,5855,737-800,17,4,25,4,4,25,,,,,8,8
2019-04-19 02:33,URC,5637,737-800,17,2,22,2,2,20,,,,,5,3
2019-04-19 02:31,URC,5637,737-800,22,2,22,2,2,23,,,,,0,1
2019-04-19 02:30,DLC,1497,737-800,10,4,22,4,4,20,,,,,12,10
2019-04-19 02:30,URC,2157,737-800,17,4,24,4,4,20,,,,,7,3
2019-04-19 02:28,XIY,1797,737-800,20,3,26,3,3,25,,,,,6,5
2019-04-19 02:26,KMG,7991,737-800,20,6,24,7,6,23,,,,,4,3
2019-04-19 02:25,DLC,1786,737-800,10,4,18,4,4,16,,,,,8,6
2019-04-19 02:24,URC,1325,737-800,17,4,26,4,4,20,,,,,9,3
2019-04-19 02:23,URC,6103,737-800,17,5,22,5,5,22,,,,,5,5
2019-04-19 02:22,XIY,5687,737-800,24,4,12,4,4,26,,,,,-12,2
2019-04-19 02:19,DLC,5359,737-800,13,6,20,5,6,16,,,,,7,3
2019-04-19 02:16,URC,6268,737-800,19,4,28,4,5,28,,,,,9,9
2019-04-19 02:12,XIY,1483,737-800,22,5,24,6,6,24,,,,,2,2
2019-04-19 02:08,SYX,206G,737-800,30,3,35,4,4,32,,,,,5,2
2019-04-19 02:07,ÐìÖÝ,1501,737-800,20,4,27,4,5,26,,,,,7,6
2019-04-19 02:07,ÐìÖÝ,1501,737-800,20,4,27,4,5,26,,,,,7,6
2019-04-19 02:07,XIY,1162,737-800,18,3,30,3,3,26,,,,,12,8
2019-04-19 02:07,XIY,1162,737-800,18,3,30,3,3,26,,,,,12,8
2019-04-19 02:07,XIY,5439,737-800,22,4,24,3,4,24,,,,,2,2
2019-04-19 02:06,SZX,5733,737-800,25,5,30,5,6,28,,,,,5,3
2019-04-19 02:05,XIY,1482,737-800,22,4,32,5,5,26,1,,,1,10,4
2019-04-19 02:05,CAN,7379,737-800,25,4,34,2,2,36,,,,,9,11
2019-04-19 02:01,XIY,1163,737-800,15,5,28,2,2,20,,,,,13,5
2019-04-19 02:00,HGH,5479,737-800,22,5,26,5,5,27,,,,,4,5
2019-04-19 02:00,HAK,5638,737-800,28,4,32,4,4,35,,,,,4,7
2019-04-19 01:59,URC,6995,737-800,19,6,26,6,7,22,,,,,7,3
2019-04-19 01:57,PEK,1733,737-800,15,4,19,3,2,17,,,,,4,2
2019-04-19 01:55,KMG,6016,737-800,19,5,28,5,5,25,,,,,9,6
2019-04-19 01:55,PEK,5538,737-800,15,3,28,3,3,27,,,,,13,12
2019-04-19 01:54,CGO,1587,737-800,17,3,24,4,2,20,,,,,7,3
2019-04-19 01:52,CGO,6800,737-800,20,4,22,4,4,23,,,,,2,3
2019-04-19 01:51,SZX,1492,737-800,25,4,30,3,3,30,,,,,5,5
2019-04-19 01:50,PEK,6066,737-800,16,2,20,2,2,22,,,,,4,6
2019-04-19 01:46,HAK,5662,737-800,25,3,32,4,5,30,,,,,7,5
2019-04-19 01:45,HAK,5520,737-800,27,5,36,7,5,33,,,,,9,6
2019-04-19 01:38,TYN,5139,737-800,15,6,18,6,4,24,,,,,3,9
2019-04-19 01:37,SYX,5480,737-800,29,3,33,4,4,32,,,,,4,3
2019-04-19 01:34,SZX,1213,737-800,25,6,32,6,6,31,,,,,7,6
2019-04-19 01:32,DLC,1495,737-800,12,2,21,3,3,20,,,,,9,8
2019-04-19 01:30,SYX,206F,737-800,29,4,35,3,3,30,,,,,6,1
2019-04-19 01:27,HHA,5625,737-800,24,5,25,8,8,24,,,,,1,0
2019-04-19 01:24,XIY,7886,737-800,20,4,28,4,4,28,,,,,8,8
2019-04-19 01:24,SYX,1488,737-800,28,6,34,8,8,26,,,,,6,-2
2019-04-19 01:23,URC,205T,737-800,20,3,24,3,3,24,,,,,4,4
2019-04-19 01:21,HAK,5429,737-800,30,3,32,4,4,31,,,,,2,1
2019-04-19 01:18,SZX,1215,737-800,25,3,30,4,3,32,,,,,5,7
2019-04-19 01:17,HAK,5082,737-800,29,6,36,5,4,30,,,,,7,1
2019-04-19 01:16,SZX,1215,737-800,25,3,30,4,3,32,,,,,5,7
2019-04-19 01:10,XIY,1161,737-800,20,6,28,3,3,22,,,,,8,2
2019-04-19 01:02,PEK,7400,737-800,14,5,22,5,5,20,,,,,8,6
2019-04-19 00:58,CAN,1493,737-800,22,5,30,5,5,28,,,,,8,6
2019-04-19 00:57,HAK,1785,737-800,26,0,32,8,8,32,,,,,6,6
2019-04-19 00:57,URC,5375,737-800,19,6,26,6,6,26,,,,,7,7
2019-04-19 00:50,HRB,1559,737-800,5,3,18,4,3,17,,,,,13,12
2019-04-19 00:45,PEK ,5137,737-800,18,2,14,2,2,24,,,,,-4,6
2019-04-19 00:45,HAK,7175,737-800,27,5,34,6,5,31,,,,,7,4
2019-04-19 00:45,ZUH,1373,737-800,24,4,32,4,4,26,,,,,8,2
2019-04-19 00:38,CGO,5346,737-800,18,5,24,5,5,23,,,,,6,5
2019-04-19 00:37,MIG,6809,737-800,25,6,26,5,5,26,,,,,1,1
2019-04-19 00:36,MIG,5732,737-800,25,4,25,4,4,26,,,,,0,1
2019-04-19 00:36,MIG,5732,737-800,25,4,25,4,4,26,,,,,0,1
2019-04-19 00:35,MIG,1798,737-800,25,5,26,4,4,26,,,,,1,1
2019-04-19 00:35,MIG,5407,737-800,24,6,26,5,5,26,,,,,2,2
2019-04-19 00:33,HGH,5373,737-800,24,4,22,6,5,26,,,,,-2,2
2019-04-19 00:31,XIY,5478,737-800,23,4,30,4,4,24,,,,,7,1
2019-04-19 00:30,KHG,1323,737-800,23,2,22,2,2,24,,,,,-1,1
2019-04-19 00:26,HAK,1796,737-800,28,6,34,4,4,30,,,,,6,2
2019-04-19 00:25,URC,205V,737-800,20,4,28,3,3,24,,,,,8,4
2019-04-19 00:23,CAN,1995,737-800,25,6,31,6,6,30,,,,,6,5
2019-04-19 00:21,URC,1545,737-800,19,4,24,5,4,22,,,,,5,3
2019-04-19 00:16,CGO,1569,737-800,20,2,26,3,3,24,,,,,6,4
2019-04-19 00:06,FOC,1905,737-800,23,4,28,4,4,24,,,,,5,1
2019-04-19 00:06,SZX,6065,737-800,25,5,32,4,5,31,,,,,7,6
2019-04-19 00:01,HAK,5153,737-800,29,3,36,3,4,35,,,,,7,6
2019-04-19 00:00,HAK,5371,737-800,29,9,31,6,6,32,,,,,2,3
2019-04-18 23:56,CAN,1929,737-800,24,3,30,3,3,26,,,,,6,2
2019-04-18 23:51,XIY,5406,737-800,22,3,27,6,4,25,,,,,5,3
2019-04-18 23:46,CAN,5408,737-800,25,4,32,4,4,28,,,,,7,3
2019-04-18 23:41,XIY,1346,737-800,24,6,30,6,6,26,,,,,6,2
2019-04-18 23:39,CAN,5372,737-800,25,8,31,8,8,30,,,,,6,5
2019-04-18 23:34,DLC,1927,737-800,15,4,20,4,4,23,,,,,5,8
2019-04-18 23:30,ÖØÇì,1101,737-800,28,3,28,2,2,30,,,,,0,2
2019-04-18 23:29,KMG,7993,737-800,20,6,24,7,6,22,,,,,4,2
2019-04-18 23:25,SYX,1130,737-800,29,3,33,3,3,30,,,,,4,1
2019-04-18 23:17,PEK,6062,737-800,15,4,22,4,4,24,,,,,7,9
2019-04-18 23:06,HAK,206H,737-800,25,3,33,3,3,33,,,,,8,8
2019-04-18 23:02,HAK,5358,737-800,29,8,32,8,8,33,,,,,3,4
2019-04-18 22:55,HAK,5712,737-800,28,2,28,1,1,28,,,,,0,0
2019-04-18 22:54,HAK,5712,737-800,28,2,28,1,1,28,,,,,0,0
2019-04-18 22:53,HRB,1906,737-800,7,8,22,6,6,26,,,,,15,19
2019-04-18 22:51,XIY,6061,737-800,20,4,25,4,4,25,,,,,5,5
2019-04-18 22:45,SYX,7619,737-800,29,4,28,7,6,30,,,,,-1,1
2019-04-18 22:42,HRB,1480,737-800,5,3,18,3,4,17,,,,,13,12
2019-04-18 22:35,HAK,5416,737-800,29,8,30,8,8,36,,,,,1,7
2019-04-18 22:32,XIY,1131,737-800,20,5,29,4,4,29,,,,,9,9
2019-04-18 22:30,CAN,1799,737-800,24,4,32,5,5,30,,,,,8,6
2019-04-18 22:27,XNN,1491,737-800,20,6,24,6,5,25,,,,,4,5
2019-04-18 22:12,ZGC,5462,737-800,20,5,24,8,6,22,,,,,4,2
2019-04-18 22:07,HGH,5623,737-800,20,6,30,5,5,28,,,,,10,8
2019-04-18 21:45,PEK,7398,737-800,20,4,24,2,2,20,,,,,4,0
2019-04-18 21:39,Ì«Ô­,1928,737-800,15,5,18,5,4,20,,,,,3,5
2019-04-18 21:35,HAK,5089,737-800,30,6,29,1,1,33,,,,,-1,3
2019-04-18 21:33,XNN,7171,737-800,20,4,20,5,4,22,,,,,0,2
2019-04-18 20:51,ÐìÖÝ,7988,737-800,15,4,28,4,3,27,,,,,13,12
2019-04-18 20:25,HAK,5581,737-800,30,8,32,6,5,34,,,,,2,4
2019-04-18 18:58,DLC,1102,737-800,14,3,23,3,4,21,,,,,9,7
2019-04-18 16:36,XIY,1161,737-800,23,4,26,4,4,23,,,,,3,0
2019-04-18 15:30,FOC,1348,737-800,25,4,30,4,4,28,,,,,5,3
2019-04-18 14:38,URC,7198,737-800,23,7,24,6,5,22,,,,,1,-1
2019-04-18 08:34,HAK,5712,737-800,27,3,31,2,2,29,,,,,4,2
2019-04-18 08:26,PEK,7639,737-800,18,6,28,6,6,24,,,,,10,6
2019-04-18 07:40,HGH,1372,737-800,20,5,20,4,4,24,,,,,0,4
2019-04-18 07:00,CGO,205T,737-800,25,2,30,3,3,28,,,,,5,3
2019-04-18 06:50,CAN,5620,737-800,25,3,33,3,3,30,,,,,8,5
2019-04-18 06:47,PEK,1727,737-800,19,2,20,4,5,21,,,,,1,2
2019-04-18 06:31,PEK,1733,737-800,18,3,20,3,3,20,,,,,2,2
2019-04-18 05:57,KMG,7992,737-800,20,7,23,8,7,22,,,,,3,2
2019-04-18 05:45,XIY,1995,737-800,24,6,28,6,6,27,,,,,4,3
2019-04-18 05:28,SZX,1996,737-800,24,4,24,4,4,28,,,,,0,4
2019-04-18 05:21,XMN,5625,737-800,22,4,28,4,4,24,,,,,6,2
2019-04-18 05:20,XMN,7400,737-800,22,4,26,4,5,22,,,,,4,0
2019-04-18 05:19,XMN,1929,737-800,20,2,27,2,1,28,,,,,7,8
2019-04-18 05:19,CAN,5408,737-800,25,5,31,5,5,31,,,,,6,6
2019-04-18 05:19,XMN,6060,737-800,21,2,24,2,3,32,,1,,1,3,11
2019-04-18 05:18,KMG,7167,737-800,20,6,25,6,6,22,,,,,5,2
2019-04-18 05:15,URC,5636,737-800,15,4,22,6,6,22,,,,,7,7
2019-04-18 05:12,FOC,5182,737-800,21,2,28,4,3,24,,,,,7,3
2019-04-18 05:07,HRB,1348,737-800,1,5,18,4,5,20,,,,,17,19
2019-04-18 04:57,HHA,1787,737-800,22,2,24,2,2,22,,,,,2,0
2019-04-18 04:55,FOC,7395,737-800,20,4,26,5,5,27,,,,,6,7
2019-04-18 04:51,SYX ,206G ,737-800,28,5,25,8,8,30,,,,,-3,2
2019-04-18 04:47,PEK,5428,737-800,24,4,22,5,4,29,,,,,-2,5
2019-04-18 04:42,HAK,5153,737-800,27,3,33,4,4,33,,,,,6,6
2019-04-18 04:39,XIY,1162,737-800,23,4,28,4,4,24,,,,,5,1
2019-04-18 04:38,CGO,7173,737-800,22,4,0,4,4,24,,,,,-22,2
2019-04-18 04:38,XIY,5116,737-800,21,4,20,4,4,20,,,,,-1,-1
2019-04-18 04:26,SYX,1796,737-800,28,6,34,6,5,32,,,,,6,4
2019-04-18 04:23,PEK,5520,737-800,15,7,28,5,5,25,,,,,13,10
2019-04-18 04:21,FOC,1346,737-800,20,5,29,4,4,24,,,,,9,4
2019-04-18 04:20,PEK ,1497,737-800,20,3,22,2,2,20,,,,,2,0
2019-04-18 04:19,HAK,5346,737-800,25,4,31,4,3,31,,,,,6,6
2019-04-18 04:17,PEK,5338,737-800,23,3,22,5,4,25,,,,,-1,2
2019-04-18 04:11,PEK,5482,737-800,22,4,20,4,2,24,,,,,-2,2
2019-04-18 04:10,PEK,5538,737-800,20,0,28,0,0,27,,,,,8,7
2019-04-18 04:09,MIG,5732,737-800,20,4,24,3,3,24,,,,,4,4
2019-04-18 04:07,XIY,1902,737-800,20,5,26,8,6,24,,,,,6,4
2019-04-18 04:03,SYX ,5480,737-800,28,5,22,5,6,24,,,,,-6,-4
2019-04-18 04:01,TYN ,5139,737-800,19,4,24,6,4,25,,,,,5,6
2019-04-18 03:58,HAK,1103,737-800,26,5,34,6,5,28,,,,,8,2
2019-04-18 03:56,PEK,5481,737-800,21,5,23,4,4,26,,,,,2,5
2019-04-18 03:54,URC,5637,737-800,17,3,24,3,2,21,,,,,7,4
2019-04-18 03:52,KMG ,6809,737-800,15,6,20,6,7,18,,,,,5,3
2019-04-18 03:48,URC,5375,737-800,17,6,18,5,4,21,,,,,1,4
2019-04-18 03:45,SYX,5418,737-800,29,5,32,4,4,34,,,,,3,5
2019-04-18 03:38,SYX,1735,737-800,29,4,34,3,4,30,,,,,5,1
2019-04-18 03:37,FOC,1433,737-800,19,3,26,3,3,21,,,,,7,2
2019-04-18 03:36,FOC,1433,737-800,19,4,30,5,4,26,,,,,11,7
2019-04-18 03:34,ZGC,1215,737-800,15,5,14,4,5,16,,,,,-1,1
2019-04-18 03:33,ZGC,5462,737-800,10,8,16,6,6,14,,,,,6,4
2019-04-18 03:32,HAK,1793,737-800,25,3,32,7,6,31,,,,,7,6
2019-04-18 03:32,URC,1545,737-800,16,5,26,5,5,26,,,,,10,10
2019-04-18 03:31,HAK,5082,737-800,25,4,35,4,4,32,,,,,10,7
2019-04-18 03:31,HAK,5090,737-800,25,2,32,2,2,30,,,,,7,5
2019-04-18 03:30,FOC,1350,737-800,24,4,26,4,4,22,,,,,2,-2
2019-04-18 03:26,HAK,5735,737-800,22,2,23,4,4,25,,,,,1,3
2019-04-18 03:24,HAK,1141,737-800,27,4,28,4,3,25,,,,,1,-2
2019-04-18 03:23,HGH,5623,737-800,20,6,28,5,5,25,,,,,8,5
2019-04-18 03:22,KMG,6015,737-800,19,3,23,5,5,22,,,,,4,3
2019-04-18 03:19,XIY,5430,737-800,23,7,28,6,6,28,,,,,5,5
2019-04-18 03:17,212,7377,737-800,26,8,30,8,7,33,,,,,4,7
2019-04-18 03:13,SYX,7619,737-800,29,6,29,6,5,30,,,,,0,1
2019-04-18 03:13,URC,1570,737-800,17,3,21,3,3,20,,,,,4,3
2019-04-18 03:12,URC,1322,737-800,17,3,22,4,4,23,,,,,5,6
2019-04-18 03:09,HGH,1101,737-800,25,4,30,2,2,28,,,,,5,3
2019-04-18 02:56,FOC,5503,737-800,19,3,26,3,3,24,,,,,7,5
2019-04-18 02:56,SZX,6063,737-800,25,6,32,6,5,30,,,,,7,5
2019-04-18 02:53,DLC,5687,737-800,14,2,26,4,4,24,,,,,12,10
2019-04-18 02:52,HGH,5798,737-800,20,4,22,3,3,20,,,,,2,0
2019-04-18 02:48,HAK,1795,737-800,27,4,28,5,5,32,,,,,1,5
2019-04-18 02:47,SZX,5733,737-800,25,6,30,6,6,30,,,,,5,5
2019-04-18 02:47,HHA,1503,737-800,22,0,20,2,2,24,,,,,-2,2
2019-04-18 02:46,KMG,6016,737-800,20,3,26,4,2,29,,,,,6,9
2019-04-18 02:42,URC,5636,737-800,15,4,22,6,6,22,,,,,7,7
2019-04-18 02:41,URC,5709,737-800,15,4,23,4,3,22,,,,,8,7
2019-04-18 02:37,DLC,7398,737-800,16,4,25,4,4,21,,,,,9,5
2019-04-18 02:35,DLC,1797,737-800,10,4,22,3,3,23,,,,,12,13
2019-04-18 02:35,DLC,1786,737-800,12,4,23,4,4,20,,,,,11,8
2019-04-18 02:34,URC,1547,737-800,17,6,22,6,6,22,,,,,5,5
2019-04-18 02:34,HHA,1487,737-800,25,2,24,3,3,24,,,,,-1,-1
2019-04-18 02:34,SYX,1735,737-800,29,34,4,3,4,30,,,,,-25,1
2019-04-18 02:31,SYX,1130,737-800,28,3,33,3,3,32,,,,,5,4
2019-04-18 02:31,URC,1568,737-800,16,5,24,6,6,22,,,,,8,6
2019-04-18 02:30,XIY,1903,737-800,23,2,26,3,4,25,,,,,3,2
2019-04-18 02:26,CAN,7175,737-800,25,5,32,6,5,28,,,,,7,3
2019-04-18 02:25,CTU,7989,737-800,21,6,31,6,5,28,,,,,10,7
2019-04-18 02:24,XIY,5686,737-800,20,4,24,4,4,20,,,,,4,0
2019-04-18 02:21,HAK,1502,737-800,27,4,32,3,3,34,,,,,5,7
2019-04-18 02:19,1483,XIY,737-800,22,4,22,4,5,24,,,,,0,2
2019-04-18 02:15,URC,206P,737-800,16,4,23,4,5,20,,,,,7,4
2019-04-18 02:13,XIY,1548,737-800,20,4,22,4,4,24,,,,,2,4
2019-04-18 02:13,URC,6995,737-800,15,4,24,4,5,20,,,,,9,5
2019-04-18 02:11,FOC,7105,737-800,22,5,28,5,5,26,,,,,6,4
2019-04-18 02:11,HAK,1131,737-800,27,4,30,4,4,34,,,,,3,7
2019-04-18 02:09,HGH,1785,737-800,20,7,24,7,8,27,,,,,4,7
2019-04-18 02:06,FOC,1905,737-800,19,4,26,3,3,22,,,,,7,3
2019-04-18 02:04,FOC,1905,737-800,16,4,26,4,4,24,,,,,10,8
2019-04-18 02:03,DLC,1927,737-800,15,3,22,6,4,22,,,,,7,7
2019-04-18 02:03,CAN,1538,737-800,25,3,31,5,3,29,,,,,6,4
2019-04-18 02:02,YIH,1351,737-800,20,3,30,3,3,24,,,,,10,4
2019-04-18 02:01,URC,1498,737-800,17,6,24,5,6,21,,,,,7,4
2019-04-18 01:59,HAK,5416,737-800,27,6,32,8,8,28,,,,,5,1
2019-04-18 01:55,SYX,2158,737-800,27,9,32,4,4,29,,,,,5,2
2019-04-18 01:54,KMG,7991,737-800,19,6,24,7,7,22,,,,,5,3
2019-04-18 01:50,TYN,206F,737-800,20,3,24,3,3,23,,,,,4,3
2019-04-18 01:47,XIY,5180,737-800,20,4,26,4,5,29,,,,,6,9
2019-04-18 01:47,HHA,1783,737-800,24,4,25,5,4,28,,,,,1,4
2019-04-18 01:43,TYN,5359,737-800,20,4,21,6,6,25,,,,,1,5
2019-04-18 01:42,TYN,1386,737-800,20,4,22,4,4,20,,,,,2,0
2019-04-18 01:40,HRB,1562,737-800,17,4,26,4,4,24,,,,,9,7
2019-04-18 01:38,XIY,5478,737-800,25,3,28,5,3,23,,,,,3,-2
2019-04-18 01:38,XIY,5478,737-800,25,3,28,5,3,23,,,,,3,-2
2019-04-18 01:33,DLC,5417,737-800,15,2,22,3,3,22,,,,,7,7
2019-04-18 01:31,CGO,1587,737-800,23,3,26,5,3,24,,,,,3,1
2019-04-18 01:28,HGH,5372,737-800,28,7,25,9,8,25,,,,,-3,-3
2019-04-18 01:23,HGH,7379,737-800,20,4,28,3,3,28,,,,,8,8
2019-04-18 01:22,URC,2157,737-800,17,2,22,4,3,24,,,,,5,7
2019-04-18 01:18,PEK,5539,737-800,21,5,24,6,5,25,,,,,3,4
2019-04-18 01:18,YIH,1435,737-800,21,5,29,5,5,26,,,,,8,5
2019-04-18 01:17,CGO,1209,737-800,26,3,29,3,4,27,,,,,3,1
2019-04-18 01:16,PEK,1542,737-800,23,4,26,4,5,22,,,,,3,-1
2019-04-18 01:13,KMG,7990,737-800,20,4,22,4,3,22,,,,,2,2
2019-04-18 01:12,SZX,1213,737-800,24,6,32,6,6,30,,,,,8,6
2019-04-18 01:10,PEK,5853,737-800,22,6,28,6,6,28,,,,,6,6
2019-04-18 00:54,SYX,7378,737-800,29,4,32,4,4,32,,,,,3,3
2019-04-18 00:54,CKG,7618,737-800,20,5,28,6,6,26,,,,,8,6
2019-04-18 00:53,CAN,5638,737-800,24,4,32,4,5,32,,,,,8,8
2019-04-18 00:51,HAK,5713,737-800,26,6,33,6,6,31,,,,,7,5
2019-04-18 00:50,CAN,1728,737-800,25,4,30,5,5,26,,,,,5,1
2019-04-18 00:49,SZX,5521,737-800,25,4,27,4,4,26,,,,,2,1
2019-04-18 00:49,TYN,1373,737-800,20,2,20,2,2,20,,,,,0,0
2019-04-18 00:48,HRB,1559,737-800,2,4,18,4,5,18,,,,,16,16
2019-04-18 00:47,SZX,6065,737-800,25,5,32,4,4,31,,,,,7,6
2019-04-18 00:43,CAN,5465,737-800,27,2,26,2,2,30,,,,,-1,3
2019-04-18 00:42,HAK,1493,737-800,27,6,32,6,6,30,,,,,5,3
2019-04-18 00:38,PEK,6066,737-800,24,6,24,4,4,22,,,,,0,-2
2019-04-18 00:35,CAN,5405,737-800,25,5,36,6,5,34,,,,,11,9
2019-04-18 00:34,DLC,5687,737-800,16,2,6,4,4,24,,,,,-10,8
2019-04-18 00:25,PEK,5522,737-800,23,6,28,6,5,24,,,,,5,1
2019-04-18 00:19,CAN,1799,737-800,25,4,34,5,5,32,,,,,9,7
2019-04-18 00:19,HRB,1906,737-800,2,6,21,6,7,20,,,,,19,18
2019-04-18 00:19,URC,1725,737-800,15,4,23,4,5,26,,,,,8,11
2019-04-18 00:17,KHG,1569,737-800,23,2,26,2,2,24,,,,,3,1
2019-04-18 00:15,HHA,1549,737-800,26,5,28,5,5,26,,,,,2,0
2019-04-18 00:05,URC,5135,737-800,16,2,24,3,2,22,,,,,8,6
2019-04-18 00:05,URC,5580,737-800,16,6,24,6,6,26,,,,,8,10
2019-04-18 00:04,MIG,5407,737-800,20,3,26,3,3,24,,,,,6,4
2019-04-18 00:04,HAK,5358,737-800,27,8,32,7,6,33,,,,,5,6
2019-04-18 00:02,CKG,5661,737-800,20,4,24,4,4,30,,,,,4,10
2019-04-18 00:01,HGH,1541,737-800,19,5,28,5,5,27,,,,,9,8
2019-04-18 00:01,CKG,5467,737-800,25,3,27,3,2,22,,,,,2,-3
2019-04-18 00:00,XIY,1102,737-800,23,3,28,3,3,26,,,,,5,3
2019-04-17 23:58,MIG,5409,737-800,20,4,26,3,3,26,,,,,6,6
2019-04-17 23:58,HAK,5540,737-800,28,4,35,3,4,33,,,,,7,5
2019-04-17 23:57,DLC,1501,737-800,20,1,26,4,4,22,,,,,6,2
2019-04-17 23:55,CGO,6800,737-800,25,4,24,4,4,24,,,,,-1,-1
2019-04-17 23:53,DLC,1495,737-800,16,6,24,4,4,22,,,,,8,6
2019-04-17 23:51,HAK,5479,737-800,27,6,28,6,6,32,,,,,1,5
2019-04-17 23:49,SZX,1496,737-800,24,6,34,5,4,32,,,,,10,8
2019-04-17 23:44,URC,205V,737-800,16,4,26,4,4,24,,,,,10,8
2019-04-17 23:44,CGO,7616,737-800,18,4,26,4,4,26,,,,,8,8
2019-04-17 23:43,URC,6103,737-800,17,5,22,6,6,22,,,,,5,5
2019-04-17 23:35,HGH,5581,737-800,21,3,19,3,3,24,,,,,-2,3
2019-04-17 23:33,URC,205U,737-800,17,3,23,3,2,21,,,,,6,4
2019-04-17 23:29,CGO,1588,737-800,25,4,26,3,4,26,,,,,1,1
2019-04-17 23:26,HAK,5141,737-800,27,5,31,8,8,33,,,,,4,6
2019-04-17 23:23,XIY,7886,737-800,22,4,28,5,4,26,,,,,6,4
2019-04-17 23:22,HAK,1928,737-800,27,6,34,6,6,30,,,,,7,3
2019-04-17 23:20,URC,1323,737-800,17,3,24,3,4,24,,,,,7,7
2019-04-17 23:12,XNN,7171,737-800,20,5,20,5,5,20,,,,,0,0
2019-04-17 23:08,HAK,5797,737-800,27,6,28,5,5,30,,,,,1,3
2019-04-17 23:07,HRB,1480,737-800,2,4,19,3,4,20,,,,,17,18
2019-04-17 23:07,HAK,7993,737-800,27,5,33,5,5,28,,,,,6,1
2019-04-17 23:01,HET,5429,737-800,12,4,16,3,4,20,,,,,4,8
2019-04-17 22:57,URC,5137,737-800,15,3,16,2,2,22,,,,,1,7
2019-04-17 22:42,SYX,1729,737-800,29,5,30,5,5,30,,,,,1,1
2019-04-17 22:40,CAN,5337,737-800,26,4,32,5,5,33,,,,,6,7
2019-04-17 22:34,SHE,1505,737-800,15,8,19,4,4,20,,,,,4,5
2019-04-17 22:32,URC,1325,737-800,15,4,26,4,4,20,,,,,11,5
2019-04-17 22:17,HAK,206H,737-800,27,3,32,3,3,33,,,,,5,6
2019-04-17 22:13,HAK,1489,737-800,27,4,34,4,4,31,,,,,7,4
2019-04-17 22:04,HAK,5371,737-800,25,7,35,6,6,32,,,,,10,7
2019-04-17 22:00,CAN,6061,737-800,27,5,31,5,5,31,,,,,4,4
2019-04-17 21:58,HAK,5089,737-800,27,3,21,2,2,22,,,,,-6,-5
2019-04-17 21:38,MIG,1798,737-800,20,6,26,4,4,24,,,,,6,4
2019-04-17 21:33,XNN,1491,737-800,18,5,24,6,5,24,,,,,6,6
2019-04-17 20:28,XUZ,7988,737-800,24,3,24,4,3,24,,,,,0,0
2019-04-17 20:26,DLC,7172,737-800,20,4,26,5,4,25,,,,,6,5
2019-04-17 18:19,URC,5855,737-800,15,6,22,6,7,20,,,,,7,5
2019-04-17 14:31,URC ,7198 ,737-800,14,4,22,6,4,22,,,,,8,8
2019-04-17 10:03,HAK,5797,737-800,25,6,25,6,6,29,,,,,0,4
2019-04-17 10:02,HAK,5797,737-800,25,6,25,6,6,29,,,,,0,4
2019-04-17 10:02,HAK,5797,737-800,25,6,23,6,6,25,,,,,-2,0
2019-04-17 10:00,HAK,5797,737-800,25,6,23,6,6,25,,,,,-2,0
2019-04-17 09:34,XIY,1482,737-800,18,5,28,6,5,22,,,,,10,4
2019-04-17 09:33,XIY,1482,737-800,18,5,28,6,5,22,,,,,10,4
2019-04-17 08:55,ZGC,5462,737-800,15,4,18,5,4,20,,,,,3,5
2019-04-17 08:54,ZGC,5625,737-800,15,3,20,4,3,21,,,,,5,6
2019-04-17 08:41,HAK,1208,737-800,24,5,33,8,6,28,,,,,9,4
2019-04-17 08:40,FOC,1497,737-800,20,4,26,3,3,24,,,,,6,4
2019-04-17 08:39,1435,1435,737-800,23,5,25,6,5,25,,,,,2,2
2019-04-17 08:38,FOC,5182,737-800,21,3,12,3,4,18,,,,,-9,-3
2019-04-17 08:37,FOC,1497,737-800,20,4,26,3,3,24,,,,,6,4
2019-04-17 08:35,XIY,5853,737-800,18,5,22,5,6,23,,,,,4,5
2019-04-17 08:06,PEK,5538,737-800,15,2,26,2,2,26,,,,,11,11
2019-04-17 08:04,HAK,5416,737-800,26,8,30,8,8,34,,,,,4,8
2019-04-17 08:03,HAK,5139,737-800,27,5,35,8,4,32,,,,,8,5
2019-04-17 08:02,HAK,5579,737-800,25,6,34,6,6,32,,,,,9,7
2019-04-17 07:56,XIY,5115,737-800,15,3,23,6,4,20,,,,,8,5
2019-04-17 06:59,CKG,5661,737-800,16,8,24,4,4,24,,,,,8,8
2019-04-17 06:49,XIY,5430,737-800,15,6,24,6,5,26,,,,,9,11
2019-04-17 06:48,XIY,5180,737-800,15,6,24,3,3,22,,,,,9,7
2019-04-17 06:36,HAK,1505,737-800,25,4,34,4,4,30,,,,,9,5
2019-04-17 06:30,XMN,1490,737-800,20,8,24,8,8,22,,,,,4,2
2019-04-17 06:26,XMN,1549,737-800,20,2,29,4,4,23,,,,,9,3
2019-04-17 06:25,XMN,5373,737-800,20,4,26,4,4,22,,,,,6,2
2019-04-17 06:24,XMN,6066,737-800,15,3,15,2,3,12,,,,,0,-3
2019-04-17 06:23,XMN,6066,737-800,15,3,15,2,3,12,,,,,0,-3
2019-04-17 06:18,HAK,5429,737-800,25,3,31,3,3,32,,,,,6,7
2019-04-17 06:13,TYN,5480,737-800,15,3,20,4,2,20,,,,,5,5
2019-04-17 06:12,PEK ,1542,737-800,16,4,24,3,4,20,,,,,8,4
2019-04-17 06:12,XIY,5478,737-800,17,4,27,5,5,23,,,,,10,6
2019-04-17 05:43,HGH,5855,737-800,18,7,26,7,6,22,,,,,8,4
2019-04-17 05:26,XIY,1481,737-800,20,5,25,5,5,22,,,,,5,2
2019-04-17 04:59,URC,1725,737-800,20,5,27,4,4,27,,,,,7,7
2019-04-17 04:44,CAN,5620,737-800,21,4,30,4,4,26,,,,,9,5
2019-04-17 04:42,CGO,7167,737-800,19,8,25,5,5,25,,,,,6,6
2019-04-17 04:33,CAN,5405,737-800,25,5,30,6,4,29,,,,,5,4
2019-04-17 04:33,URC,5636,737-800,20,5,27,7,7,26,,,,,7,6
2019-04-17 04:33,HAK,5479,737-800,25,6,22,8,4,26,,,,,-3,1
2019-04-17 04:32,URC,5636,737-800,20,5,27,7,7,26,,,,,7,6
2019-04-17 04:31,HAK,1799,737-800,26,3,32,5,5,32,,,,,6,6
2019-04-17 04:31,CAN,5337,737-800,21,4,29,5,4,30,,,,,8,9
2019-04-17 04:27,XIY,1162,737-800,20,4,22,3,2,20,,,,,2,0
2019-04-17 04:27,KMG,6015,737-800,15,3,25,4,4,21,,,,,10,6
2019-04-17 04:26,XIY,5430,737-800,15,6,24,6,5,26,,,,,9,11
2019-04-17 04:23,KMG ,7988,737-800,18,5,28,6,4,24,,,,,10,6
2019-04-17 04:12,KMG,1587,737-800,17,3,24,6,4,23,,,,,7,6
2019-04-17 04:11,HAK,1793,737-800,27,5,33,5,5,32,,,,,6,5
2019-04-17 04:10,CGO,5467,737-800,20,2,25,4,2,20,,,,,5,0
2019-04-17 04:09,XIY,5406,737-800,20,8,26,6,7,26,,,,,6,6
2019-04-17 04:08,XIY,1483,737-800,20,4,22,5,6,22,,,,,2,2
2019-04-17 04:04,PEK,7400,737-800,18,5,26,8,7,32,,,,,8,14
2019-04-17 04:03,URC,6268,737-800,20,6,26,6,6,26,,,,,6,6
2019-04-17 04:02,HHA,1346,737-800,15,6,27,5,5,24,,,,,12,9
2019-04-17 03:56,XIY,1997,737-800,20,5,24,8,7,20,,,,,4,0
2019-04-17 03:55,XIY,1997,737-800,30,5,24,8,7,20,,,,,-6,-10
2019-04-17 03:48,HHA,6060,737-800,17,5,25,5,5,25,,,,,8,8
2019-04-17 03:48,CAN,1538,737-800,22,3,28,3,2,27,,,,,6,5
2019-04-17 03:47,HHA,7377,737-800,16,6,25,6,5,27,,,,,9,11
2019-04-17 03:46,CAN,1538,737-800,22,3,28,3,2,27,,,,,6,5
2019-04-17 03:44,URC,2159,737-800,20,8,19,3,3,23,,,,,-1,3
2019-04-17 03:43,URC,2159,737-800,20,8,19,3,3,23,,,,,-1,3
2019-04-17 03:43,HGH,1501,737-800,20,4,26,2,2,24,,,,,6,4
2019-04-17 03:38,PEK,7400,737-800,18,5,26,8,7,32,,,,,8,14
2019-04-17 03:33,FOC ,7105,737-800,19,4,27,4,4,26,,,,,8,7
2019-04-17 03:29,HAK,206H,737-800,25,5,33,3,3,31,,,,,8,6
2019-04-17 03:16,SYX,7616,737-800,25,4,30,4,4,32,,,,,5,7
2019-04-17 03:15,SYX,1796,737-800,25,4,24,6,4,30,,,,,-1,5
2019-04-17 03:14,HHA,1503,737-800,18,5,26,4,3,24,,,,,8,6
2019-04-17 03:09,FOC,1905,737-800,16,4,26,4,4,24,,,,,10,8
2019-04-17 03:09,KMG,5407,737-800,15,0,25,5,4,22,,,,,10,7
2019-04-17 03:04,URC,1545,737-800,20,4,24,4,3,21,,,,,4,1
2019-04-17 03:03,URC,6995,737-800,15,4,24,3,3,20,,,,,9,5
2019-04-17 02:55,HAK,1783,737-800,25,2,10,7,6,30,,,,,-15,5
2019-04-17 02:54,URC,1547,737-800,20,5,20,3,3,18,,,,,0,-2
2019-04-17 02:52,CKG,7173,737-800,18,4,22,4,3,20,,,,,4,2
2019-04-17 02:52,KMG,7993,737-800,20,6,25,7,6,24,,,,,5,4
2019-04-17 02:52,YIH,1433,737-800,17,3,26,3,3,22,,,,,9,5
2019-04-17 02:52,URC,5637,737-800,20,2,24,3,2,20,,,,,4,0
2019-04-17 02:51,CKG,7618,737-800,19,4,20,4,5,20,,,,,1,1
2019-04-17 02:49,URC,1131,737-800,20,5,27,4,4,26,,,,,7,6
2019-04-17 02:48,HGH,1489,737-800,16,4,26,4,4,24,,,,,10,8
2019-04-17 02:47,FOC,1559,737-800,20,3,26,2,2,23,,,,,6,3
2019-04-17 02:39,KMG,6809,737-800,18,5,22,6,6,22,,,,,4,4
2019-04-17 02:38,HAK,2158,737-800,27,7,30,4,5,29,,,,,3,2
2019-04-17 02:37,HAK,1493,737-800,25,5,32,6,4,31,,,,,7,6
2019-04-17 02:36,HAK,5090,737-800,25,2,31,2,3,30,,,,,6,5
2019-04-17 02:35,PEK,5522,737-800,20,5,27,5,4,22,,,,,7,2
2019-04-17 02:35,XIY,1902,737-800,20,5,25,5,6,24,,,,,5,4
2019-04-17 02:34,XIY,7886,737-800,25,4,24,4,4,24,,,,,-1,-1
2019-04-17 02:34,URC,2157,737-800,19,4,19,8,2,16,,,,,0,-3
2019-04-17 02:32,SYX,206G,737-800,28,2,28,3,3,30,,,,,0,2
2019-04-17 02:26,URC,1929,737-800,20,4,24,4,4,24,,,,,4,4
2019-04-17 02:25,SZX,5623,737-800,25,5,32,5,5,28,,,,,7,3
2019-04-17 02:25,XIY,1797,737-800,18,4,22,4,4,18,,,,,4,0
2019-04-17 02:22,DLC,1927,737-800,16,2,22,4,6,24,,,,,6,8
2019-04-17 02:21,HGH,5521,737-800,25,1,20,1,1,20,,,,,-5,-5
2019-04-17 02:15,TYN,206F,737-800,16,3,22,3,3,20,,,,,6,4
2019-04-17 02:15,CGO,7379,737-800,21,4,29,3,3,30,,,,,8,9
2019-04-17 02:12,CGO,1209,737-800,20,3,26,4,4,24,,,,,6,4
2019-04-17 02:11,DLC,1495,737-800,15,4,24,4,4,22,,,,,9,7
2019-04-17 02:08,SYX,7619,737-800,28,6,28,6,6,28,,,,,0,0
2019-04-17 02:05,HAK,6061,737-800,25,3,31,2,2,30,,,,,6,5
2019-04-17 01:56,CAN,1502,737-800,21,3,25,4,4,26,,,,,4,5
2019-04-17 01:49,CGO,6800,737-800,21,4,26,4,4,24,,,,,5,3
2019-04-17 01:49,HAK,5358,737-800,25,8,33,8,7,32,,,,,8,7
2019-04-17 01:46,SYX,5418,737-800,28,6,28,4,4,30,,,,,0,2
2019-04-17 01:45,ÃàÑô,1798,737-800,23,6,27,5,5,24,,,,,4,1
2019-04-17 01:42, HHA,5138,737-800,20,4,28,4,4,26,,,,,8,6
2019-04-17 01:34,URC,205U,737-800,23,4,24,4,4,24,,,,,1,1
2019-04-17 01:33,HAK,5346,737-800,26,6,31,6,5,31,,,,,5,5
2019-04-17 01:29,CGO,1588,737-800,20,4,23,4,4,23,,,,,3,3
2019-04-17 01:29,CAN ,1728,737-800,22,4,29,5,5,22,,,,,7,0
2019-04-17 01:27,PEK,1141,737-800,20,5,26,5,5,27,,,,,6,7
2019-04-17 01:27,CAN ,1347,737-800,21,3,30,4,4,26,,,,,9,5
2019-04-17 01:27,PEK,1141,737-800,20,5,26,5,5,27,,,,,6,7
2019-04-17 01:26,KMG,7991,737-800,20,6,24,6,7,23,,,,,4,3
2019-04-17 01:26,URC,1372,737-800,20,6,24,5,4,20,,,,,4,0
2019-04-17 01:25,SZX,5712,737-800,25,2,26,4,2,19,,,,,1,-6
2019-04-17 01:24,URC,5580,737-800,19,5,23,5,6,28,,,,,4,9
2019-04-17 01:24,SZX ,1103,737-800,22,4,34,4,4,29,,,,,12,7
2019-04-17 01:24,HHA,1487,737-800,17,3,25,3,3,23,,,,,8,6
2019-04-17 01:23,PEK ,5482,737-800,20,2,20,6,6,22,,,,,0,2
2019-04-17 01:22,HGH,5463,737-800,17,5,22,5,5,20,,,,,5,3
2019-04-17 01:19,TYN,5371,737-800,13,5,18,5,5,18,,,,,5,5
2019-04-17 01:19,CAN,5638,737-800,22,4,31,4,4,29,,,,,9,7
2019-04-17 01:17,XIY,1163,737-800,20,2,24,2,2,24,,,,,4,4
2019-04-17 01:14,TYN,5359,737-800,15,4,16,4,4,18,,,,,1,3
2019-04-17 01:13,KMG,7992,737-800,20,4,26,8,7,23,,,,,6,3
2019-04-17 01:13,XIY,7113,737-800,15,3,23,2,2,27,,,,,8,12
2019-04-17 01:11,HHA,1928,737-800,18,4,22,4,4,22,,,,,4,4
2019-04-17 01:09,URC,5375,737-800,20,0,18,3,4,20,,,,,-2,0
2019-04-17 01:05,HAK,1373,737-800,26,4,32,4,5,30,,,,,6,4
2019-04-17 01:04,URC,5709,737-800,20,6,26,6,6,26,,,,,6,6
2019-04-17 01:02,HAK,5137,737-800,28,3,23,3,3,32,,,,,-5,4
2019-04-17 01:00,YIH,1351,737-800,18,4,26,4,4,24,,,,,8,6
2019-04-17 00:59,HRB,1562,737-800,15,4,25,4,4,23,,,,,10,8
2019-04-17 00:58,HAK,5662,737-800,25,2,28,4,6,30,,,,,3,5
2019-04-17 00:58,PEK,5522,737-800,20,5,27,5,4,22,,,,,7,2
2019-04-17 00:58,106,1727,737-800,17,8,27,4,4,20,,,,,10,3
2019-04-17 00:58,TYN,6065,737-800,18,4,26,6,5,24,,,,,8,6
2019-04-17 00:57,CGO,205T,737-800,21,2,26,4,2,26,,,,,5,5
2019-04-17 00:56,CAN,5540,737-800,25,5,34,5,5,30,,,,,9,5
2019-04-17 00:56,SYX,1735,737-800,29,4,33,6,4,27,,,,,4,-2
2019-04-17 00:50,HAL,7175,737-800,25,3,32,5,5,32,,,,,7,7
2019-04-17 00:50,FOC,1559,737-800,24,3,26,2,2,24,,,,,2,0
2019-04-17 00:46,SZX,1213,737-800,27,6,32,5,6,30,,,,,5,3
2019-04-17 00:44,HGH ,1785,737-800,20,5,23,5,6,22,,,,,3,2
2019-04-17 00:41,URC,1498,737-800,15,7,24,4,6,22,,,,,9,7
2019-04-17 00:38,KHG,1569,737-800,23,2,25,2,2,24,,,,,2,1
2019-04-17 00:34,XIY,5180,737-800,15,4,8,3,3,8,,,,,-7,-7
2019-04-17 00:33,XIY,1995,737-800,18,7,25,8,8,24,,,,,7,6
2019-04-17 00:31,CAN,5465,737-800,22,3,26,4,3,30,,,,,4,8
2019-04-17 00:27,HRB,1906,737-800,16,6,26,6,6,22,,,,,10,6
2019-04-17 00:22,ÃàÑô,5409,737-800,24,4,25,4,4,26,,,,,1,2
2019-04-17 00:20,DLC,5417,737-800,13,3,20,4,4,21,,,,,7,8
2019-04-17 00:19,PEK,1733,737-800,15,3,21,3,2,20,,,,,6,5
2019-04-17 00:09,FOC,5503,737-800,20,3,25,4,3,24,,,,,5,4
2019-04-17 00:09,FOC,5503,737-800,20,3,25,4,3,24,,,,,5,4
2019-04-17 00:05,HHA,1787,737-800,19,2,24,2,2,22,,,,,5,3
2019-04-17 00:04,URC,205V,737-800,20,5,29,5,5,26,,,,,9,6
2019-04-16 23:54,FOC,7395,737-800,17,6,24,6,6,24,,,,,7,7
2019-04-16 23:53,PEK,5428,737-800,15,4,24,4,4,31,,,,,9,16
2019-04-16 23:52,CAN,5153,737-800,23,3,30,3,3,30,,,,,7,7
2019-04-16 23:50,CAN,5408,737-800,23,6,30,5,6,28,,,,,7,5
2019-04-16 23:49,XIY,5439,737-800,20,4,20,4,4,22,,,,,0,2
2019-04-16 23:45,URC,1323,737-800,20,4,20,4,4,16,,,,,0,-4
2019-04-16 23:45,PEK,5735,737-800,18,0,16,0,0,14,,,,,-2,-4
2019-04-16 23:44,SZX,5733,737-800,23,6,32,6,6,31,,,,,9,8
2019-04-16 23:39,HAK,5089,737-800,27,1,28,1,1,32,,,,,1,5
2019-04-16 23:30,HGH ,1101,737-800,23,2,30,3,3,28,,,,,7,5
2019-04-16 23:30,HRB,1480,737-800,18,4,20,4,5,20,,,,,2,2
2019-04-16 23:30,HRB,1348,737-800,17,6,16,6,6,22,,,,,-1,5
2019-04-16 23:26,URC,1568,737-800,23,6,26,6,6,22,,,,,3,-1
2019-04-16 23:26,HGH ,1101,737-800,23,2,30,3,3,28,,,,,7,5
2019-04-16 23:24,SYX,5520,737-800,25,6,36,5,4,32,,,,,11,7
2019-04-16 23:22,SYX,1130,737-800,29,1,34,3,2,32,,,,,5,3
2019-04-16 23:22,SYX,1729,737-800,25,6,29,6,7,26,,,,,4,1
2019-04-16 23:13,URC,5135,737-800,20,3,26,4,4,24,,,,,6,4
2019-04-16 23:10,SYX,1729,737-800,25,6,29,6,7,26,,,,,4,1
2019-04-16 23:09,DLC,5687,737-800,12,5,15,4,4,22,,,,,3,10
2019-04-16 23:09,ÃàÑô,6016,737-800,20,5,29,4,4,26,,,,,9,6
2019-04-16 22:56,TYN,5371,737-800,15,4,18,6,6,20,,,,,3,5
2019-04-16 22:52,DLC,7172,737-800,20,4,22,4,4,22,,,,,2,2
2019-04-16 22:52,´óÁ¬,1786,737-800,12,4,20,4,4,20,,,,,8,8
2019-04-16 22:50,DLC,1102,737-800,15,4,25,4,3,22,,,,,10,7
2019-04-16 22:50,´óÁ¬,1786,737-800,12,4,20,4,4,20,,,,,8,8
2019-04-16 22:50,´óÁ¬,1786,737-800,12,4,20,4,4,20,,,,,8,8
2019-04-16 22:49,DLC,1102,737-800,15,4,25,4,3,22,,,,,10,7
2019-04-16 22:48,DLC,1102,737-800,15,4,25,4,3,22,,,,,10,7
2019-04-16 22:47,DLC,1102,737-800,15,4,25,4,3,22,,,,,10,7
2019-04-16 22:47,DLC,1102,737-800,15,4,25,4,3,22,,,,,10,7
2019-04-16 22:45,PEK,5481,737-800,20,5,26,6,5,30,,,,,6,10
2019-04-16 22:44,KMG,7990,737-800,20,4,24,4,4,23,,,,,4,3
2019-04-16 22:38,HAK,6063,737-800,26,6,31,7,8,30,,,,,5,4
2019-04-16 22:38,HAK,6063,737-800,26,6,31,7,8,30,,,,,5,4
2019-04-16 22:34,XNN,1491,737-800,12,6,26,6,6,23,,,,,14,11
2019-04-16 22:34,XNN,1491,737-800,12,6,26,6,6,23,,,,,14,11
2019-04-16 22:22,URC,1325,737-800,20,4,21,4,5,22,,,,,1,2
2019-04-16 22:21,HAK,5338,737-800,26,3,30,5,6,30,,,,,4,4
2019-04-16 22:20,HAK,5338,737-800,26,3,30,5,6,30,,,,,4,4
2019-04-16 22:20,HAK,5338,737-800,26,3,30,5,6,30,,,,,4,4
2019-04-16 22:18,HAK,5798,737-800,28,5,32,4,5,32,,,,,4,4
2019-04-16 22:17,DLC,6062,737-800,13,3,23,4,4,24,,,,,10,11
2019-04-16 22:03,HAK,1799,737-800,26,4,35,6,5,32,,,,,9,6
2019-04-16 22:01,HAK,1799,737-800,26,4,35,6,5,32,,,,,9,6
2019-04-16 21:54,MIG,5732,737-800,19,3,26,3,2,23,,,,,7,4
2019-04-16 21:32,XUZ,7989,737-800,20,6,26,6,6,25,,,,,6,5
2019-04-16 21:25,XNN,7171,737-800,12,4,19,5,4,21,,,,,7,9
2019-04-16 21:08,´óÁ¬,5581,737-800,13,4,16,4,4,22,,,,,3,9
2019-04-16 20:38,DLC,7172,737-800,20,5,26,6,5,24,,,,,6,4
2019-04-16 20:38,DLC,7172,737-800,20,5,26,6,5,24,,,,,6,4
2019-04-16 20:00,FOC,7395,737-800,19,7,30,7,7,28,,,,,11,9
2019-04-16 19:53,HAK,5713,737-800,29,4,34,5,6,32,,,,,5,3
2019-04-16 19:16,HAK,5082,737-800,26,6,32,3,3,30,,,,,6,4
2019-04-16 18:59,URC,206P,737-800,23,2,23,2,2,22,,,,,0,-1
2019-04-16 18:55,HGH,1215,737-800,20,3,25,3,3,25,,,,,5,5
2019-04-16 18:28,URC,7198,737-800,20,4,28,8,8,22,,,,,8,2
2019-04-16 18:18,PEK,5502,737-800,25,5,24,6,5,25,,,,,-1,0
2019-04-16 18:15,HRB,1350,737-800,23,4,24,5,5,24,,,,,1,1
2019-04-16 17:52,SYX,1386,737-800,35,3,36,4,3,32,,,,,1,-3
2019-04-16 17:03,SZX,1783,737-800,23,4,22,5,5,30,,,,,-1,7
2019-04-16 17:02,SZX,1492,737-800,20,3,28,2,2,28,,,,,8,8
2019-04-16 16:02,CTU,7990,737-800,18,3,28,3,4,26,,,,,10,8
2019-04-16 09:08,CKG,5661,737-800,16,3,20,10,8,18,,1,,1,4,2
2019-04-16 08:50,CAN,1373,737-800,22,4,27,3,3,22,,,,,5,0
2019-04-16 08:49,CAN,5638,737-800,22,4,28,4,4,26,,,,,6,4
2019-04-16 08:46,HAK,206H,737-800,27,4,34,6,5,35,,,,,7,8
2019-04-16 08:14,PEK,7398,737-800,18,3,24,3,3,20,,,,,6,2
2019-04-16 07:54,ZGC,1735,737-800,5,4,25,3,4,24,,,,,20,19
2019-04-16 07:53,ZGC,5625,737-800,5,4,24,3,4,25,,,,,19,20
2019-04-16 07:52,ZGC,7378,737-800,5,2,23,3,2,24,,,,,18,19
2019-04-16 07:26,HAK,7616,737-800,25,5,33,4,4,34,,,,,8,9
2019-04-16 07:09,SYX,206G,737-800,27,4,34,4,4,32,,,,,7,5
2019-04-16 07:05,CGO,206P,737-800,17,4,26,4,4,24,,,,,9,7
2019-04-16 07:03,SHA,1785,737-800,15,1,27,8,8,25,,,,,12,10
2019-04-16 07:02,SHA,1493,737-800,15,6,24,5,5,22,,,,,9,7
2019-04-16 06:53,XMN,1549,737-800,20,6,25,5,7,26,,,,,5,6
2019-04-16 06:52,XMN,6103,737-800,20,5,25,4,6,27,,,,,5,7
2019-04-16 06:51,XMN,5462,737-800,20,5,20,5,6,24,,,,,0,4
2019-04-16 06:50,XMN,1733,737-800,18,3,23,3,3,20,,,,,5,2
2019-04-16 06:08,PEK,5538,737-800,15,3,27,3,3,27,,,,,12,12
2019-04-16 06:02,XIY,5430,737-800,13,5,24,4,5,28,,,,,11,15
2019-04-16 05:53,KMG,5407,737-800,14,5,22,8,6,22,,,,,8,8
2019-04-16 05:44,PEK,1786,737-800,20,1,15,2,2,16,,,,,-5,-4
2019-04-16 05:43,CAN,5620,737-800,22,5,29,4,4,28,,,,,7,6
2019-04-16 05:42,HAK,7173,737-800,26,6,32,6,6,33,,,,,6,7
2019-04-16 05:41,URC ,7198,737-800,27,4,22,7,5,24,,,,,-5,-3
2019-04-16 05:28,HGH,5797,737-800,20,4,20,4,4,22,,,,,0,2
2019-04-16 05:23,CAN,1726,737-800,21,6,24,6,6,25,,,,,3,4
2019-04-16 05:19,URC,1131,737-800,22,4,22,3,3,20,,,,,0,-2
2019-04-16 05:08,URC ,1570,737-800,20,6,22,6,6,20,,,,,2,0
2019-04-16 04:54,URC ,5373,737-800,24,6,20,6,6,24,,,,,-4,0
2019-04-16 04:53,CAN,1502,737-800,20,4,28,4,4,28,,,,,8,8
2019-04-16 04:47,CAN,5153,737-800,20,3,28,4,3,26,,,,,8,6
2019-04-16 04:47,SYX,5540,737-800,28,5,35,4,4,32,,,,,7,4
2019-04-16 04:44,KMG,1798,737-800,18,6,26,7,7,23,,,,,8,5
2019-04-16 04:40,SZX,1505,737-800,21,4,30,3,3,24,,,,,9,3
2019-04-16 04:31,KMG,6800,737-800,17,4,24,5,4,23,,,,,7,6
2019-04-16 04:28,HAK,5623,737-800,25,6,36,6,6,31,1,,,1,11,6
2019-04-16 04:26,HGH,5463,737-800,17,4,26,3,3,24,,,,,9,7
2019-04-16 04:23,XIY,1482,737-800,11,8,30,8,8,26,,,,,19,15
2019-04-16 04:23,XIY,5115,737-800,11,4,14,5,5,26,,,,,3,15
2019-04-16 04:12,FOC,5136,737-800,16,1,20,4,5,22,,,,,4,6
2019-04-16 04:12,PEK,1375,737-800,19,5,24,4,4,23,,,,,5,4
2019-04-16 04:07,CAN,1347,737-800,20,4,28,3,4,30,,,,,8,10
2019-04-16 04:06,FOC,5503,737-800,13,4,24,4,4,24,,,,,11,11
2019-04-16 03:55,URC,2159,737-800,25,9,18,2,4,22,,,,,-7,-3
2019-04-16 03:47,HHA,1101,737-800,15,4,31,2,2,24,,,,,16,9
2019-04-16 03:46,HAK,1727,737-800,28,6,31,6,5,30,,,,,3,2
2019-04-16 03:46,HAK,7171,737-800,28,6,32,4,3,31,,,,,4,3
2019-04-16 03:45,PEK,5408,737-800,20,4,24,3,2,21,,,,,4,1
2019-04-16 03:42,XIY,5180,737-800,15,6,24,7,6,24,,,,,9,9
2019-04-16 03:42,CAN,1538,737-800,20,4,28,4,4,26,,,,,8,6
2019-04-16 03:39,CKG,7619,737-800,16,2,22,2,2,24,,,,,6,8
2019-04-16 03:39,HHA,1497,737-800,17,4,26,4,3,24,,,,,9,7
2019-04-16 03:37,SYX,1796,737-800,27,5,34,5,5,30,,,,,7,3
2019-04-16 03:35,HHA,6060,737-800,20,5,26,4,3,22,,,,,6,2
2019-04-16 03:27,SZX,5135,737-800,22,3,28,2,2,26,,,,,6,4
2019-04-16 03:27,SZX,5733,737-800,23,6,26,6,6,28,,,,,3,5
2019-04-16 03:26,HGH,5141,737-800,16,4,20,5,5,26,,,,,4,10
2019-04-16 03:23,XIY,5430,737-800,13,5,24,4,5,28,,,,,11,15
2019-04-16 03:16,PEK,5539,737-800,21,5,20,6,5,23,,,,,-1,2
2019-04-16 03:13,PEK,7400,737-800,15,7,24,4,4,20,,,,,9,5
2019-04-16 03:12,5713,HAK,737-800,26,6,29,6,6,0,,,,,3,-26
2019-04-16 03:11,TYN,5359,737-800,14,4,24,5,5,24,,,,,10,10
2019-04-16 03:09,HAK,1997,737-800,25,5,34,6,5,34,,,,,9,9
2019-04-16 03:09,KMG,7993,737-800,18,6,24,7,6,22,,,,,6,4
2019-04-16 03:04,HGH,5429,737-800,17,3,20,3,3,22,,,,,3,5
2019-04-16 03:03,PEK,5502,737-800,15,4,22,4,4,22,,,,,7,7
2019-04-16 02:58,FOC,1350,737-800,18,4,24,4,4,20,,,,,6,2
2019-04-16 02:58,KMG,7167,737-800,18,5,26,5,5,24,,,,,8,6
2019-04-16 02:57,URC,1545,737-800,21,5,24,6,6,23,,,,,3,2
2019-04-16 02:57,URC,205V,737-800,24,4,28,4,4,26,,,,,4,2
2019-04-16 02:56,SZX,1103,737-800,23,4,32,4,4,28,,,,,9,5
2019-04-16 02:55,ÃàÑô,6809,737-800,16,5,24,5,5,24,,,,,8,8
2019-04-16 02:55,URC ,5580 ,737-800,24,6,22,6,6,25,,,,,-2,1
2019-04-16 02:54,URC ,5637 ,737-800,24,2,24,2,2,20,,,,,0,-4
2019-04-16 02:53,URC ,5636 ,737-800,22,4,24,3,4,23,,,,,2,1
2019-04-16 02:53,MIG,5732,737-800,15,4,25,3,4,24,,,,,10,9
2019-04-16 02:52,URC ,1929,737-800,22,4,20,4,4,20,,,,,-2,-2
2019-04-16 02:51,URC ,205T,737-800,22,3,24,3,2,24,,,,,2,2
2019-04-16 02:46,HAK,6063,737-800,25,6,34,6,6,31,,,,,9,6
2019-04-16 02:45,PEK ,5482,737-800,15,0,18,5,4,20,,,,,3,5
2019-04-16 02:45,URC,1323,737-800,22,6,26,6,6,26,,,,,4,4
2019-04-16 02:37,XIY,5428,737-800,20,4,19,4,4,25,,,,,-1,5
2019-04-16 02:32,HHA,1503,737-800,17,3,23,3,3,21,,,,,6,4
2019-04-16 02:30,XIY,1162,737-800,12,5,22,6,8,18,,,,,10,6
2019-04-16 02:29,HHA,7377,737-800,16,6,24,6,6,26,,,,,8,10
2019-04-16 02:29,XIY,1902,737-800,12,7,19,5,6,22,,,,,7,10
2019-04-16 02:28,HAK,1501,737-800,26,4,34,5,4,32,,,,,8,6
2019-04-16 02:27,TYN,5358,737-800,10,5,28,4,4,26,,,,,18,16
2019-04-16 02:25,PEK,7639,737-800,21,6,30,7,6,28,,,,,9,7
2019-04-16 02:19,SZX,1795,737-800,22,4,28,4,4,27,,,,,6,5
2019-04-16 02:16,HRB,1562,737-800,10,2,24,4,4,20,,,,,14,10
2019-04-16 02:14,URC,5579,737-800,20,4,26,2,4,24,,,,,6,4
2019-04-16 02:11,SYX,2158,737-800,28,8,30,4,4,26,,,,,2,-2
2019-04-16 02:09,XIY,5439,737-800,15,4,20,8,8,30,,,,,5,15
2019-04-16 02:03,FOC,5182,737-800,20,2,24,3,3,22,,,,,4,2
2019-04-16 01:59,XIY,7113,737-800,15,5,24,5,4,21,,,,,9,6
2019-04-16 01:56,XIY,1488,737-800,12,6,28,5,5,22,,,,,16,10
2019-04-16 01:55,HAK,5712,737-800,26,3,28,6,3,29,,,,,2,3
2019-04-16 01:53,SYX,5418,737-800,28,4,31,4,4,31,,,,,3,3
2019-04-16 01:53,XIY,5853,737-800,15,7,26,8,8,28,,,,,11,13
2019-04-16 01:49,URC,1498,737-800,25,6,18,6,6,22,,,,,-7,-3
2019-04-16 01:46,XIY,5116,737-800,13,3,21,4,4,20,,,,,8,7
2019-04-16 01:43,SYX,5417,737-800,30,5,30,4,4,32,,,,,0,2
2019-04-16 01:41,TYN,6065,737-800,14,4,25,4,4,24,,,,,11,10
2019-04-16 01:40,URC,1570,737-800,20,6,22,6,6,20,,,,,2,0
2019-04-16 01:40,XIY,1483,737-800,13,9,25,8,7,22,,,,,12,9
2019-04-16 01:38,KMG,1208,737-800,19,3,24,4,4,22,,,,,5,3
2019-04-16 01:33,XIY,5686,737-800,15,4,22,4,4,20,,,,,7,5
2019-04-16 01:30,YIH,1433,737-800,15,3,25,3,3,21,,,,,10,6
2019-04-16 01:25,CGO,1587,737-800,15,3,22,4,3,20,,,,,7,5
2019-04-16 01:23,TYN,206F,737-800,18,4,26,2,2,22,,,,,8,4
2019-04-16 01:23,XIY,5478,737-800,13,4,26,5,4,22,,,,,13,9
2019-04-16 01:16,XIY,1163,737-800,24,2,24,8,8,28,,,,,0,4
2019-04-16 01:16,HAK,5611,737-800,26,5,34,5,5,34,,,,,8,8
2019-04-16 01:12,HAK,5581,737-800,26,8,28,6,4,34,,,,,2,8
2019-04-16 01:10,º£¿Ú,5371,737-800,26,6,31,6,6,32,,,,,5,6
2019-04-16 01:10,HAK,5082,737-800,26,6,36,4,4,30,,,,,10,4
2019-04-16 01:10,HAK,5090,737-800,26,2,30,2,4,30,,,,,4,4
2019-04-16 01:09,DLC,5687,737-800,17,4,18,4,4,22,,,,,1,5
2019-04-16 01:07,HAK,1542,737-800,27,4,32,4,4,33,,,,,5,6
2019-04-16 01:07,DLC,1346,737-800,17,4,25,4,4,20,,,,,8,3
2019-04-16 01:06,DLC,1927,737-800,20,4,12,6,4,23,,,,,-8,3
2019-04-16 01:04,DLC,1386,737-800,16,4,22,4,4,24,,,,,6,8
2019-04-16 01:02,HAK,5416,737-800,25,8,34,8,7,34,,,,,9,9
2019-04-16 01:00,HHA,1787,737-800,22,1,24,0,0,20,,,,,2,-2
2019-04-16 00:59,URC,2157,737-800,24,2,22,9,9,28,,,,,-2,4
2019-04-16 00:58,KMG,7993,737-800,15,5,25,6,5,22,,,,,10,7
2019-04-16 00:55,TYN,5480,737-800,15,4,24,4,4,24,,,,,9,9
2019-04-16 00:54,URC,69965,737-800,20,4,24,6,5,22,,,,,4,2
2019-04-16 00:52,FOC,1906,737-800,18,6,28,8,8,28,,,,,10,10
2019-04-16 00:50,FOC,7395,737-800,19,3,22,3,3,22,,,,,3,3
2019-04-16 00:47,HRB,7105,737-800,15,4,22,5,4,22,,,,,7,7
2019-04-16 00:41,SYX,5855,737-800,28,3,31,3,3,29,,,,,3,1
2019-04-16 00:39,XIY,5089,737-800,15,2,12,2,2,24,,,,,-3,9
2019-04-16 00:38,HAK,1728,737-800,28,4,32,4,4,32,,,,,4,4
2019-04-16 00:36,FOC,1435,737-800,20,8,24,5,6,24,,,,,4,4
2019-04-16 00:30,XIY,5406,737-800,14,4,23,7,4,22,,,,,9,8
2019-04-16 00:27,HGH,1490,737-800,19,5,24,5,5,22,,,,,5,3
2019-04-16 00:26,DLC,6062,737-800,10,2,18,4,4,20,,,,,8,10
2019-04-16 00:24,DLC,1102,737-800,15,4,23,4,4,23,,,,,8,8
2019-04-16 00:24,HGH,5521,737-800,17,4,21,2,2,18,,,,,4,1
2019-04-16 00:24,DLC,5346,737-800,19,4,20,4,4,24,,,,,1,5
2019-04-16 00:24,KHG,1569,737-800,22,3,26,3,3,25,,,,,4,3
2019-04-16 00:23,DLC,1495,737-800,15,4,22,4,4,22,,,,,7,7
2019-04-16 00:23,KMG,7991,737-800,20,6,26,7,6,24,,,,,6,4
2019-04-16 00:19,CGO,1588,737-800,17,4,25,4,6,20,,,,,8,3
2019-04-16 00:19,XIY,1481,737-800,12,5,19,3,2,22,,,,,7,10
2019-04-16 00:17,CGO,1588,737-800,18,6,28,4,4,26,,,,,10,8
2019-04-16 00:17,SYX,1729,737-800,28,4,28,6,6,30,,,,,0,2
2019-04-16 00:17,CGO,5465,737-800,18,6,28,4,4,26,,,,,10,8
2019-04-16 00:14,CGO,1588,737-800,17,4,25,4,6,20,,,,,8,3
2019-04-16 00:12,SYX,5520,737-800,30,6,36,5,5,33,,,,,6,3
2019-04-16 00:10,CAN,5798,737-800,20,2,24,2,2,24,,,,,4,4
2019-04-16 00:10,SZX,5372,737-800,23,6,30,6,5,30,,,,,7,7
2019-04-16 00:04,PEK ,1141,737-800,20,4,27,3,5,26,,,,,7,6
2019-04-16 00:02,HAK,1793,737-800,26,6,32,5,5,30,,,,,6,4
2019-04-16 00:00,URC,5375,737-800,24,2,18,4,4,20,,,,,-6,-4
2019-04-15 23:48,CGO,7618,737-800,18,4,24,6,4,22,,,,,6,4
2019-04-15 23:46,CAN,1130,737-800,21,2,33,2,2,28,1,,,1,12,7
2019-04-15 23:44,HAK,5662,737-800,26,3,30,3,8,31,,,,,4,5
2019-04-15 23:41,º£¿Ú,5735,737-800,26,2,22,3,2,24,,,,,-4,-2
2019-04-15 23:37,ÃàÑô,5409,737-800,20,4,25,4,4,26,,,,,5,6
2019-04-15 23:33,URC,1325,737-800,22,6,22,4,4,20,,,,,0,-2
2019-04-15 23:32,URC,1725,737-800,22,4,26,2,2,20,,,,,4,-2
2019-04-15 23:31,URC,1725,737-800,22,4,26,2,2,20,,,,,4,-2
2019-04-15 23:31,XIY,1797,737-800,13,3,24,3,3,20,,,,,11,7
2019-04-15 23:31,HGH,1489,737-800,20,4,25,4,3,22,,,,,5,2
2019-04-15 23:29,CAN,5337,737-800,21,5,29,4,5,29,,,,,8,8
2019-04-15 23:25,URC,1568,737-800,20,6,22,4,6,20,,,,,2,0
2019-04-15 23:15,CAN,1496,737-800,22,6,31,6,5,32,,,,,9,10
2019-04-15 23:15,CAN,5405,737-800,22,4,32,5,4,29,1,,,1,10,7
2019-04-15 23:14,XIY,1548,737-800,14,3,23,4,3,22,,,,,9,8
2019-04-15 23:09,HAK,7175,737-800,27,5,34,5,5,32,,,,,7,5
2019-04-15 23:09,HHA,1928,737-800,23,6,20,5,5,22,,,,,-3,-1
2019-04-15 23:07,HHA,1487,737-800,18,2,23,3,3,22,,,,,5,4
2019-04-15 23:05,CGO,1372,737-800,17,3,23,4,4,24,,,,,6,7
2019-04-15 23:02,CGO,6015,737-800,20,4,22,4,4,22,,,,,2,2
2019-04-15 22:58,HAK,7988,737-800,27,4,34,5,4,32,,,,,7,5
2019-04-15 22:58,HRB,1348,737-800,10,3,18,4,4,17,,,,,8,7
2019-04-15 22:48,CKG,6061,737-800,17,2,24,2,2,24,,,,,7,7
2019-04-15 22:22,HGH,1215,737-800,17,3,27,4,4,24,,,,,10,7
2019-04-15 22:14,XNN,5479,737-800,12,6,20,6,6,20,,,,,8,8
2019-04-15 22:01,HAK,1213,737-800,29,6,30,4,6,32,,,,,1,3
2019-04-15 21:54,XIY,1903,737-800,15,4,28,6,7,30,,,,,13,15
2019-04-15 21:51,SYX,5467,737-800,28,7,30,4,0,28,,,,,2,0
2019-04-15 21:48,URC,205U,737-800,25,6,26,6,6,26,,,,,1,1
2019-04-15 21:43,PEK,5139,737-800,22,4,26,6,2,28,,,,,4,6
2019-04-15 21:36,XNN,1491,737-800,12,5,26,6,5,22,,,,,14,10
2019-04-15 21:26,FOC,1559,737-800,20,3,27,3,2,23,,,,,7,3
2019-04-15 20:32,HAK,5338,737-800,27,4,28,5,4,32,,,,,1,5
2019-04-15 19:41,HAK,5481,737-800,27,5,30,6,6,30,,,,,3,3
2019-04-15 19:08,DLC,5346,737-800,19,4,20,4,4,24,,,,,1,5
2019-04-15 19:05,MIG,6016,737-800,18,3,25,3,3,25,,,,,7,7
2019-04-15 19:01,´óÁ¬,7172,737-800,19,4,26,4,4,24,,,,,7,5
2019-04-15 18:52,HRB,1905,737-800,20,3,20,4,4,18,,,,,0,-2
2019-04-15 18:24,HGH,1547,737-800,17,5,24,5,5,24,,,,,7,7
2019-04-15 16:58,ÐìÖÝ,7989,737-800,20,4,27,6,5,24,,,,,7,4
2019-04-15 16:25,YIH,1351,737-800,21,3,26,4,4,22,,,,,5,1
2019-04-15 14:05,XIY,7886,737-800,25,2,28,4,2,30,,,,,3,5
2019-04-15 13:33,PEK,1785,737-800,26,0,26,6,6,25,,,,,0,-1
2019-04-15 11:51,PEK,6066,737-800,28,4,21,3,4,22,,,,,-7,-6
2019-04-15 11:20,CTU,7990,737-800,18,2,24,2,1,22,,,,,6,4
2019-04-15 09:24,FOC,1350,737-800,19,3,26,2,2,22,,,,,7,3
2019-04-15 08:57,PEK,1501,737-800,20,4,24,3,3,22,,,,,4,2
2019-04-15 08:25,CKG,7619,737-800,18,6,26,4,6,22,,,,,8,4
2019-04-15 08:23,FOC,1435,737-800,18,5,26,5,5,24,,,,,8,6
2019-04-15 08:21,FOC,1906,737-800,19,7,28,6,6,26,,,,,9,7
2019-04-15 08:15,KMG,1587,737-800,18,3,23,5,3,21,,,,,5,3
2019-04-15 07:43,HRB,1480,737-800,7,6,20,6,5,19,,,,,13,12
2019-04-15 07:41,HRB,7395,737-800,6,5,30,4,5,20,,,,,24,14
2019-04-15 07:26,SZX,1783,737-800,24,4,32,4,4,32,,,,,8,8
2019-04-15 07:25,HAK,1101,737-800,26,3,37,2,2,33,,,,,11,7
2019-04-15 07:20,KMG,5732,737-800,20,2,23,2,3,23,,,,,3,3
2019-04-15 07:06,KMG,7989,737-800,18,5,26,6,5,24,,,,,8,6
2019-04-15 06:33,HAK,5662,737-800,28,4,35,4,6,32,,,,,7,4
2019-04-15 06:20,XMN,1735,737-800,21,6,28,6,5,23,,,,,7,2
2019-04-15 06:19,XMN,5408,737-800,22,3,25,4,3,24,,,,,3,2
2019-04-15 06:18,XMN,1928,737-800,20,5,20,2,3,18,,,,,0,-2
2019-04-15 06:18,XMN,1493,737-800,18,6,24,4,4,19,,,,,6,1
2019-04-15 06:09,PEK,1347,737-800,12,4,22,4,3,20,,,,,10,8
2019-04-15 05:30,FOC,5503,737-800,20,4,25,4,3,24,,,,,5,4
2019-04-15 05:06,PEK,7400,737-800,15,6,23,5,4,20,,,,,8,5
2019-04-15 04:45,SZX,5712,737-800,23,2,34,4,4,36,,,,,11,13
2019-04-15 04:32,HGH,6103,737-800,17,5,23,6,6,24,,,,,6,7
2019-04-15 04:31,TYN,5359,737-800,9,4,18,4,4,20,,,,,9,11
2019-04-15 04:29,KMG,6800,737-800,16,4,24,5,3,22,,,,,8,6
2019-04-15 04:22,XIY,1903,737-800,16,2,24,2,2,23,,,,,8,7
2019-04-15 04:19,KMG,7991,737-800,16,3,25,6,6,22,,,,,9,6
2019-04-15 04:14,URC,5625,737-800,15,4,24,4,4,20,,,,,9,5
2019-04-15 04:10,PEK,1799,737-800,11,8,25,5,5,26,,,,,14,15
2019-04-15 04:10,XIY,7172,737-800,15,4,24,4,4,22,,,,,9,7
2019-04-15 04:01,URC,1568,737-800,12,4,20,4,5,26,,,,,8,14
2019-04-15 04:01,URC,1131,737-800,12,4,26,4,5,14,,,,,14,2
2019-04-15 03:57,HAK,5337,737-800,25,4,30,4,4,30,,,,,5,5
2019-04-15 03:48,XIY,1548,737-800,15,2,22,2,3,24,,,,,7,9
2019-04-15 03:45,SZX,5372,737-800,24,7,30,7,6,30,,,,,6,6
2019-04-15 03:35,HGH,7171,737-800,15,4,22,4,4,24,,,,,7,9
2019-04-15 03:35,HAK,5463,737-800,26,6,32,6,6,33,,,,,6,7
2019-04-15 03:31,SZX,1492,737-800,25,9,25,4,5,25,,,,,0,0
2019-04-15 03:27,HAK,1491,737-800,25,5,33,5,5,33,,,,,8,8
2019-04-15 03:23,HGH ,1547,737-800,15,5,23,5,6,22,,,,,8,7
2019-04-15 03:21,PEK,5482,737-800,19,2,20,4,5,22,,,,,1,3
2019-04-15 03:16,HAK,5661,737-800,25,4,36,4,4,34,,,,,11,9
2019-04-15 03:13,HAK,7616,737-800,25,3,30,4,4,31,,,,,5,6
2019-04-15 03:13,TYN,206F,737-800,11,4,20,2,2,18,,,,,9,7
2019-04-15 03:11,SYX,1489,737-800,29,5,32,5,4,31,,,,,3,2
2019-04-15 03:10,CAN,5623,737-800,22,6,32,5,5,27,,,,,10,5
2019-04-15 03:08,KMG,7988,737-800,16,4,26,4,4,24,,,,,10,8
2019-04-15 03:06,SYX,5540,737-800,29,4,36,6,6,33,,,,,7,4
2019-04-15 03:05,SYX,7618,737-800,28,6,34,6,5,30,,,,,6,2
2019-04-15 03:03,URC,205U,737-800,15,4,24,4,4,22,,,,,9,7
2019-04-15 03:01,HAK,1786,737-800,25,2,32,4,2,30,,,,,7,5
2019-04-15 02:58,XIY,1482,737-800,15,5,28,5,5,22,,,,,13,7
2019-04-15 02:56,HAK,5138,737-800,26,4,32,4,4,32,,,,,6,6
2019-04-15 02:51,XIY,5116,737-800,16,4,20,4,4,20,,,,,4,4
2019-04-15 02:49,PEK,5538,737-800,16,2,26,2,2,26,,,,,10,10
2019-04-15 02:48,XIY,1162,737-800,16,2,24,3,2,22,,,,,8,6
2019-04-15 02:43,URC,1570,737-800,15,5,18,5,5,19,,,,,3,4
2019-04-15 02:40,URC,1725,737-800,15,4,25,4,4,26,,,,,10,11
2019-04-15 02:36,HHA,1727,737-800,16,5,26,5,5,24,,,,,10,8
2019-04-15 02:35,URC,5136,737-800,16,4,22,4,4,28,,,,,6,12
2019-04-15 02:34,HAK,5798,737-800,24,2,26,3,2,26,,,,,2,2
2019-04-15 02:32,CAN,5153,737-800,22,3,30,4,3,30,,,,,8,8
2019-04-15 02:27,XIY,7113,737-800,13,4,24,4,5,23,,,,,11,10
2019-04-15 02:26,URC,6268,737-800,15,4,26,5,5,25,,,,,11,10
2019-04-15 02:25,URC,6268,737-800,15,4,26,5,5,25,,,,,11,10
2019-04-15 02:16,XIY,5430,737-800,18,6,24,6,5,25,,,,,6,7
2019-04-15 02:14,KMG,7167,737-800,16,5,26,6,6,24,,,,,10,8
2019-04-15 02:14,HAK,1795,737-800,27,4,30,3,4,32,,,,,3,5
2019-04-15 02:13,URC,2159,737-800,15,4,20,4,4,22,,,,,5,7
2019-04-15 02:10,MIG,6016,737-800,16,6,30,4,4,26,,,,,14,10
2019-04-15 02:10,SYX,5855,737-800,28,7,34,8,6,28,,,,,6,0
2019-04-15 02:10,HHA,1549,737-800,20,4,26,4,4,24,,,,,6,4
2019-04-15 02:09,XIY,5439,737-800,16,4,18,4,4,20,,,,,2,4
2019-04-15 02:09,MIG,6016,737-800,16,6,30,4,4,26,,,,,14,10
2019-04-15 02:04,HGH,5141,737-800,20,4,22,4,5,26,,,,,2,6
2019-04-15 02:01,URC,1372,737-800,15,5,22,4,4,20,,,,,7,5
2019-04-15 02:00,CAN,5620,737-800,22,4,32,3,5,27,,,,,10,5
2019-04-15 01:56,URC,2157,737-800,16,4,24,4,6,26,,,,,8,10
2019-04-15 01:55,PEK,5139,737-800,20,4,24,8,4,28,,,,,4,8
2019-04-15 01:55,HAK,1101,737-800,25,3,36,3,3,33,,,,,11,8
2019-04-15 01:54,PEK,6062,737-800,17,4,20,4,5,24,,,,,3,7
2019-04-15 01:54,FOC,1559,737-800,19,4,26,3,3,24,,,,,7,5
2019-04-15 01:51,SYX,2158,737-800,28,8,30,4,4,28,,,,,2,0
2019-04-15 01:51,HAK,6060,737-800,28,6,32,6,6,30,,,,,4,2
2019-04-15 01:49,URC,7198,737-800,17,2,21,2,2,20,,,,,4,3
2019-04-15 01:47,CAN,7173,737-800,24,4,30,6,5,28,,,,,6,4
2019-04-15 01:47,PEK,5539,737-800,17,5,21,5,5,21,,,,,4,4
2019-04-15 01:42,XIY,5371,737-800,15,4,18,5,5,22,,,,,3,7
2019-04-15 01:41,PEK,1733,737-800,19,8,30,6,7,28,,,,,11,9
2019-04-15 01:41,CAN,5735,737-800,22,1,24,1,1,19,,,,,2,-3
2019-04-15 01:40,URC,1322,737-800,16,4,24,5,5,23,,,,,8,7
2019-04-15 01:39,FOC,5182,737-800,18,4,24,2,3,23,,,,,6,5
2019-04-15 01:39,HAK,1130,737-800,24,3,30,2,2,30,,,,,6,6
2019-04-15 01:36,YIH,1351,737-800,14,3,26,4,4,22,,,,,12,8
2019-04-15 01:35,HGH ,1215,737-800,18,4,22,5,4,21,,,,,4,3
2019-04-15 01:35,HHA,1487,737-800,20,2,25,3,3,22,,,,,5,2
2019-04-15 01:33,SYX,5467,737-800,28,0,28,0,0,22,,,,,0,-6
2019-04-15 01:28,URC,5611,737-800,10,4,24,6,6,30,,,,,14,20
2019-04-15 01:28,HAK,6063,737-800,25,6,32,6,5,30,,,,,7,5
2019-04-15 01:27,CKG,5581,737-800,20,4,21,6,6,22,,,,,1,2
2019-04-15 01:23,SYX,5418,737-800,28,5,30,5,4,32,,,,,2,4
2019-04-15 01:22,CAN,1141,737-800,23,4,31,5,5,29,,,,,8,6
2019-04-15 01:17,XIY,5115,737-800,18,3,23,3,4,25,,,,,5,7
2019-04-15 01:14,HAK,206G,737-800,26,3,35,4,4,33,,,,,9,7
2019-04-15 01:13,URC,1498,737-800,16,4,24,4,4,22,,,,,8,6
2019-04-15 01:13,HAK,5089,737-800,27,2,26,1,1,32,,,,,-1,5
2019-04-15 01:12,HAK,1213,737-800,24,6,32,6,6,32,,,,,8,8
2019-04-15 01:10,HHA,1929,737-800,17,4,24,4,4,24,,,,,7,7
2019-04-15 01:08,XIY,5180,737-800,15,4,24,2,2,24,,,,,9,9
2019-04-15 01:03,MIG,6809,737-800,16,6,22,4,4,22,,,,,6,6
2019-04-15 01:03,SYX,1495,737-800,28,4,22,4,4,21,,,,,-6,-7
2019-04-15 01:02,HAK,1728,737-800,25,5,28,5,5,26,,,,,3,1
2019-04-15 01:02,HHA,7377,737-800,16,4,24,5,5,24,,,,,8,8
2019-04-15 01:01,HAK,5480,737-800,25,4,30,5,3,27,,,,,5,2
2019-04-15 01:01,CGO,5465,737-800,15,3,22,4,2,22,,,,,7,7
2019-04-15 01:00,CAN,1502,737-800,23,4,31,3,4,28,,,,,8,5
2019-04-15 00:56,KMG,5732,737-800,16,2,23,2,3,23,,,,,7,7
2019-04-15 00:56,SZX,5733,737-800,25,6,30,6,6,30,,,,,5,5
2019-04-15 00:55,CKG,6061,737-800,20,4,27,4,4,24,,,,,7,4
2019-04-15 00:55,YIH,1433,737-800,14,3,25,4,3,22,,,,,11,8
2019-04-15 00:54,XIY,5853,737-800,13,6,25,6,6,22,,,,,12,9
2019-04-15 00:53,KMG,7989,737-800,18,5,26,6,5,24,,,,,8,6
2019-04-15 00:52,CGO,6015,737-800,15,4,24,4,4,21,,,,,9,6
2019-04-15 00:51,HGH,5429,737-800,16,3,20,3,4,24,,,,,4,8
2019-04-15 00:49,URC,6995,737-800,19,4,25,6,5,26,,,,,6,7
2019-04-15 00:48,DLC,1488,737-800,15,5,21,6,6,24,,,,,6,9
2019-04-15 00:48,CAN,1726,737-800,23,5,32,3,3,26,,,,,9,3
2019-04-15 00:47,CAN,1373,737-800,23,3,30,4,3,24,,,,,7,1
2019-04-15 00:46,HAK,1785,737-800,24,1,32,8,8,31,,,,,8,7
2019-04-15 00:44,URC,205V,737-800,17,3,29,3,4,22,,,,,12,5
2019-04-15 00:44,CAN,1496,737-800,23,5,32,5,5,32,,,,,9,9
2019-04-15 00:44,MIG,5409,737-800,18,4,24,4,4,25,,,,,6,7
2019-04-15 00:43,DLC,1797,737-800,14,3,22,4,4,20,,,,,8,6
2019-04-15 00:43,URC,5375,737-800,15,2,19,4,4,22,,,,,4,7
2019-04-15 00:42,DLC,1488,737-800,20,5,25,6,5,22,,,,,5,2
2019-04-15 00:42,XIY,5428,737-800,16,4,20,4,4,30,,,,,4,14
2019-04-15 00:41,URC,5636,737-800,18,2,23,2,3,23,,,,,5,5
2019-04-15 00:41,URC,5637,737-800,19,2,23,3,3,22,,,,,4,3
2019-04-15 00:38,DLC,1102,737-800,14,3,24,4,3,22,,,,,10,8
2019-04-15 00:33,HAK,1793,737-800,25,4,32,6,5,30,,,,,7,5
2019-04-15 00:29,HAK,1996,737-800,27,5,33,6,5,30,,,,,6,3
2019-04-15 00:29,DLC,5417,737-800,15,4,20,4,4,20,,,,,5,5
2019-04-15 00:28,HRB,7105,737-800,9,5,19,5,6,20,,,,,10,11
2019-04-15 00:27,XIY,5478,737-800,17,3,24,5,4,24,,,,,7,7
2019-04-15 00:25,HAK,5090,737-800,24,2,30,3,3,31,,,,,6,7
2019-04-15 00:24,PEK,1541,737-800,18,4,26,6,4,24,,,,,8,6
2019-04-15 00:20,CGO,1490,737-800,16,6,23,5,6,22,,,,,7,6
2019-04-15 00:18,FOC,1348,737-800,22,4,29,3,3,25,,,,,7,3
2019-04-15 00:14,SZX,5135,737-800,24,3,30,2,2,28,,,,,6,4
2019-04-15 00:12,PEK,5502,737-800,19,5,21,5,5,22,,,,,2,3
2019-04-15 00:11,TYN,5521,737-800,10,4,16,2,2,16,,,,,6,6
2019-04-15 00:09,HGH,5638,737-800,22,4,24,4,4,24,,,,,2,2
2019-04-15 00:09,HGH,5462,737-800,20,4,22,4,6,24,,,,,2,4
2019-04-15 00:03,SZX,1505,737-800,25,5,36,3,5,34,,,,,11,9
2019-04-14 23:55,XIY,5406,737-800,17,4,19,7,4,21,,,,,2,4
2019-04-14 23:50,TYN,5687,737-800,11,4,18,5,4,20,,,,,7,9
2019-04-14 23:49,HHA,1787,737-800,17,2,22,2,2,20,,,,,5,3
2019-04-14 23:43,CGO,7993,737-800,17,4,25,5,5,25,,,,,8,8
2019-04-14 23:43,DLC,1346,737-800,12,7,27,5,5,20,,,,,15,8
2019-04-14 23:38,PEK,5373,737-800,18,6,20,6,6,22,,,,,2,4
2019-04-14 23:37,DLC,5346,737-800,14,5,22,5,4,26,,,,,8,12
2019-04-14 23:36,SYX,5520,737-800,30,6,32,6,6,33,,,,,2,3
2019-04-14 23:36,SYX,5520,737-800,30,6,32,6,6,33,,,,,2,3
2019-04-14 23:34,PEK,7398,737-800,20,5,24,4,4,22,,,,,4,2
2019-04-14 23:29,CAN,5686,737-800,23,5,30,5,5,26,,,,,7,3
2019-04-14 23:24,HRB,1905,737-800,12,3,22,3,3,20,,,,,10,8
2019-04-14 23:22,SYX,1796,737-800,28,8,32,7,8,32,,,,,4,4
2019-04-14 23:21,À¥Ã÷,5407,737-800,23,4,19,5,4,26,,,,,-4,3
2019-04-14 23:20,XIY,1995,737-800,16,5,20,5,5,22,,,,,4,6
2019-04-14 23:19,ZGC,1729,737-800,20,6,20,5,4,23,,,,,0,3
2019-04-14 23:17,HAK,7378,737-800,28,6,32,6,6,36,,,,,4,8
2019-04-14 23:13,MIG,1798,737-800,20,6,26,6,6,24,,,,,6,4
2019-04-14 23:09,HAK,7992,737-800,27,7,33,7,7,32,,,,,6,5
2019-04-14 23:06,DLC,1927,737-800,12,2,20,8,2,20,,,,,8,8
2019-04-14 23:03,URC,5580,737-800,21,3,21,3,3,23,,,,,0,2
2019-04-14 23:03,XIY,7639,737-800,17,6,30,6,6,24,,,,,13,7
2019-04-14 23:00,CAN,5405,737-800,25,5,34,6,4,31,,,,,9,6
2019-04-14 22:55,HHA,1497,737-800,16,3,22,2,2,22,,,,,6,6
2019-04-14 22:55,HAK,5082,737-800,26,7,36,5,5,33,,,,,10,7
2019-04-14 22:54,FOC,1906,737-800,19,7,28,6,6,26,,,,,9,7
2019-04-14 22:51,SZX,1997,737-800,24,4,34,4,4,26,,,,,10,2
2019-04-14 22:49,CGO,206P,737-800,17,4,26,4,4,22,,,,,9,5
2019-04-14 22:41,URC,1325,737-800,15,4,24,4,4,22,,,,,9,7
2019-04-14 22:39,URC,5579,737-800,20,3,26,2,2,21,,,,,6,1
2019-04-14 22:36,CAN,1538,737-800,23,5,30,4,3,30,,,,,7,7
2019-04-14 22:33,XIY,7886,737-800,16,4,26,2,2,24,,,,,10,8
2019-04-14 22:33,PEK,5522,737-800,19,4,22,4,4,20,,,,,3,1
2019-04-14 22:17,URC,205T,737-800,20,2,26,3,2,25,,,,,6,5
2019-04-14 22:17,XNN,5479,737-800,12,6,20,6,6,20,,,,,8,8
2019-04-14 22:16,HAK,5481,737-800,27,6,32,4,4,32,,,,,5,5
2019-04-14 22:13,HAK,1545,737-800,27,6,34,6,6,33,,,,,7,6
2019-04-14 22:05,TYN,7175,737-800,15,3,21,3,4,20,,,,,6,5
2019-04-14 21:55,HGH,6808,737-800,20,4,27,4,4,26,,,,,7,6
2019-04-14 21:34,XNN,5338,737-800,12,3,18,4,3,22,,,,,6,10
2019-04-14 21:01,CGO,1209,737-800,21,3,27,4,3,22,,,,,6,1
2019-04-14 19:02,HRB,1562,737-800,11,5,22,5,6,21,,,,,11,10
2019-04-14 17:11,HAK,206H,737-800,33,2,36,2,2,36,,,,,3,3
2019-04-14 17:02,CTU,7990,737-800,25,3,26,3,3,25,,,,,1,0
2019-04-14 16:39,ÐìÖÝ,1208,737-800,20,2,24,3,4,22,,,,,4,2
2019-04-14 15:15,HRB,7105,737-800,4,4,24,6,4,20,,,,,20,16
2019-04-14 08:51,HAK,6800,737-800,25,4,36,4,4,30,1,,,1,11,5
2019-04-14 08:50,HAK,5579,737-800,28,5,35,5,5,35,,,,,7,7
2019-04-14 08:49,HAK,5089,737-800,25,6,30,1,1,33,,,,,5,8
2019-04-14 08:25,PEK,1503,737-800,14,2,8,3,3,10,,,,,-6,-4
2019-04-14 08:02,KMG,5407,737-800,18,4,25,6,4,22,,,,,7,4
2019-04-14 07:04,PEK,1103,737-800,15,3,30,3,3,22,,,,,15,7
2019-04-14 06:58,HHA,1727,737-800,20,5,27,4,5,24,,,,,7,4
2019-04-14 06:45,TYN,206F,737-800,10,4,20,4,2,18,,,,,10,8
2019-04-14 06:16,KHG,205T,737-800,20,2,26,2,2,26,,,,,6,6
2019-04-14 06:02,FOC,5713,737-800,19,6,27,6,6,0,,,,,8,-19
2019-04-14 06:02,KMG,1588,737-800,20,8,26,4,4,21,,,,,6,1
2019-04-14 05:52,CAN,5478,737-800,23,4,32,4,4,27,,,,,9,4
2019-04-14 05:25,XIY,5430,737-800,10,4,20,4,4,22,,,,,10,12
2019-04-14 05:12,XMN,5709,737-800,20,6,30,7,6,27,,,,,10,7
2019-04-14 05:11,XMN,1787,737-800,20,7,28,8,8,31,,,,,8,11
2019-04-14 05:11,XMN,1733,737-800,20,6,29,7,7,30,,,,,9,10
2019-04-14 05:06,MIG,1798,737-800,21,7,27,6,6,24,,,,,6,3
2019-04-14 05:05,MIG,1798,737-800,21,7,27,6,6,24,,,,,6,3
2019-04-14 04:59,CGO,5429,737-800,19,4,22,4,3,24,,,,,3,5
2019-04-14 04:50,URC,1372,737-800,16,4,24,4,4,20,,,,,8,4
2019-04-14 04:45,CAN,5153,737-800,22,5,30,3,2,19,,,,,8,-3
2019-04-14 04:42,XIY,1995,737-800,12,5,24,3,3,22,,,,,12,10
2019-04-14 04:35,FOC,5182,737-800,18,4,26,4,4,24,,,,,8,6
2019-04-14 04:29,SZX,5661,737-800,24,4,28,4,4,32,,,,,4,8
2019-04-14 04:23,XIY,1483,737-800,12,9,23,7,6,24,,,,,11,12
2019-04-14 04:15,XIY,1161,737-800,12,4,24,4,4,22,,,,,12,10
2019-04-14 04:14,XIY,5116,737-800,13,4,20,4,4,20,,,,,7,7
2019-04-14 04:12,XIY,5623,737-800,15,4,24,6,6,26,,,,,9,11
2019-04-14 04:09,PEK,5482,737-800,15,12,21,4,4,20,1,,,1,6,5
2019-04-14 04:05,CAN,5735,737-800,23,2,24,2,4,24,,,,,1,1
2019-04-14 03:53,PEK,5136,737-800,10,4,20,4,4,28,,,,,10,18
2019-04-14 03:49,XIY,5115,737-800,15,2,28,2,4,28,,,,,13,13
2019-04-14 03:43,HHA,1487,737-800,19,2,25,3,2,23,,,,,6,4
2019-04-14 03:41,SZX,7171,737-800,24,2,22,4,4,28,,,,,-2,4
2019-04-14 03:39,HAK,5463,737-800,27,5,31,4,4,28,,,,,4,1
2019-04-14 03:33,URC,1568,737-800,16,6,24,6,6,22,,,,,8,6
2019-04-14 03:32,XIY,7639,737-800,13,7,31,7,6,24,,,,,18,11
2019-04-14 03:31,XIY,5428,737-800,15,4,19,6,4,28,,,,,4,13
2019-04-14 03:28,XIY,1482,737-800,12,4,27,6,6,22,,,,,15,10
2019-04-14 03:19,SYX,2158,737-800,28,8,30,4,4,28,,,,,2,0
2019-04-14 03:16,KMG,6016,737-800,20,6,20,7,5,22,,,,,0,2
2019-04-14 03:16,HAK,6061,737-800,28,6,34,5,6,31,,,,,6,3
2019-04-14 03:15,HHA,1929,737-800,19,3,14,3,3,17,,,,,-5,-2
2019-04-14 03:15,URC,5611,737-800,17,5,25,7,6,27,,,,,8,10
2019-04-14 03:15,XIY,1163,737-800,12,5,20,5,4,21,,,,,8,9
2019-04-14 03:14,SYX,1490,737-800,28,3,31,8,8,30,,,,,3,2
2019-04-14 03:14,XIY,5853,737-800,14,5,23,5,6,24,,,,,9,10
2019-04-14 03:13,URC,6268,737-800,16,5,26,5,5,24,,,,,10,8
2019-04-14 03:12,103,5539,737-800,16,3,20,3,3,21,,,,,4,5
2019-04-14 03:11,XIY,1902,737-800,13,6,24,6,4,22,,,,,11,9
2019-04-14 03:08,URC,5797,737-800,15,5,21,5,5,23,,,,,6,8
2019-04-14 03:07,XIY,1491,737-800,15,5,26,5,5,25,,,,,11,10
2019-04-14 03:07,XIY,7113,737-800,15,4,24,6,4,27,,,,,9,12
2019-04-14 03:05,URC,2159,737-800,16,8,16,3,2,20,,,,,0,4
2019-04-14 03:01,PEK,1927,737-800,17,4,20,7,4,24,,,,,3,7
2019-04-14 03:01,SZX,1728,737-800,27,4,28,4,4,26,,,,,1,-1
2019-04-14 02:55,KMG,7988,737-800,15,6,22,6,5,24,,,,,7,9
2019-04-14 02:53,PEK,1541,737-800,15,4,18,3,4,17,,,,,3,2
2019-04-14 02:46,SYX,5418,737-800,25,7,28,4,4,30,,,,,3,5
2019-04-14 02:46,HHA,7377,737-800,18,6,25,4,4,28,,,,,7,10
2019-04-14 02:46,KMG,1588,737-800,20,3,23,5,4,20,,,,,3,0
2019-04-14 02:45,FOC,1348,737-800,21,4,28,4,4,25,,,,,7,4
2019-04-14 02:44,HAK,7616,737-800,27,4,30,4,4,34,,,,,3,7
2019-04-14 02:44,SYX,5138,737-800,28,4,34,6,4,36,,,,,6,8
2019-04-14 02:40,CAN,1726,737-800,23,4,32,4,4,26,,,,,9,3
2019-04-14 02:37,HGH,1997,737-800,20,4,24,6,6,36,,1,,1,4,16
2019-04-14 02:36,URC,5580,737-800,16,5,24,6,6,26,,,,,8,10
2019-04-14 02:35,CGO,7991,737-800,16,6,26,5,6,24,,,,,10,8
2019-04-14 02:33,PEK ,6062,737-800,15,2,20,4,2,22,,,,,5,7
2019-04-14 02:32,URC,5636,737-800,15,4,22,4,4,22,,,,,7,7
2019-04-14 02:31,CAN,1496,737-800,23,6,32,5,5,32,,,,,9,9
2019-04-14 02:26,HAK,7172,737-800,27,5,34,5,4,32,,,,,7,5
2019-04-14 02:21,HAK,5662,737-800,25,4,33,4,8,32,,,,,8,7
2019-04-14 02:16,SZX,5372,737-800,24,8,30,8,8,32,,,,,6,8
2019-04-14 02:15,HHA,1549,737-800,20,1,22,2,1,19,,,,,2,-1
2019-04-14 02:10,ZGC,5620,737-800,15,6,22,4,5,23,,,,,7,8
2019-04-14 02:10,TYN,5521,737-800,8,4,15,2,3,11,,,,,7,3
2019-04-14 02:10,FOC,1906,737-800,20,6,28,6,6,27,,,,,8,7
2019-04-14 02:09,HAK,1215,737-800,27,4,31,4,3,32,,,,,4,5
2019-04-14 02:09,CAN,1213,737-800,22,7,30,6,6,28,,,,,8,6
2019-04-14 02:09,XIY,5371,737-800,15,4,28,5,4,27,,,,,13,12
2019-04-14 02:07,URC,1725,737-800,17,4,22,2,3,24,,,,,5,7
2019-04-14 02:07,XIY ,1735 ,737-800,14,3,22,4,3,22,,,,,8,8
2019-04-14 02:06,HAK,5416,737-800,27,7,29,8,7,33,,,,,2,6
2019-04-14 02:05,YIH,1433,737-800,17,3,27,3,3,22,,,,,10,5
2019-04-14 02:05,CAN,1538,737-800,23,3,30,3,3,28,,,,,7,5
2019-04-14 02:04,SYX,1495,737-800,25,6,32,6,6,32,,,,,7,7
2019-04-14 02:02,KMG,7992,737-800,19,6,24,8,8,24,,,,,5,5
2019-04-14 02:02,HHA,1928,737-800,20,4,20,6,6,22,,,,,0,2
2019-04-14 01:59,URC,5637,737-800,17,2,12,2,2,14,,,,,-5,-3
2019-04-14 01:59,ZGC,5540,737-800,11,5,26,5,5,24,,,,,15,13
2019-04-14 01:55,FOC,1559,737-800,17,4,29,5,6,28,,,,,12,11
2019-04-14 01:51,URC,7175,737-800,16,4,24,6,4,22,,,,,8,6
2019-04-14 01:51,HGH,1547,737-800,24,5,27,4,4,25,,,,,3,1
2019-04-14 01:49,º£¿Ú,5358,737-800,25,8,34,9,9,34,,,,,9,9
2019-04-14 01:48,HHA,2647,737-800,18,2,20,3,3,20,,,,,2,2
2019-04-14 01:47,CGO,7993,737-800,16,5,25,6,6,22,,,,,9,6
2019-04-14 01:46,XIY,1386,737-800,11,2,23,3,4,22,,,,,12,11
2019-04-14 01:44,CGO,1587,737-800,18,4,27,4,3,24,,,,,9,6
2019-04-14 01:44,KMG,7167,737-800,20,5,25,5,5,22,,,,,5,2
2019-04-14 01:40,SZX,1505,737-800,24,4,30,4,4,26,,,,,6,2
2019-04-14 01:39,HHA,6063,737-800,25,6,27,6,6,28,,,,,2,3
2019-04-14 01:39,SZX,5733,737-800,27,6,30,6,7,30,,,,,3,3
2019-04-14 01:38,HAK,1498,737-800,26,6,32,5,5,31,,,,,6,5
2019-04-14 01:37,CGO,6015,737-800,17,3,25,4,4,24,,,,,8,7
2019-04-14 01:36,URC,5373,737-800,18,5,20,5,5,20,,,,,2,2
2019-04-14 01:33,TYN,1548,737-800,7,4,20,4,4,20,,,,,13,13
2019-04-14 01:27,HAK,1785,737-800,27,8,30,8,8,32,,,,,3,5
2019-04-14 01:26,HAK,1795,737-800,28,4,34,4,4,30,,,,,6,2
2019-04-14 01:24,SZX,6060,737-800,24,5,31,5,5,27,,,,,7,3
2019-04-14 01:24,MIG,5732,737-800,16,4,26,4,4,25,,,,,10,9
2019-04-14 01:21,PEK,1347,737-800,20,4,22,3,4,20,,,,,2,0
2019-04-14 01:20,DLC,5439,737-800,12,4,20,3,3,20,,,,,8,8
2019-04-14 01:19,XIY,5180,737-800,15,4,28,4,2,30,,,,,13,15
2019-04-14 01:16,URC,205U,737-800,17,4,24,3,3,22,,,,,7,5
2019-04-14 01:14,SZX,1783,737-800,21,5,0,5,6,20,,,,,-21,-1
2019-04-14 01:12,URC,6995,737-800,17,4,24,5,5,18,,,,,7,1
2019-04-14 01:11,FOC,5503,737-800,19,3,24,4,3,24,,,,,5,5
2019-04-14 01:11,CAN,1141,737-800,22,3,33,6,6,30,,,,,11,8
2019-04-14 01:09,PEK,7398,737-800,15,4,24,5,4,20,,,,,9,5
2019-04-14 01:01,HAK,1545,737-800,25,6,35,5,6,32,,,,,10,7
2019-04-14 00:59,HGH,5141,737-800,20,3,22,3,3,21,,,,,2,1
2019-04-14 00:53,HGH,5135,737-800,19,3,27,2,2,25,,,,,8,6
2019-04-14 00:51,HGH,1729,737-800,19,4,24,4,4,22,,,,,5,3
2019-04-14 00:50,HAK,206G,737-800,27,3,34,3,4,34,,,,,7,7
2019-04-14 00:49,CAN,1796,737-800,22,6,31,5,4,29,,,,,9,7
2019-04-14 00:48,URC,5625,737-800,19,7,26,4,4,22,,,,,7,3
2019-04-14 00:47,XNN,5338,737-800,4,3,16,4,4,20,,,,,12,16
2019-04-14 00:46,¹þ¶û±õ,1562,737-800,6,4,27,4,4,28,,,,,21,22
2019-04-14 00:46,HAK,5712,737-800,28,2,33,6,2,30,,,,,5,2
2019-04-14 00:43,KMG,1209,737-800,20,4,16,4,5,22,,,,,-4,2
2019-04-14 00:42,104,5408,737-800,16,3,20,2,5,20,,,,,4,4
2019-04-14 00:41,FOC,1906,737-800,20,6,28,6,6,27,,,,,8,7
2019-04-14 00:38,DLC,5417,737-800,15,4,24,4,4,20,,,,,9,5
2019-04-14 00:37,CAN,1996,737-800,23,5,30,6,5,28,,,,,7,5
2019-04-14 00:35,CAN,5405,737-800,23,4,32,5,5,32,,,,,9,9
2019-04-14 00:33,URC,1323,737-800,20,2,14,3,3,16,,,,,-6,-4
2019-04-14 00:33,HAK,1785,737-800,25,10,34,8,10,32,,,,,9,7
2019-04-14 00:31,HAK,1101,737-800,20,5,32,5,6,34,1,1,,11,12,14
2019-04-14 00:29,SYX,5855,737-800,25,7,30,8,7,28,,,,,5,3
2019-04-14 00:26,CKG,5581,737-800,23,5,22,4,4,22,,,,,-1,-1
2019-04-14 00:26,HRB,7105,737-800,4,4,24,6,4,20,,,,,20,16
2019-04-14 00:24,URC,5375,737-800,20,0,18,0,0,18,,,,,-2,-2
2019-04-14 00:24,DLC,5346,737-800,12,4,20,4,4,24,,,,,8,12
2019-04-14 00:22,FOC,1350,737-800,20,4,27,3,3,23,,,,,7,3
2019-04-14 00:18,SYX,5520,737-800,29,4,34,7,6,34,,,,,5,5
2019-04-14 00:16,CGO,5465,737-800,19,4,22,4,3,23,,,,,3,4
2019-04-14 00:12,FOC,7395,737-800,19,6,25,6,6,26,,,,,6,7
2019-04-14 00:12,MIG,5409,737-800,18,4,26,4,4,27,,,,,8,9
2019-04-14 00:11,HAK,1786,737-800,22,2,31,3,4,28,,,,,9,6
2019-04-14 00:08,HGH,1497,737-800,18,4,26,4,2,22,,,,,8,4
2019-04-14 00:07,SZX,1492,737-800,24,3,27,3,3,26,,,,,3,2
2019-04-14 00:05,XIY,1903,737-800,15,4,24,4,4,23,,,,,9,8
2019-04-13 23:58,FOC,1906,737-800,20,6,28,6,6,27,,,,,8,7
2019-04-13 23:54,HAK,5090,737-800,28,2,34,2,2,33,,,,,6,5
2019-04-13 23:53,KMG,1208,737-800,20,26,8,4,4,21,,,,,-12,1
2019-04-13 23:51,CGO,206P,737-800,20,4,28,4,4,26,,,,,8,6
2019-04-13 23:47,HAK,5686,737-800,25,5,34,5,5,32,,,,,9,7
2019-04-13 23:44,HHA,6066,737-800,15,3,28,3,3,26,,,,,13,11
2019-04-13 23:43,SYX,1502,737-800,29,4,34,4,4,32,,,,,5,3
2019-04-13 23:40,CKG,5480,737-800,25,3,28,4,4,28,,,,,3,3
2019-04-13 23:39,SYX,1489,737-800,28,2,25,8,8,24,,,,,-3,-4
2019-04-13 23:38,HRB,1480,737-800,6,4,18,6,6,18,,,,,12,12
2019-04-13 23:30,URC,1131,737-800,10,6,22,6,6,20,,,,,12,10
2019-04-13 23:29,CKG,7619,737-800,25,4,22,4,3,20,,,,,-3,-5
2019-04-13 23:23,CAN,5648,737-800,22,4,30,4,4,28,,,,,8,6
2019-04-13 23:20,DLC,5439,737-800,12,4,20,3,3,20,,,,,8,8
2019-04-13 23:20,MIG,1798,737-800,21,7,27,6,24,24,,,,,6,3
2019-04-13 23:20,XIY,1375,737-800,15,4,24,5,4,25,,,,,9,10
2019-04-13 23:20,URC,1569,737-800,20,2,27,3,2,25,,,,,7,5
2019-04-13 23:17,HAK,5082,737-800,27,7,36,4,3,32,,,,,9,5
2019-04-13 23:12,URC,206H,737-800,20,4,23,3,3,22,,,,,3,2
2019-04-13 23:12,CAN,1373,737-800,22,6,30,4,4,24,,,,,8,2
2019-04-13 23:05,XUZ,7988,737-800,20,4,26,5,4,23,,,,,6,3
2019-04-13 23:04,URC,1325,737-800,15,4,26,4,4,20,,,,,11,5
2019-04-13 23:03,ZGC,1493,737-800,5,6,22,6,6,18,,,,,17,13
2019-04-13 23:02,HRB,1905,737-800,6,3,22,3,3,18,,,,,16,12
2019-04-13 23:02,TYN,7886,737-800,10,3,24,3,3,22,,,,,14,12
2019-04-13 22:55,DLC,1102,737-800,10,3,24,4,4,22,,,,,14,12
2019-04-13 22:43,DLC,1488,737-800,15,6,27,6,6,22,,,,,12,7
2019-04-13 22:27,HAK,7399,737-800,27,5,31,3,3,28,,,,,4,1
2019-04-13 22:19,PEK,1501,737-800,18,3,18,4,4,22,,,,,0,4
2019-04-13 22:12,XIY,5406,737-800,15,3,22,4,3,22,,,,,7,7
2019-04-13 22:08,HAK,7173,737-800,27,5,30,5,6,32,,,,,3,5
2019-04-13 22:06,HAK,1130,737-800,27,4,34,2,3,29,,,,,7,2
2019-04-13 22:05,ZGC,5620,737-800,15,6,22,4,5,23,,,,,7,8
2019-04-13 21:54,XNN,5479,737-800,4,5,19,6,6,18,,,,,15,14
2019-04-13 21:53,MIG,6809,737-800,22,4,24,4,5,25,,,,,2,3
2019-04-13 21:51,DLC,1346,737-800,12,4,26,4,6,24,,,,,14,12
2019-04-13 21:14,TYN,5687,737-800,10,4,20,6,8,22,,,,,10,12
2019-04-13 20:56,DLC,6065,737-800,10,4,26,4,4,24,,,,,16,14
2019-04-13 20:53,´óÁ¬,5139,737-800,11,4,16,6,4,24,,,,,5,13
2019-04-13 20:35,PEK,5502,737-800,19,5,24,6,5,22,,,,,5,3
2019-04-13 20:10,DLC,1797,737-800,13,2,20,2,2,22,,,,,7,9
2019-04-13 20:07,HAK,1793,737-800,27,5,37,6,6,32,,,,,10,5
2019-04-13 19:40,HAK,7378,737-800,28,6,32,6,6,32,,,,,4,4
2019-04-13 19:31,URC,1570,737-800,28,5,23,5,6,20,,,,,-5,-8
2019-04-13 19:25,XIY,5467,737-800,16,2,21,2,3,16,,,,,5,0
2019-04-13 18:47,HGH,6808,737-800,19,4,27,4,4,26,,,,,8,7
2019-04-13 18:36,PEK,5538,737-800,25,4,24,3,5,22,,,,,-1,-3
2019-04-13 18:20,URC,2159,737-800,15,8,16,1,1,22,,,,,1,7
2019-04-13 18:19,URC,205U,737-800,15,2,20,4,4,22,,,,,5,7
2019-04-13 18:01,HGH,6103,737-800,21,6,26,6,6,25,,,,,5,4
2019-04-13 15:18,URC,7198,737-800,23,5,24,4,5,23,,,,,1,0
2019-04-13 15:08,XIY,1161,737-800,16,2,24,2,2,22,,,,,8,6
2019-04-13 15:06,XIY,1163,737-800,15,2,25,4,4,22,,,,,10,7
2019-04-13 14:49,XIY,1902,737-800,20,0,16,0,1,18,,,,,-4,-2
2019-04-13 14:29,URC,1725,737-800,15,4,25,3,5,24,,,,,10,9
2019-04-13 14:12,XIY,1483,737-800,18,4,22,6,6,22,,,,,4,4
2019-04-13 12:22,XIY,1481,737-800,15,6,26,6,7,18,,,,,11,3
2019-04-13 12:10,HAK,1213,737-800,34,6,36,6,6,34,,,,,2,0
2019-04-13 12:08,XIY,1162,737-800,16,2,12,2,4,22,,,,,-4,6
2019-04-13 11:54,CTU,7990,737-800,23,3,26,3,3,24,,,,,3,1
2019-04-13 11:46,URC,1323,737-800,18,4,24,3,3,25,,,,,6,7
2019-04-13 11:23,XIY,1903,737-800,20,1,24,1,0,22,,,,,4,2
2019-04-13 09:56,XIY,1482,737-800,13,6,27,6,6,22,,,,,14,9
2019-04-13 09:54,XIY,1482,737-800,13,6,27,6,6,22,,,,,14,9
2019-04-13 09:47,HAK,5462,737-800,30,4,31,7,5,33,,,,,1,3
2019-04-13 08:37,PEK,5416,737-800,16,8,22,8,8,25,,,,,6,9
2019-04-13 08:22,CAN,5371,737-800,20,8,26,6,7,26,,,,,6,6
2019-04-13 07:55,SZX,1505,737-800,22,4,30,4,3,28,,,,,8,6
2019-04-13 07:53,SZX,1505,737-800,22,4,30,4,3,28,,,,,8,6
2019-04-13 07:37,SZX,1783,737-800,23,4,18,5,4,30,,,,,-5,7
2019-04-13 07:37,HAK,5337,737-800,27,4,34,5,5,36,,,,,7,9
2019-04-13 07:36,HAK,5852,737-800,27,4,30,5,4,30,,,,,3,3
2019-04-13 07:36,SZX,5406,737-800,22,4,24,7,3,28,,,,,2,6
2019-04-13 07:36,PEK,1799,737-800,14,5,15,4,5,18,,,,,1,4
2019-04-13 07:35,SZX,1492,737-800,23,3,29,3,3,28,,,,,6,5
2019-04-13 07:34,SZX,7616,737-800,23,4,26,4,4,28,,,,,3,5
2019-04-13 07:34,SZX,7886,737-800,23,3,25,3,3,30,,,,,2,7
2019-04-13 07:33,SZX,7171,737-800,22,5,27,4,4,28,,,,,5,6
2019-04-13 07:32,SZX,5661,737-800,22,4,26,4,4,30,,,,,4,8
2019-04-13 07:10,ZGC,5138,737-800,10,5,21,4,3,20,,,,,11,10
2019-04-13 07:08,ZGC,5116,737-800,10,4,19,4,5,17,,,,,9,7
2019-04-13 06:57,XMN,6066,737-800,18,3,26,3,3,25,,,,,8,7
2019-04-13 06:56,XMN,5408,737-800,19,4,27,4,3,23,,,,,8,4
2019-04-13 06:55,XMN,5467,737-800,15,2,10,3,4,11,,,,,-5,-4
2019-04-13 06:54,DLC,1102,737-800,10,2,18,4,4,20,,,,,8,10
2019-04-13 06:54,XMN,5540,737-800,19,6,30,4,4,26,,,,,11,7
2019-04-13 06:17,PEK,6065,737-800,14,4,25,5,5,24,,,,,11,10
2019-04-13 06:08,FOC,1559,737-800,15,3,26,3,3,24,,,,,11,9
2019-04-13 05:59,KMG,5409,737-800,20,5,23,5,6,25,,,,,3,5
2019-04-13 05:45,ZGC,1733,737-800,14,7,23,6,5,21,,,,,9,7
2019-04-13 05:42,XIY,1386,737-800,14,3,25,3,4,18,,,,,11,4
2019-04-13 05:24,XIY,5346,737-800,16,5,20,6,5,22,,,,,4,6
2019-04-13 05:13,HGH,1493,737-800,12,4,20,4,3,20,,,,,8,8
2019-04-13 05:01,CGO,5358,737-800,14,5,21,4,4,26,,,,,7,12
2019-04-13 04:59,CGO,5358,737-800,14,5,21,4,4,26,,,,,7,12
2019-04-13 04:57,PEK,5539,737-800,10,5,21,5,5,22,,,,,11,12
2019-04-13 04:56,SYX,5465,737-800,29,4,29,5,4,32,,,,,0,3
2019-04-13 04:34,SZX,1505,737-800,22,4,30,4,3,28,,,,,8,6
2019-04-13 04:23,FOC,1131,737-800,16,3,22,4,5,16,,,,,6,0
2019-04-13 04:21,KMG,1588,737-800,16,4,22,4,4,20,,,,,6,4
2019-04-13 04:16,HAK,7400,737-800,27,5,32,5,5,30,,,,,5,3
2019-04-13 04:15,KMG ,6800,737-800,17,4,20,4,4,20,,,,,3,3
2019-04-13 04:14,URC,1322,737-800,13,2,20,2,2,22,,,,,7,9
2019-04-13 04:13,URC,7198,737-800,14,4,23,5,4,20,,,,,9,6
2019-04-13 04:13,URC,6268,737-800,14,4,24,5,5,23,,,,,10,9
2019-04-13 04:12,URC,5637,737-800,14,2,23,2,2,18,,,,,9,4
2019-04-13 04:12,CGO,1491,737-800,15,5,26,5,5,24,,,,,11,9
2019-04-13 04:12,URC,5373,737-800,18,5,22,5,6,22,,,,,4,4
2019-04-13 04:10,URC,1570,737-800,14,4,16,4,4,18,,,,,2,4
2019-04-13 04:09,HHA,1101,737-800,17,4,30,2,2,25,,,,,13,8
2019-04-13 04:08,SYX,1502,737-800,26,4,29,5,4,32,,,,,3,6
2019-04-13 04:05,URC,1372,737-800,17,7,28,9,9,23,,,,,11,6
2019-04-13 04:03,SYX,5520,737-800,28,6,34,7,6,34,,,,,6,6
2019-04-13 04:03,URC,6995,737-800,17,4,22,4,4,19,,,,,5,2
2019-04-13 04:02,PEK,5538,737-800,14,2,30,3,3,30,,,,,16,16
2019-04-13 04:01,FOC,5503,737-800,20,4,24,4,4,20,,,,,4,0
2019-04-13 03:40,PEK ,7398,737-800,13,4,24,18,20,21,,,,,11,8
2019-04-13 03:37,HAK,5418,737-800,24,8,32,4,4,33,,,,,8,9
2019-04-13 03:37,FOC,7105,737-800,15,4,14,5,4,20,,,,,-1,5
2019-04-13 03:31,TYN,206F,737-800,15,2,22,4,4,18,,,,,7,3
2019-04-13 03:26,URC,7175,737-800,15,4,21,4,4,21,,,,,6,6
2019-04-13 03:25,URC,5636,737-800,15,4,22,6,4,22,,,,,7,7
2019-04-13 03:25,HAK,1785,737-800,27,0,34,8,8,32,,,,,7,5
2019-04-13 03:25,PEK,1929,737-800,17,4,25,3,3,23,,,,,8,6
2019-04-13 03:24,HAK,1786,737-800,28,2,34,4,4,31,,,,,6,3
2019-04-13 03:22,HAK,1785,737-800,27,0,34,8,8,32,,,,,7,5
2019-04-13 03:15,HAK,5463,737-800,27,4,32,6,7,29,,,,,5,2
2019-04-13 03:14,HAK,1547,737-800,27,6,34,5,5,33,,,,,7,6
2019-04-13 03:06,KMG,1208,737-800,15,3,21,4,3,19,,,,,6,4
2019-04-13 03:05,URC,1347,737-800,17,4,22,0,0,20,,,,,5,3
2019-04-13 03:04,CAN,1501,737-800,22,4,31,4,4,28,,,,,9,6
2019-04-13 03:04,PEK,5482,737-800,16,0,20,3,5,20,,,,,4,4
2019-04-13 03:02,TYN,5521,737-800,10,4,20,2,2,15,,,,,10,5
2019-04-13 03:02,YIH,1351,737-800,13,3,24,4,4,22,,,,,11,9
2019-04-13 02:59,HGH,5405,737-800,20,5,28,5,4,23,,,,,8,3
2019-04-13 02:58,HAK,1793,737-800,28,4,34,4,5,31,,,,,6,3
2019-04-13 02:58,HGH,5405,737-800,20,5,28,5,4,23,,,,,8,3
2019-04-13 02:53,FOC,1906,737-800,17,5,20,6,6,22,,,,,3,5
2019-04-13 02:53,XIY,1375,737-800,14,5,20,5,6,20,,,,,6,6
2019-04-13 02:52,HHA,1549,737-800,17,5,27,6,5,24,,,,,10,7
2019-04-13 02:42,XIY,1728,737-800,12,4,20,4,4,20,,,,,8,8
2019-04-13 02:38,URC,6062,737-800,15,2,22,2,4,20,,,,,7,5
2019-04-13 02:37,XIY,5522,737-800,11,6,23,5,4,19,,,,,12,8
2019-04-13 02:34,,BX6015,737-800,18,4,26,4,4,22,,,,,8,4
2019-04-13 02:28,CAN,7172,737-800,19,0,30,8,6,28,,,,,11,9
2019-04-13 02:27,FOC,1348,737-800,16,4,27,4,3,24,,,,,11,8
2019-04-13 02:21,URC,1735,737-800,15,4,22,4,4,20,,,,,7,5
2019-04-13 02:21,CGO,206P,737-800,18,4,26,4,4,18,,,,,8,0
2019-04-13 02:21,URC,1995,737-800,15,6,22,6,7,22,,,,,7,7
2019-04-13 02:20,SYX,206H,737-800,29,5,33,4,5,33,,,,,4,4
2019-04-13 02:19,CAN,5478,737-800,20,4,32,4,4,24,,,,,12,4
2019-04-13 02:17,CAN,5735,737-800,20,1,24,1,1,21,,,,,4,1
2019-04-13 02:14,URC,5625,737-800,17,8,26,5,4,19,,,,,9,2
2019-04-13 02:12,TYN,5439,737-800,11,4,20,4,4,20,,,,,9,9
2019-04-13 02:08,URC,1568,737-800,15,3,20,4,4,20,,,,,5,5
2019-04-13 02:06,HAK,6060,737-800,28,5,35,5,6,34,,,,,7,6
2019-04-13 02:02,SYX,1489,737-800,28,4,35,4,4,31,,,,,7,3
2019-04-13 01:59,HAK,1141,737-800,27,3,32,6,7,32,,,,,5,5
2019-04-13 01:59,HAK,6061,737-800,27,4,29,5,3,29,,,,,2,2
2019-04-13 01:55,XIY,1541,737-800,11,5,26,5,4,21,,,,,15,10
2019-04-13 01:53,KMG,7988,737-800,19,4,24,5,5,25,,,,,5,6
2019-04-13 01:51,HHA,1787,737-800,19,2,23,2,2,21,,,,,4,2
2019-04-13 01:50,PEK,1503,737-800,15,3,24,4,3,20,,,,,9,5
2019-04-13 01:42,CAN,1538,737-800,20,3,28,4,3,27,,,,,8,7
2019-04-13 01:42,HAK,5136,737-800,27,3,31,5,5,37,,,,,4,10
2019-04-13 01:40,HGH ,6103,737-800,15,5,22,5,6,21,,,,,7,6
2019-04-13 01:38,SZX,7616,737-800,23,4,26,4,4,28,,,,,3,5
2019-04-13 01:38,XIY,5180,737-800,11,4,18,2,3,20,,,,,7,9
2019-04-13 01:37,HHA,5853,737-800,19,6,28,6,6,23,,,,,9,4
2019-04-13 01:36,FOC,7113,737-800,18,4,28,4,5,26,,,,,10,8
2019-04-13 01:35,HAK,5429,737-800,27,3,33,3,3,32,,,,,6,5
2019-04-13 01:34,DLC,1548,737-800,13,4,24,4,4,24,,,,,11,11
2019-04-13 01:34,MIG,5407,737-800,18,4,26,4,3,25,,,,,8,7
2019-04-13 01:33,DLC,1797,737-800,13,3,22,2,2,22,,,,,9,9
2019-04-13 01:33,DLC,5417,737-800,13,6,22,6,5,24,,,,,9,11
2019-04-13 01:31,KMG,7993,737-800,18,5,24,5,5,20,,,,,6,2
2019-04-13 01:31,DLC,1346,737-800,13,5,16,6,5,18,,,,,3,5
2019-04-13 01:30,DLC,1488,737-800,11,4,23,4,4,24,,,,,12,13
2019-04-13 01:30,HAK,7399,737-800,27,4,32,4,4,28,,,,,5,1
2019-04-13 01:30,TYN,1215,737-800,10,3,24,3,3,22,,,,,14,12
2019-04-13 01:30,DLC,5359,737-800,13,4,10,4,4,20,,,,,-3,7
2019-04-13 01:29,DLC,5713,737-800,12,6,22,6,6,20,,,,,10,8
2019-04-13 01:29,SZX,1783,737-800,23,4,18,5,4,30,,,,,-5,7
2019-04-13 01:26,HGH,6808,737-800,16,4,25,4,4,24,,,,,9,8
2019-04-13 01:23,CAN,5462,737-800,19,4,26,6,4,25,,,,,7,6
2019-04-13 01:21,CKG,5581,737-800,20,5,26,6,5,27,,,,,6,7
2019-04-13 01:21,SYX,1495,737-800,28,2,30,4,4,28,,,,,2,0
2019-04-13 01:19,HAK,206G,737-800,25,4,35,4,4,32,,,,,10,7
2019-04-13 01:17,CGO,7992,737-800,19,6,25,6,6,24,,,,,6,5
2019-04-13 01:13,TYN,206F,737-800,15,2,22,14,14,26,,,,,7,11
2019-04-13 01:09,HRB,1562,737-800,12,6,22,4,4,22,,,,,10,10
2019-04-13 01:08,SYX,2158,737-800,29,8,30,5,4,27,,,,,1,-2
2019-04-13 01:08,YIH,1433,737-800,13,3,25,3,3,24,,,,,12,11
2019-04-13 01:05,HGH,5579,737-800,17,5,28,4,5,24,,,,,11,7
2019-04-13 01:02,CKG,7618,737-800,21,5,26,5,6,25,,,,,5,4
2019-04-13 01:01,HAK,5090,737-800,30,2,32,2,3,31,,,,,2,1
2019-04-13 01:00,MIG,1798,737-800,18,5,25,4,4,24,,,,,7,6
2019-04-13 00:59,CAN,1545,737-800,20,6,30,5,5,28,,,,,10,8
2019-04-13 00:58,PEK,5580,737-800,19,6,22,6,7,28,,,,,3,9
2019-04-13 00:54,PEK ,5709,737-800,15,6,26,8,8,26,,,,,11,11
2019-04-13 00:54,KMG,7167,737-800,21,6,20,4,6,22,,,,,-1,1
2019-04-13 00:53,HRB,7395,737-800,12,6,18,6,6,21,,,,,6,9
2019-04-13 00:52,DLC,5713,737-800,12,6,22,6,6,20,,,,,10,8
2019-04-13 00:46,XIY,5428,737-800,15,4,20,8,8,30,,,,,5,15
2019-04-13 00:45,HAK,5712,737-800,28,1,29,2,2,31,,,,,1,3
2019-04-13 00:43,CAN,5638,737-800,20,4,29,3,4,29,,,,,9,9
2019-04-13 00:36,URC,205V,737-800,17,4,26,4,4,22,,,,,9,5
2019-04-13 00:34,HRB,1480,737-800,10,4,18,4,4,19,,,,,8,9
2019-04-13 00:34,KHG,1323,737-800,23,4,24,4,4,25,,,,,1,2
2019-04-13 00:24,CKG,7619,737-800,22,5,26,6,5,26,,,,,4,4
2019-04-13 00:22,SYX,1497,737-800,28,3,34,4,4,34,,,,,6,6
2019-04-13 00:18,HGH,5620,737-800,20,2,24,2,2,20,,,,,4,0
2019-04-13 00:18,HAK,1209,737-800,28,4,34,4,4,33,,,,,6,5
2019-04-13 00:17,XIY,5139,737-800,10,4,18,6,4,24,,,,,8,14
2019-04-13 00:11,CGO,7991,737-800,17,6,24,6,6,23,,,,,7,6
2019-04-13 00:10,HAK,5479,737-800,28,5,31,4,4,36,,,,,3,8
2019-04-13 00:10,CGO,5480,737-800,17,3,24,4,4,22,,,,,7,5
2019-04-13 00:02,KMG,1587,737-800,18,4,21,3,3,20,,,,,3,2
2019-04-13 00:01,SZX,7886,737-800,23,3,25,3,3,30,,,,,2,7
2019-04-13 00:00,HAK,1726,737-800,28,4,36,4,4,30,,,,,8,2
2019-04-12 23:57,DLC,7639,737-800,13,4,28,4,3,24,,,,,15,11
2019-04-12 23:53,SZX,5661,737-800,22,4,26,4,4,30,,,,,4,8
2019-04-12 23:52,XNN,5338,737-800,11,3,18,4,4,22,,,,,7,11
2019-04-12 23:51,HAK,5082,737-800,28,7,37,5,4,32,,,,,9,4
2019-04-12 23:49,XIY,5624,737-800,15,6,22,7,8,28,,,,,7,13
2019-04-12 23:47,HAK,1130,737-800,27,2,34,2,2,32,,,,,7,5
2019-04-12 23:45,CAN,1796,737-800,22,6,30,4,4,26,,,,,8,4
2019-04-12 23:38,HAK,5712,737-800,28,1,29,27,25,31,,,,,1,3
2019-04-12 23:37,PEK,1498,737-800,17,6,26,6,6,22,,,,,9,5
2019-04-12 23:32,URC,5611,737-800,20,6,26,6,6,28,,,,,6,8
2019-04-12 23:31,URC,205T,737-800,16,3,22,3,2,23,,,,,6,7
2019-04-12 23:31,HGH,7378,737-800,15,5,24,4,4,24,,,,,9,9
2019-04-12 23:24,CGO,6016,737-800,17,4,26,4,4,24,,,,,9,7
2019-04-12 23:23,CGO,206P,737-800,18,4,26,4,4,18,,,,,8,0
2019-04-12 23:23,XIY,5733,737-800,13,5,25,5,6,23,,,,,12,10
2019-04-12 23:21,HAK,1996,737-800,27,6,34,5,5,32,,,,,7,5
2019-04-12 23:18,HHA,7377,737-800,19,6,24,6,6,26,,,,,5,7
2019-04-12 23:17,HRB,1435,737-800,10,3,21,3,3,20,,,,,11,10
2019-04-12 23:14,PEK,1373,737-800,23,4,25,4,4,20,,,,,2,-3
2019-04-12 23:09,SYX,5855,737-800,25,4,32,4,4,28,,,,,7,3
2019-04-12 23:00,HHA,1487,737-800,23,3,24,3,2,22,,,,,1,-1
2019-04-12 22:56,URC,1325,737-800,17,4,19,4,4,19,,,,,2,2
2019-04-12 22:50,HAK,5686,737-800,29,4,34,5,5,33,,,,,5,4
2019-04-12 22:48,CAN,5375,737-800,20,3,24,4,4,24,,,,,4,4
2019-04-12 22:48,TYN,5687,737-800,14,3,22,4,4,23,,,,,8,9
2019-04-12 22:38,CAN,1727,737-800,20,5,30,5,5,24,,,,,10,4
2019-04-12 22:38,CAN,1496,737-800,20,5,31,5,5,31,,,,,11,11
2019-04-12 22:37,SYX,1729,737-800,26,4,30,4,4,30,,,,,4,4
2019-04-12 22:35,HAK,5372,737-800,28,8,34,9,9,33,,,,,6,5
2019-04-12 22:26,HAK,5662,737-800,28,3,32,3,4,31,,,,,4,3
2019-04-12 21:48,FOC,5182,737-800,17,2,26,3,4,23,,,,,9,6
2019-04-12 21:40,URC,1569,737-800,18,2,20,2,2,22,,,,,2,4
2019-04-12 21:39,HGH,1997,737-800,20,3,23,3,3,20,,,,,3,0
2019-04-12 21:38,HGH,1997,737-800,20,3,23,3,3,20,,,,,3,0
2019-04-12 21:35,XNN,7173,737-800,12,4,0,5,4,18,,,,,-12,6
2019-04-12 21:34,XNN,7173,737-800,12,4,0,5,4,18,,,,,-12,6
2019-04-12 21:10,PEK,1131,737-800,19,4,28,4,4,27,,,,,9,8
2019-04-12 20:01,HAK,5089,737-800,27,3,23,6,5,28,,,,,-4,1
2019-04-12 19:08,HGH,5135,737-800,18,3,25,2,2,23,,,,,7,5
2019-04-12 18:59,ÐìÖÝ,7989,737-800,15,6,26,7,6,24,,,,,11,9
2019-04-12 18:46,HRB,1905,737-800,16,4,22,4,4,18,,,,,6,2
2019-04-12 13:03,C?TU,7990,737-800,21,3,27,3,3,26,,,,,6,5
2019-04-12 12:48,MIG,5732,737-800,20,4,26,4,4,24,,,,,6,4
2019-04-12 12:40,PEK,1927,737-800,21,4,22,8,4,24,,,,,1,3
2019-04-12 12:00,YIH,1351,737-800,12,4,24,3,4,22,,,,,12,10
2019-04-12 10:03,KMG,7167,737-800,20,4,24,6,5,22,,,,,4,2
2019-04-12 09:55,SZX,1141,737-800,20,5,28,4,5,29,,,,,8,9
2019-04-12 08:57,KMG,1209,737-800,10,3,25,3,4,22,,,,,15,12
2019-04-12 07:57,CAN,5462,737-800,23,5,26,5,5,28,,,,,3,5
2019-04-12 07:57,HRB,1435,737-800,6,5,21,5,6,20,,,,,15,14
2019-04-12 07:56,HRB,1480,737-800,4,4,17,4,4,17,,,,,13,13
2019-04-12 07:54,HRB,1905,737-800,7,2,22,3,3,20,,,,,15,13
2019-04-12 07:53,HRB,1559,737-800,5,3,20,3,3,22,,,,,15,17
2019-04-12 07:50,HAK,5371,737-800,27,6,28,4,5,32,,,,,1,5
2019-04-12 07:45,KMG,1588,737-800,15,4,24,4,4,20,,,,,9,5
2019-04-12 07:43,KMG,7167,737-800,20,4,24,6,5,22,,,,,4,2
2019-04-12 07:40,HAK,1347,737-800,28,4,34,4,4,30,,,,,6,2
2019-04-12 07:30,PEK,5359,737-800,16,4,23,4,4,22,,,,,7,6
2019-04-12 07:08,FOC,7105,737-800,19,8,29,5,4,24,,,,,10,5
2019-04-12 06:35,XIY,7113,737-800,15,5,26,5,5,20,,,,,11,5
2019-04-12 06:21,DLC,1541,737-800,20,5,26,6,6,24,,,,,6,4
2019-04-12 06:17,KMG,1208,737-800,20,6,24,4,4,20,,,,,4,0
2019-04-12 06:16,HHA,1787,737-800,20,2,23,0,0,20,,,,,3,0
2019-04-12 05:56,XMN,6066,737-800,20,7,27,5,4,27,,,,,7,7
2019-04-12 05:56,XMN,5408,737-800,20,5,27,5,7,28,,,,,7,8
2019-04-12 05:55,XMN,5138,737-800,18,3,24,3,3,29,,,,,6,11
2019-04-12 05:54,XMN,7398,737-800,18,7,23,3,3,22,,,,,5,4
2019-04-12 05:53,CAN,1213,737-800,20,6,30,5,5,26,,,,,10,6
2019-04-12 05:51,SYX,5405,737-800,29,4,36,6,4,36,,,,,7,7
2019-04-12 05:51,CAN,5418,737-800,20,4,30,4,3,28,,,,,10,8
2019-04-12 05:41,TNA,5661,737-800,8,4,15,5,4,18,,,,,7,10
2019-04-12 05:34,XIY,5346,737-800,15,5,20,5,6,22,,,,,5,7
2019-04-12 05:27,KMG,7992,737-800,10,8,23,7,7,22,,,,,13,12
2019-04-12 05:22,SHA,5373,737-800,13,6,22,6,6,21,,,,,9,8
2019-04-12 05:21,SHA,5416,737-800,15,6,20,7,7,24,,,,,5,9
2019-04-12 05:20,URC,1568,737-800,15,4,20,6,6,20,,,,,5,5
2019-04-12 05:11,URC,2157,737-800,11,4,25,4,4,25,,,,,14,14
2019-04-12 05:08,HHA,7377,737-800,15,6,23,5,5,24,,,,,8,9
2019-04-12 05:07,HHA,7377,737-800,15,6,24,6,5,24,,,,,9,9
2019-04-12 05:00,HGH,1487,737-800,16,4,24,3,4,19,,,,,8,3
2019-04-12 04:59,KMG,5407,737-800,16,5,23,6,4,20,,,,,7,4
2019-04-12 04:59,SZX,1492,737-800,22,4,28,3,3,27,,,,,6,5
2019-04-12 04:53,HAK,1996,737-800,30,5,33,5,5,30,,,,,3,0
2019-04-12 04:45,CAN,1501,737-800,18,4,30,4,4,26,,,,,12,8
2019-04-12 04:39,HHA,1928,737-800,15,6,24,6,6,24,,,,,9,9
2019-04-12 04:38,CAN,5735,737-800,21,2,20,2,1,20,,,,,-1,-1
2019-04-12 04:36,HAK,1796,737-800,28,4,32,5,4,30,,,,,4,2
2019-04-12 04:23,HAK,5406,737-800,28,7,30,6,4,30,,,,,2,2
2019-04-12 04:20,XIY,5180,737-800,8,2,22,2,2,23,,,,,14,15
2019-04-12 04:16,SYX,5855,737-800,28,5,30,5,5,28,,,,,2,0
2019-04-12 04:14,URC,5289,737-800,18,4,26,4,4,25,,,,,8,7
2019-04-12 04:13,CAN,1538,737-800,21,2,27,4,3,25,,,,,6,4
2019-04-12 04:04,PEK,5539,737-800,14,5,22,6,6,27,,,,,8,13
2019-04-12 04:03,DLC,1797,737-800,11,3,24,4,4,20,,,,,13,9
2019-04-12 03:59,SYX ,206H,737-800,28,4,34,4,3,33,,,,,6,5
2019-04-12 03:57,HGH,5429,737-800,12,4,18,3,3,18,,,,,6,6
2019-04-12 03:57,CAN,5638,737-800,19,4,27,3,3,26,,,,,8,7
2019-04-12 03:56,XIY,1162,737-800,14,4,22,4,4,24,,,,,8,10
2019-04-12 03:47,PEK,5540,737-800,10,6,30,7,8,28,,,,,20,18
2019-04-12 03:46,FOC,7105,737-800,19,8,29,5,4,24,,,,,10,5
2019-04-12 03:44,HAK,1793,737-800,26,4,34,4,4,32,,,,,8,6
2019-04-12 03:42,HAK,5372,737-800,27,8,32,8,8,32,,,,,5,5
2019-04-12 03:41,HAK,5090,737-800,27,4,31,4,4,31,,,,,4,4
2019-04-12 03:39,HAK,7399,737-800,27,5,35,4,4,30,,,,,8,3
2019-04-12 03:34,,5405,737-800,29,4,36,6,4,36,,,,,7,7
2019-04-12 03:33,KMG,1587,737-800,20,3,18,4,3,18,,,,,-2,-2
2019-04-12 03:29,SZX,5620,737-800,21,2,30,2,4,26,,,,,9,5
2019-04-12 03:26,TYN,5662,737-800,8,3,18,3,4,18,,,,,10,10
2019-04-12 03:20,FOC ,1433,737-800,18,2,27,3,3,20,,,,,9,2
2019-04-12 03:19,HGH,1783,737-800,15,4,21,5,4,23,,,,,6,8
2019-04-12 03:19,URC,5502,737-800,15,5,21,5,4,20,,,,,6,5
2019-04-12 03:18,CAN,5465,737-800,20,3,28,2,3,28,,,,,8,8
2019-04-12 03:14,FOC,5182,737-800,16,4,25,4,4,21,,,,,9,5
2019-04-12 03:14,SZX,7616,737-800,20,4,26,4,4,28,,,,,6,8
2019-04-12 03:13,XIY,5430,737-800,15,8,28,5,6,27,,,,,13,12
2019-04-12 03:13,TYN,1491,737-800,5,4,24,3,4,23,,,,,19,18
2019-04-12 03:12,URC,6268,737-800,16,4,26,2,2,21,,,,,10,5
2019-04-12 03:08,URC,2159,737-800,15,6,18,4,2,19,,,,,3,4
2019-04-12 03:07,XIY,1903,737-800,15,2,20,2,2,24,,,,,5,9
2019-04-12 02:58,KMG,5409,737-800,10,2,20,2,2,20,,,,,10,10
2019-04-12 02:56,TYN,5713,737-800,8,6,22,6,6,22,,,,,14,14
2019-04-12 02:55,HAK,5371,737-800,27,6,28,4,5,32,,,,,1,5
2019-04-12 02:54,KMG,7989,737-800,15,6,24,6,5,21,,,,,9,6
2019-04-12 02:52,SYX,7378,737-800,28,5,31,5,5,32,,,,,3,4
2019-04-12 02:50,CKG,5581,737-800,20,5,20,6,5,27,,,,,0,7
2019-04-12 02:47,MIG,6809,737-800,20,4,24,4,4,24,,,,,4,4
2019-04-12 02:46,HGH,1733,737-800,15,3,22,3,3,18,,,,,7,3
2019-04-12 02:43,PEK,5153,737-800,13,2,22,6,4,20,,,,,9,7
2019-04-12 02:42,URC,5625,737-800,10,2,26,4,6,20,,,,,16,10
2019-04-12 02:41,SZX,7886,737-800,24,3,32,3,3,30,,,,,8,6
2019-04-12 02:38,URC,1322,737-800,15,4,24,3,3,22,,,,,9,7
2019-04-12 02:35,FOC,5503,737-800,16,4,24,4,4,25,,,,,8,9
2019-04-12 02:34,HGH,1503,737-800,15,2,24,3,3,20,,,,,9,5
2019-04-12 02:32,HHA,5580,737-800,15,6,22,6,6,26,,,,,7,11
2019-04-12 02:28,HAK,5358,737-800,27,8,32,8,8,32,,,,,5,5
2019-04-12 02:23,URC,1995,737-800,15,3,23,3,4,21,,,,,8,6
2019-04-12 02:19,XIY,1163,737-800,16,3,25,2,2,23,,,,,9,7
2019-04-12 02:15,CAN,5478,737-800,19,4,30,4,4,24,,,,,11,5
2019-04-12 02:14,ZGC,1497,737-800,10,7,21,7,6,22,,,,,11,12
2019-04-12 02:14,HHA,2647,737-800,15,2,18,4,4,20,,,,,3,5
2019-04-12 02:09,HAK,7172,737-800,27,4,34,5,4,32,,,,,7,5
2019-04-12 02:09,XIY,1161,737-800,16,3,29,4,3,28,,,,,13,12
2019-04-12 02:09,CAN,5375,737-800,21,1,20,4,3,22,,,,,-1,1
2019-04-12 02:08,FOC,1562,737-800,15,4,27,4,4,26,,,,,12,11
2019-04-12 02:01,CGO,7993,737-800,15,5,25,5,5,22,,,,,10,7
2019-04-12 01:58,URC,5636,737-800,16,4,24,5,4,22,,,,,8,6
2019-04-12 01:55,XIY,1728,737-800,15,4,20,5,5,20,,,,,5,5
2019-04-12 01:52,FOC,1386,737-800,18,5,21,5,6,30,,,,,3,12
2019-04-12 01:51,HGH,5136,737-800,15,4,22,5,5,23,,,,,7,8
2019-04-12 01:50,PEK,5539,737-800,14,5,22,6,6,227,,,,,8,213
2019-04-12 01:47,PEK,5538,737-800,12,4,27,0,1,26,,,,,15,14
2019-04-12 01:46,CGO,1495,737-800,14,3,23,4,3,23,,,,,9,9
2019-04-12 01:41,TYN ,1215,737-800,10,4,25,4,4,20,,,,,15,10
2019-04-12 01:39,XIY,5797,737-800,15,4,19,4,4,22,,,,,4,7
2019-04-12 01:38,SZX,5687,737-800,22,4,30,4,5,30,,,,,8,8
2019-04-12 01:33,DLC,1488,737-800,12,5,27,3,3,21,,,,,15,9
2019-04-12 01:33,XIY,1101,737-800,15,3,32,2,2,22,,,,,17,7
2019-04-12 01:33,URC,7400,737-800,10,6,24,4,4,20,,,,,14,10
2019-04-12 01:32,KMG,7988,737-800,10,5,23,6,5,23,,,,,13,13
2019-04-12 01:31,XIY,5115,737-800,16,5,24,5,6,24,,,,,8,8
2019-04-12 01:28,HAK,1727,737-800,28,5,36,5,5,29,,,,,8,1
2019-04-12 01:26,XIY,5623,737-800,15,4,22,4,5,20,,,,,7,5
2019-04-12 01:25,URC,1735,737-800,15,4,24,4,4,21,,,,,9,6
2019-04-12 01:25,XIY,1548,737-800,14,4,22,2,2,20,,,,,8,6
2019-04-12 01:22,PEK,5463,737-800,16,7,24,7,7,19,,,,,8,3
2019-04-12 01:21,SZX,1505,737-800,21,4,30,4,4,26,,,,,9,5
2019-04-12 01:20,HGH,5135,737-800,20,2,26,4,2,24,,,,,6,4
2019-04-12 01:17,SZX,1785,737-800,21,2,30,7,7,28,,,,,9,7
2019-04-12 01:16,URC ,5139,737-800,15,4,20,4,3,21,,,,,5,6
2019-04-12 01:15,HHA,6063,737-800,15,5,24,4,4,24,,,,,9,9
2019-04-12 01:11,SYX,BX1729,737-800,28,4,30,5,5,30,,,,,2,2
2019-04-12 01:10,ZGC,5467,737-800,10,7,18,6,5,20,,,,,8,10
2019-04-12 01:08,CGO,5480,737-800,15,3,22,4,2,23,,,,,7,8
2019-04-12 01:07,URC,5611,737-800,16,6,26,6,7,27,,,,,10,11
2019-04-12 01:06,URC,205U,737-800,17,3,25,2,2,26,,,,,8,9
2019-04-12 01:05,URC,1372,737-800,18,4,23,2,3,20,,,,,5,2
2019-04-12 01:02,HHA,5852,737-800,16,4,22,4,5,22,,,,,6,6
2019-04-12 01:02,WUT,5337,737-800,11,2,18,4,3,16,,,,,7,5
2019-04-12 00:59,PEK,PEK5709,737-800,13,6,30,6,4,28,,,,,17,15
2019-04-12 00:58,HGH,1929,737-800,15,4,22,4,4,21,,,,,7,6
2019-04-12 00:55,HHA,1549,737-800,18,4,24,5,5,22,,,,,6,4
2019-04-12 00:55,DLC,5417,737-800,11,5,23,5,4,20,,,,,12,9
2019-04-12 00:55,Î÷°²,5579,737-800,18,6,26,6,6,26,,,,,8,8
2019-04-12 00:54,Î÷°²,5116,737-800,16,4,20,4,4,20,,,,,4,4
2019-04-12 00:51,HAK,1373,737-800,27,4,32,4,4,30,,,,,5,3
2019-04-12 00:49,CKG,7619,737-800,20,7,23,6,5,26,,,,,3,6
2019-04-12 00:48,DLC,1102,737-800,10,2,23,4,4,22,,,,,13,12
2019-04-12 00:46,CGO,7991,737-800,14,6,25,6,6,22,,,,,11,8
2019-04-12 00:36,SHE,2158,737-800,11,4,16,4,5,18,,,,,5,7
2019-04-12 00:32,HHA,6060,737-800,17,6,28,5,6,26,,,,,11,9
2019-04-12 00:32,FOC,5503,737-800,16,4,24,4,4,25,,,,,8,9
2019-04-12 00:30,SYX,1489,737-800,28,4,32,4,4,32,,,,,4,4
2019-04-12 00:28,XIY,5522,737-800,14,3,23,3,4,25,,,,,9,11
2019-04-12 00:27,SYX,BX1490,737-800,28,6,33,6,6,32,,,,,5,4
2019-04-12 00:24,PEK,5482,737-800,15,2,18,6,4,22,,,,,3,7
2019-04-12 00:22,FOC,1350,737-800,18,3,23,3,4,25,,,,,5,7
2019-04-12 00:17,URC,6062,737-800,15,3,21,4,4,22,,,,,6,7
2019-04-12 00:16,URC,205V,737-800,16,2,24,3,3,21,,,,,8,5
2019-04-12 00:11,MIG,1798,737-800,20,6,26,6,6,26,,,,,6,6
2019-04-12 00:10,MIG,5732,737-800,20,4,25,3,3,24,,,,,5,4
2019-04-12 00:10,DLC,1103,737-800,11,4,22,6,7,24,,,,,11,13
2019-04-12 00:10,HAK,1375,737-800,27,4,32,4,4,30,,,,,5,3
2019-04-12 00:09,HGH,1493,737-800,13,6,21,6,6,20,,,,,8,7
2019-04-12 00:01,SZX,7171,737-800,22,4,30,4,4,30,,,,,8,8
2019-04-12 00:01,XIY,5733,737-800,16,5,22,5,6,24,,,,,6,8
2019-04-11 23:55,CTU,5248,737-800,20,0,8,0,0,4,,,,,-12,-16
2019-04-11 23:50,XIY,5521,737-800,10,2,24,2,4,22,,,,,14,12
2019-04-11 23:50,HAK,5686,737-800,28,5,34,5,5,31,,,,,6,3
2019-04-11 23:50,CGO,206P,737-800,14,4,27,4,4,24,,,,,13,10
2019-04-11 23:48,HAK,5479,737-800,27,5,31,6,6,34,,,,,4,7
2019-04-11 23:42,URC,5637,737-800,8,2,24,2,2,20,,,,,16,12
2019-04-11 23:39,CAN,1498,737-800,23,6,30,6,6,26,,,,,7,3
2019-04-11 23:38,DLC,1346,737-800,10,6,26,4,4,20,,,,,16,10
2019-04-11 23:31,CAN,1130,737-800,20,3,28,2,2,28,,,,,8,8
2019-04-11 23:25,HAK,6065,737-800,27,4,35,4,4,34,,,,,8,7
2019-04-11 23:24,HAK,206F,737-800,27,3,34,3,3,30,,,,,7,3
2019-04-11 23:12,PEK,1496,737-800,15,8,30,6,7,28,,,,,15,13
2019-04-11 23:09,PEK,1786,737-800,15,5,22,5,4,18,,,,,7,3
2019-04-11 23:01,URC,1325,737-800,15,4,21,4,5,22,,,,,6,7
2019-04-11 22:56,SYX,BX1502,737-800,28,4,33,4,4,32,,,,,5,4
2019-04-11 22:53,HAK,5089,737-800,29,3,28,1,1,34,,,,,-1,5
2019-04-11 22:52,TYN,6103,737-800,10,9,28,8,9,22,,,,,18,12
2019-04-11 22:48,HAK,6808,737-800,28,4,30,4,4,32,,,,,2,4
2019-04-11 22:46,º£¿Ú,1545,737-800,27,5,35,6,5,30,,,,,8,3
2019-04-11 22:44,URC,205T,737-800,12,3,28,3,3,25,,,,,16,13
2019-04-11 22:43,FOC,1906,737-800,15,7,28,6,6,27,,,,,13,12
2019-04-11 22:43,CKG,7618,737-800,20,4,26,4,3,25,,,,,6,5
2019-04-11 22:41,URC,1323,737-800,15,2,25,3,3,25,,,,,10,10
2019-04-11 22:40,XNN,5338,737-800,10,4,18,4,4,22,,,,,8,12
2019-04-11 22:35,PEK,1786,737-800,15,5,22,5,4,18,,,,,7,3
2019-04-11 22:32,PEK,1725,737-800,15,2,24,2,3,22,,,,,9,7
2019-04-11 22:25,XIY,5428,737-800,20,2,20,4,4,30,,,,,0,10
2019-04-11 22:21,DLC,7639,737-800,12,6,28,6,6,24,,,,,16,12
2019-04-11 22:21,HGH,5429,737-800,12,4,18,3,3,18,,,,,6,6
2019-04-11 22:11,DLC,5439,737-800,13,4,22,4,4,20,,,,,9,7
2019-04-11 22:04,XNN,7173,737-800,10,4,0,5,4,18,,,,,-10,8
2019-04-11 22:03,HAK,5853,737-800,28,6,30,4,6,28,,,,,2,0
2019-04-11 21:44,XUZ,6800,737-800,15,6,23,3,4,23,,,,,8,8
2019-04-11 21:44,SYX,5520,737-800,29,6,36,6,6,34,,,,,7,5
2019-04-11 20:32,W113,1799,737-800,20,5,26,4,5,27,,,,,6,7
2019-04-11 20:23,HAK,206G,737-800,29,4,36,2,2,32,,,,,7,3
2019-04-11 17:39,XIY,5712,737-800,22,1,20,4,2,18,,,,,-2,-4
2019-04-11 17:16,KMG,6015,737-800,23,6,24,5,4,23,,,,,1,0
2019-04-11 15:42,URC,7198,737-800,19,6,22,4,6,22,,,,,3,3
2019-04-11 09:30,CTU,7990,737-800,18,3,27,3,3,25,,,,,9,7
2019-04-11 08:49,FOC,1433,737-800,14,3,26,3,3,20,,,,,12,6
2019-04-11 08:49,HHA,5852,737-800,10,6,9,4,4,8,,,,,-1,-2
2019-04-11 08:33,HAK,5358,737-800,28,6,30,6,6,31,,,,,2,3
2019-04-11 08:14,KMG ,1209,737-800,18,4,28,4,4,22,,,,,10,4
2019-04-11 08:07,PEK,1997,737-800,13,3,24,3,3,18,,,,,11,5
2019-04-11 08:04,HAK,6065,737-800,28,5,36,5,5,32,,,,,8,4
2019-04-11 07:52,KMG ,6809 ,737-800,17,4,20,6,6,22,,,,,3,5
2019-04-11 07:13,SZX,7886,737-800,26,3,30,4,4,33,,,,,4,7
2019-04-11 07:01,HAK,1347,737-800,25,4,32,4,4,30,,,,,7,5
2019-04-11 06:50,SYX,2158,737-800,28,8,28,4,4,29,,,,,0,1
2019-04-11 06:48,FOC,7105,737-800,14,3,23,2,3,21,,,,,9,7
2019-04-11 06:33,XIY ,1903,737-800,10,4,26,6,6,24,,,,,16,14
2019-04-11 06:31,XMN,1497,737-800,19,5,26,3,4,28,,,,,7,9
2019-04-11 06:31,XMN,5373,737-800,18,9,32,8,8,30,,,,,14,12
2019-04-11 06:30,XMN,6066,737-800,20,6,30,4,4,28,,,,,10,8
2019-04-11 06:29,XMN,5141,737-800,20,8,28,6,9,30,,,,,8,10
2019-04-11 06:26,URC,205T,737-800,16,3,24,3,3,24,,,,,8,8
2019-04-11 06:14,KHG,206P,737-800,20,4,24,4,3,23,,,,,4,3
2019-04-11 06:00,FOC,5182,737-800,15,3,25,3,3,21,,,,,10,6
2019-04-11 05:56,XIY,11622,737-800,15,4,26,5,6,27,,,,,11,12
2019-04-11 05:49,URC,7400,737-800,16,5,24,5,5,20,,,,,8,4
2019-04-11 05:43,KMG,5409,737-800,16,4,24,5,4,25,,,,,8,9
2019-04-11 05:06,PEK ,5408,737-800,23,4,24,4,4,20,,,,,1,-3
2019-04-11 05:04,URC,7398,737-800,15,3,22,4,4,19,,,,,7,4
2019-04-11 05:04,URC,2159,737-800,15,8,18,4,4,18,,,,,3,3
2019-04-11 04:44,URC,1995,737-800,16,5,20,6,6,23,,,,,4,7
2019-04-11 04:43,SYX,1502,737-800,25,3,33,5,5,32,,,,,8,7
2019-04-11 04:37,URC,1995,737-800,16,5,20,6,6,23,,,,,4,7
2019-04-11 04:35,HAK,1793,737-800,26,5,34,5,5,30,,,,,8,4
2019-04-11 04:32,CGO,7167,737-800,11,5,24,5,5,21,,,,,13,10
2019-04-11 04:29,HAK,6061,737-800,28,4,30,5,4,30,,,,,2,2
2019-04-11 04:28,HAK,5136,737-800,28,4,32,4,4,34,,,,,4,6
2019-04-11 04:28,HAK,1796,737-800,28,5,35,5,5,32,,,,,7,4
2019-04-11 04:21,PEK,5539,737-800,15,4,21,5,5,23,,,,,6,8
2019-04-11 04:13,HAK,5089,737-800,26,2,28,0,1,32,,,,,2,6
2019-04-11 04:04,CAN,1786,737-800,27,4,32,4,4,28,,,,,5,1
2019-04-11 03:57,KMG,6015,737-800,17,6,20,4,4,20,,,,,3,3
2019-04-11 03:54,HAK,1793,737-800,26,5,34,5,5,30,,,,,8,4
2019-04-11 03:54,URC,1372,737-800,15,8,21,6,5,20,,,,,6,5
2019-04-11 03:48,XIY,5522,737-800,12,5,24,5,4,22,,,,,12,10
2019-04-11 03:45,FOC,1350,737-800,14,3,28,8,6,27,,,,,14,13
2019-04-11 03:44,URC,6268,737-800,15,5,24,3,4,22,,,,,9,7
2019-04-11 03:38,HAK,1545,737-800,27,4,34,4,4,32,,,,,7,5
2019-04-11 03:29,CAN,2647,737-800,27,5,26,8,8,26,,,,,-1,-1
2019-04-11 03:27,MIG,1208,737-800,15,3,25,3,3,23,,,,,10,8
2019-04-11 03:26,URC,1323,737-800,16,3,22,3,3,25,,,,,6,9
2019-04-11 03:22,HGH,5337,737-800,12,4,12,3,3,13,,,,,0,1
2019-04-11 03:18,KMG,1587,737-800,15,3,20,4,3,20,,,,,5,5
2019-04-11 03:15,CAN,5478,737-800,27,4,35,5,4,31,,,,,8,4
2019-04-11 03:14,FOC,5709,737-800,19,6,27,6,6,24,,,,,8,5
2019-04-11 03:09,HHA,1787,737-800,11,0,6,0,0,10,,,,,-5,-1
2019-04-11 03:08,FOC,1433,737-800,14,3,26,3,3,20,,,,,12,6
2019-04-11 03:08,HHA,1887,737-800,11,0,0,0,0,0,,,,,-11,-11
2019-04-11 03:07,HAK,206F,737-800,27,2,32,3,3,30,,,,,5,3
2019-04-11 03:07,PEK,5482,737-800,18,2,16,2,4,30,,,,,-2,12
2019-04-11 03:06,HHA,1928,737-800,15,4,20,5,5,20,,,,,5,5
2019-04-11 03:05,HAK,5686,737-800,26,6,32,6,5,30,,,,,6,4
2019-04-11 03:04,ZGC,1490,737-800,8,9,26,9,8,28,,,,,18,20
2019-04-11 02:58,URC,7175,737-800,10,4,22,4,4,22,,,,,12,12
2019-04-11 02:57,HAK,5090,737-800,26,1,31,3,4,31,,,,,5,5
2019-04-11 02:54,FOC,5503,737-800,14,4,24,4,4,24,,,,,10,10
2019-04-11 02:52,HAK,5407,737-800,26,6,34,6,4,33,,,,,8,7
2019-04-11 02:52,SZX,1547,737-800,26,6,30,5,6,31,,,,,4,5
2019-04-11 02:41,CKG,5732,737-800,17,4,22,4,3,20,,,,,5,3
2019-04-11 02:39,SZX,1492,737-800,25,4,34,3,3,31,,,,,9,6
2019-04-11 02:38,SZX,5620,737-800,26,5,31,5,5,32,,,,,5,6
2019-04-11 02:36,HGH,5429,737-800,12,3,16,2,2,18,,,,,4,6
2019-04-11 02:34,URC,205V,737-800,15,5,24,4,4,20,,,,,9,5
2019-04-11 02:32,HHA,1375,737-800,10,3,22,3,4,22,,,,,12,12
2019-04-11 02:31,CAN,1538,737-800,27,3,32,5,3,31,,,,,5,4
2019-04-11 02:30,XIY,5479,737-800,12,5,22,5,5,22,,,,,10,10
2019-04-11 02:30,SYX,5520,737-800,25,5,25,3,2,30,,,,,0,5
2019-04-11 02:30,SYX,1373,737-800,27,2,34,4,4,28,,,,,7,1
2019-04-11 02:30,HAK,1542,737-800,28,4,32,6,4,31,,,,,4,3
2019-04-11 02:29,HHA,6060,737-800,12,5,23,5,5,21,,,,,11,9
2019-04-11 02:29,XIY,1482,737-800,15,5,29,4,5,28,,,,,14,13
2019-04-11 02:29,CAN,1726,737-800,27,4,32,4,4,30,,,,,5,3
2019-04-11 02:27,CGO,6016,737-800,11,5,25,4,4,24,,,,,14,13
2019-04-11 02:24,XIY,5430,737-800,13,5,25,5,5,24,,,,,12,11
2019-04-11 02:24,HAK,1503,737-800,26,1,30,4,4,30,,,,,4,4
2019-04-11 02:20,KMG,7988,737-800,15,4,22,6,5,23,,,,,7,8
2019-04-11 02:19,PEK,5371,737-800,16,8,19,5,6,23,,,,,3,7
2019-04-11 02:16,HHA,5580,737-800,15,4,25,4,4,25,,,,,10,10
2019-04-11 02:15,PEK,5439,737-800,15,4,21,4,4,22,,,,,6,7
2019-04-11 02:15,CGO,1588,737-800,10,4,22,5,4,19,,,,,12,9
2019-04-11 02:12,KMG,7993,737-800,17,5,23,5,6,23,,,,,6,6
2019-04-11 02:12,URC,5637,737-800,17,2,23,3,2,19,,,,,6,2
2019-04-11 02:09,HHA,5638,737-800,11,4,21,2,3,19,,,,,10,8
2019-04-11 02:08,URC,2157,737-800,16,4,22,8,8,24,,,,,6,8
2019-04-11 02:08,SYX,206H,737-800,27,3,32,3,2,32,,,,,5,5
2019-04-11 02:06,XIY,1161,737-800,10,3,23,2,3,20,,,,,13,10
2019-04-11 02:03,CAN,1501,737-800,28,4,34,5,4,30,,,,,6,2
2019-04-11 01:59,´óÁ¬,1496,737-800,9,5,26,5,5,25,,,,,17,16
2019-04-11 01:57,HAK,5687,737-800,28,6,20,4,4,36,,,,,-8,8
2019-04-11 01:52,PEK,5636,737-800,15,5,24,5,4,24,,,,,9,9
2019-04-11 01:51,XIY,5180,737-800,12,6,23,7,6,22,,,,,11,10
2019-04-11 01:51,URC,6995,737-800,18,4,22,4,4,18,,,,,4,0
2019-04-11 01:50,URC,5359,737-800,16,4,22,5,6,22,,,,,6,6
2019-04-11 01:50,CKG,5855,737-800,18,6,25,6,6,22,,,,,7,4
2019-04-11 01:48,HAK,5661,737-800,28,5,32,5,4,33,,,,,4,5
2019-04-11 01:46,HGH ,5135,737-800,19,2,24,2,2,22,,,,,5,3
2019-04-11 01:45,YIH,1351,737-800,11,4,23,4,4,20,,,,,12,9
2019-04-11 01:43,SZX,7172,737-800,26,6,23,6,4,22,,,,,-3,-4
2019-04-11 01:43,XIY,1728,737-800,12,4,20,4,4,20,,,,,8,8
2019-04-11 01:43,ZGC,5138,737-800,7,9,20,9,8,22,,,,,13,15
2019-04-11 01:43,SYX,5480,737-800,25,5,32,5,3,31,,,,,7,6
2019-04-11 01:42,XIY,1725,737-800,15,5,29,4,5,31,,,,,14,16
2019-04-11 01:41,HHA,1549,737-800,13,4,23,5,5,23,,,,,10,10
2019-04-11 01:40,XIY,7113,737-800,12,3,22,4,4,24,,,,,10,12
2019-04-11 01:40,CAN,1498,737-800,28,6,32,6,6,30,,,,,4,2
2019-04-11 01:37,HAK,1996,737-800,26,5,31,5,6,30,,,,,5,4
2019-04-11 01:36,URC,5611,737-800,16,4,12,5,6,14,,,,,-4,-2
2019-04-11 01:35,SZX,1505,737-800,27,4,32,4,4,30,,,,,5,3
2019-04-11 01:34,DLC,1346,737-800,10,7,28,5,6,28,,,,,18,18
2019-04-11 01:29,XIY,1902,737-800,12,7,28,6,6,24,,,,,16,12
2019-04-11 01:28,FOC,1562,737-800,18,4,25,4,4,25,,,,,7,7
2019-04-11 01:26,CAN,5406,737-800,25,8,28,4,6,30,,,,,3,5
2019-04-11 01:20,URC,1569,737-800,15,5,13,2,3,12,,,,,-2,-3
2019-04-11 01:19,HAK,1545,737-800,27,4,34,4,4,30,,,,,7,3
2019-04-11 01:18,PEK,1103,737-800,17,4,30,4,4,22,,,,,13,5
2019-04-11 01:18,XIY,1163,737-800,15,2,28,4,2,30,,,,,13,15
2019-04-11 01:17,PEK,1103,737-800,17,4,30,4,4,22,,,,,13,5
2019-04-11 01:17,HAK,6065,737-800,27,5,36,5,5,32,,,,,9,5
2019-04-11 01:15,DLC,1102,737-800,10,4,24,6,6,26,,,,,14,16
2019-04-11 01:14,HRB,1480,737-800,6,4,17,4,4,16,,,,,11,10
2019-04-11 01:11,DLC,1496,737-800,9,5,26,5,5,25,,,,,17,16
2019-04-11 01:11,URC,5637,737-800,17,2,23,21,22,19,,,,,6,2
2019-04-11 01:09,URC,5853,737-800,17,6,22,5,6,21,,,,,5,4
2019-04-11 01:06,XIY,5116,737-800,12,4,20,4,4,18,,,,,8,6
2019-04-11 01:05,DLC,7639,737-800,11,6,26,6,6,22,,,,,15,11
2019-04-11 01:03,XIY,5417,737-800,14,4,20,4,4,23,,,,,6,9
2019-04-11 00:54,SYX,7378,737-800,27,3,33,5,6,32,,,,,6,5
2019-04-11 00:54,HAK,5405,737-800,27,5,36,6,5,35,,,,,9,8
2019-04-11 00:50,HAK,6103,737-800,29,7,32,6,6,31,,,,,3,2
2019-04-11 00:50,TYN,1491,737-800,10,3,20,8,8,30,,,,,10,20
2019-04-11 00:49,HGH,5465,737-800,20,1,22,3,3,23,,,,,2,3
2019-04-11 00:49,YIH,1348,737-800,11,3,20,4,4,18,,,,,9,7
2019-04-11 00:47,HGH,1727,737-800,15,4,19,4,4,18,,,,,4,3
2019-04-11 00:46,CGO,7618,737-800,10,6,24,5,5,20,,,,,14,10
2019-04-11 00:44,HGH,1733,737-800,20,2,20,1,2,20,,,,,0,0
2019-04-11 00:41,HRB,1905,737-800,6,3,21,3,3,18,,,,,15,12
2019-04-11 00:34,HAK,6808,737-800,27,4,34,6,5,31,,,,,7,4
2019-04-11 00:33,HGH,1783,737-800,16,7,24,6,5,23,,,,,8,7
2019-04-11 00:31,HAK,5082,737-800,30,4,34,5,4,32,,,,,4,2
2019-04-11 00:31,URC,5502,737-800,15,4,12,4,4,14,,,,,-3,-1
2019-04-11 00:31,SZX,5428,737-800,26,4,30,6,5,33,,,,,4,7
2019-04-11 00:29,CGO,1495,737-800,11,4,22,4,4,20,,,,,11,9
2019-04-11 00:27,CAN,1548,737-800,28,4,30,4,4,31,,,,,2,3
2019-04-11 00:23,TYN,1215,737-800,10,4,24,4,5,20,,,,,14,10
2019-04-11 00:19,DLC,1797,737-800,10,4,24,3,4,22,,,,,14,12
2019-04-11 00:18,104,1130,737-800,16,2,26,2,2,21,,,,,10,5
2019-04-11 00:17,HAK,5579,737-800,28,6,35,6,6,32,,,,,7,4
2019-04-11 00:15,URC,1325,737-800,17,2,23,2,3,19,,,,,6,2
2019-04-11 00:14,XIY,5733,737-800,12,6,20,6,6,24,,,,,8,12
2019-04-11 00:12,URC,1568,737-800,15,5,23,6,6,23,,,,,8,8
2019-04-11 00:11,SZX,1785,737-800,26,0,32,8,8,34,,,,,6,8
2019-04-11 00:10,FOC,1906,737-800,17,6,30,5,6,25,,,,,13,8
2019-04-11 00:09,XIY,5712,737-800,15,2,20,2,2,19,,,,,5,4
2019-04-11 00:08,ÃàÑô,5732,737-800,20,4,24,4,3,24,,,,,4,4
2019-04-11 00:05,URC,6062,737-800,15,4,20,4,4,21,,,,,5,6
2019-04-11 00:02,CAN,5735,737-800,29,2,26,2,3,27,,,,,-3,-2
2019-04-10 23:57,URC,1735,737-800,16,4,22,4,4,20,,,,,6,4
2019-04-10 23:51,HRB,7395,737-800,7,6,22,6,6,20,,,,,15,13
2019-04-10 23:48,XIY,5462,737-800,10,4,20,4,6,22,,,,,10,12
2019-04-10 23:44,URC,1570,737-800,16,4,20,5,5,19,,,,,4,3
2019-04-10 23:43,PEK,5416,737-800,20,6,22,6,5,22,,,,,2,2
2019-04-10 23:43,HAK,206G,737-800,28,2,35,3,3,30,,,,,7,2
2019-04-10 23:38,´óÁ¬,5346,737-800,9,6,20,4,4,22,,,,,11,13
2019-04-10 23:36,HHA,5852,737-800,10,11,10,5,4,8,,,,,0,-2
2019-04-10 23:35,CGO,205U,737-800,18,4,25,4,4,22,,,,,7,4
2019-04-10 23:28,SYX,1489,737-800,28,4,31,4,4,30,,,,,3,2
2019-04-10 23:28,PEK,1131,737-800,24,2,28,4,4,26,,,,,4,2
2019-04-10 23:27,HGH,5467,737-800,13,2,22,6,3,20,,,,,9,7
2019-04-10 23:25,URC,1322,737-800,17,4,22,4,4,23,,,,,5,6
2019-04-10 23:24,HHA,1799,737-800,13,4,26,4,4,25,,,,,13,12
2019-04-10 23:16,CGO,7991,737-800,12,4,23,4,5,20,,,,,11,8
2019-04-10 23:11,XIY,5623,737-800,14,6,24,6,4,22,,,,,10,8
2019-04-10 23:03,HGH,5625,737-800,13,4,20,4,4,21,,,,,7,8
2019-04-10 23:02,XIY,5797,737-800,20,6,17,5,5,23,,,,,-3,3
2019-04-10 22:55,KMG,7989,737-800,18,5,24,6,5,23,,,,,6,5
2019-04-10 22:51,HRB,1435,737-800,11,6,23,5,5,20,,,,,12,9
2019-04-10 22:45,HAK,7992,737-800,29,7,32,8,7,31,,,,,3,2
2019-04-10 22:44,SYX,5520,737-800,25,5,36,5,5,32,,,,,11,7
2019-04-10 22:41,XIY,1101,737-800,12,4,32,4,4,28,,,,,20,16
2019-04-10 22:34,URC,1325,737-800,17,2,23,3,2,19,,,,,6,2
2019-04-10 22:31,PEK,1386,737-800,15,3,22,4,4,18,,,,,7,3
2019-04-10 22:28,CAN,6063,737-800,27,6,32,6,6,31,,,,,5,4
2019-04-10 22:27,DLC,5521,737-800,11,4,18,2,4,15,,,,,7,4
2019-04-10 22:24,URC,1325,737-800,18,2,23,2,3,19,,,,,5,1
2019-04-10 22:23,XNN,5463,737-800,10,5,22,5,4,16,,,,,12,6
2019-04-10 22:05,HAK,5375,737-800,27,2,33,8,8,34,,,,,6,7
2019-04-10 22:00,ÃàÑô,1798,737-800,20,4,26,5,5,23,,,,,6,3
2019-04-10 21:59,TYN,1795,737-800,18,2,20,4,4,20,,,,,2,2
2019-04-10 21:37,XNN,7173,737-800,10,4,0,5,4,18,,,,,-10,8
2019-04-10 21:35,CAN,1213,737-800,30,8,34,6,8,34,,,,,4,4
2019-04-10 21:17,DLC,1488,737-800,11,5,26,5,6,20,,,,,15,9
2019-04-10 20:53,XUZ,1141,737-800,15,3,23,3,3,23,,,,,8,8
2019-04-10 20:14,PEK,5540,737-800,18,6,28,4,4,26,,,,,10,8
2019-04-10 19:18,HRB,1559,737-800,12,3,23,3,2,24,,,,,11,12
2019-04-10 19:00,DLC,1541,737-800,12,6,26,6,5,22,,,,,14,10
2019-04-10 18:34,HAK,5713,737-800,31,5,29,4,5,28,,,,,-2,-3
2019-04-10 17:14,XUZ,6800,737-800,15,2,20,1,1,20,,,,,5,5
2019-04-10 16:15,HAK,7399,737-800,36,5,32,3,4,30,,,,,-4,-6
2019-04-10 14:40,URC,5637,737-800,14,1,20,2,4,24,,,,,6,10
2019-04-10 14:39,URC,7175,737-800,14,6,24,4,4,22,,,,,10,8
2019-04-10 13:01,CAN,1796,737-800,30,6,34,5,5,30,,,,,4,0
2019-04-10 11:36,URC,6268,737-800,15,2,20,2,2,20,,,,,5,5
2019-04-10 10:51,CTU,7990,737-800,20,4,26,4,3,25,,,,,6,5
2019-04-10 09:44,PEK,5538,737-800,5,9,30,3,3,28,,,,,25,23
2019-04-10 09:11,SZX,5623,737-800,25,5,33,5,5,29,,,,,8,4
2019-04-10 09:10,SZX,1141,737-800,25,4,33,5,5,29,,,,,8,4
2019-04-10 08:29,SZX,5417,737-800,26,6,30,5,5,32,,,,,4,6
2019-04-10 08:28,SZX,5426,737-800,26,4,30,4,3,30,,,,,4,4
2019-04-10 08:27,SZX,1545,737-800,26,5,33,5,5,36,,1,,1,7,10
2019-04-10 08:27,SZX,6103,737-800,26,6,31,5,5,34,,,,,5,8
2019-04-10 08:21,KMG,6800,737-800,17,4,23,5,4,22,,,,,6,5
2019-04-10 08:18,SZX,7886,737-800,25,4,35,4,5,32,1,,,1,10,7
2019-04-10 08:13,PEK,5540,737-800,15,5,30,5,5,26,,,,,15,11
2019-04-10 08:04,DLC,1102,737-800,12,6,24,7,7,27,,,,,12,15
2019-04-10 07:50,ÉîÛÚ,1545,737-800,26,5,33,5,5,36,,,,,7,10
2019-04-10 07:48,ÉîÛÚ,6103,737-800,26,6,31,5,5,34,,,,,5,8
2019-04-10 07:47,ÉîÛÚ,5429,737-800,26,4,30,4,3,30,,,,,4,4
2019-04-10 07:29,ÉîÛÚ,5417,737-800,26,6,30,5,5,32,,,,,4,6
2019-04-10 07:29,KMG,1208,737-800,20,3,24,4,3,21,,,,,4,1
2019-04-10 06:54,SYX,206H,737-800,27,4,32,2,2,32,,,,,5,5
2019-04-10 06:48,SYX,206,737-800,27,4,32,2,2,32,,,,,5,5
2019-04-10 06:31,FOC,7105,737-800,23,4,30,4,4,28,,,,,7,5
2019-04-10 06:29,HAK,5463,737-800,27,6,31,4,5,27,,,,,4,0
2019-04-10 06:28,HAK,1495,737-800,30,4,31,4,5,30,,,,,1,0
2019-04-10 06:27,HAK,1542,737-800,25,5,34,4,4,32,,,,,9,7
2019-04-10 06:27,HAK,5089,737-800,25,5,26,2,2,32,,,,,1,7
2019-04-10 06:02,HAK,5372,737-800,25,8,29,8,7,28,,,,,4,3
2019-04-10 06:01,HAK,1729,737-800,25,4,28,5,4,25,,,,,3,0
2019-04-10 05:59,KMG,1209,737-800,20,4,28,4,4,22,,,,,8,2
2019-04-10 05:53,URC,5502,737-800,10,4,24,5,4,21,,,,,14,11
2019-04-10 05:38,HGH,5625,737-800,10,4,24,4,4,20,,,,,14,10
2019-04-10 05:33,PEK,5636,737-800,15,4,22,5,4,23,,,,,7,8
2019-04-10 05:21,URC,2157,737-800,15,2,20,5,7,24,,,,,5,9
2019-04-10 05:21,URC,1372,737-800,15,4,22,0,1,20,,,,,7,5
2019-04-10 05:20,URC,5853,737-800,15,6,20,6,7,22,,,,,5,7
2019-04-10 05:20,URC,1995,737-800,15,4,22,6,6,24,,,,,7,9
2019-04-10 05:18,URC,5611,737-800,15,2,20,4,4,22,,,,,5,7
2019-04-10 05:18,FOC,1906,737-800,22,7,32,0,0,24,,,,,10,2
2019-04-10 05:18,SYX,1502,737-800,25,3,34,5,5,32,,,,,9,7
2019-04-10 05:12,HAK,5735,737-800,26,3,31,3,4,32,,,,,5,6
2019-04-10 05:05,HGH,1497,737-800,12,3,13,5,5,22,,,,,1,10
2019-04-10 05:03,URC,2159,737-800,16,8,21,2,2,18,,,,,5,2
2019-04-10 05:02,URC,206P,737-800,15,4,22,4,4,20,,,,,7,5
2019-04-10 04:57,KMG,1587,737-800,15,2,20,4,2,19,,,,,5,4
2019-04-10 04:57,CKG,7619,737-800,23,6,29,5,5,28,,,,,6,5
2019-04-10 04:56,URC,6995,737-800,10,8,22,4,4,18,,,,,12,8
2019-04-10 04:51,FOC,7395,737-800,22,6,28,6,6,28,,,,,6,6
2019-04-10 04:42,XIY,1162,737-800,10,8,30,7,7,26,,,,,20,16
2019-04-10 04:40,HGH,5337,737-800,12,4,26,4,4,26,,,,,14,14
2019-04-10 04:39,PEK ,7377,737-800,10,5,21,8,8,22,,,,,11,12
2019-04-10 04:37,ZGC,7378,737-800,9,9,20,9,8,20,,,,,11,11
2019-04-10 04:34,XIY,1482,737-800,13,6,26,6,6,24,,,,,13,11
2019-04-10 04:34,XMN,1490,737-800,25,7,30,6,8,28,,,,,5,3
2019-04-10 04:33,SYX,2158,737-800,27,6,28,4,4,27,,,,,1,0
2019-04-10 04:33,XMN,1130,737-800,26,6,28,6,6,29,,,,,2,3
2019-04-10 04:30,HAK,5522,737-800,25,5,31,6,5,32,,,,,6,7
2019-04-10 04:26,XIY,5430,737-800,15,6,24,6,5,26,,,,,9,11
2019-04-10 04:26,CAN,5797,737-800,26,5,28,5,5,30,,,,,2,4
2019-04-10 04:08,KMG,7991,737-800,17,6,24,7,7,23,,,,,7,6
2019-04-10 03:55,DLC,7639,737-800,8,6,26,6,6,22,,,,,18,14
2019-04-10 03:55,KMG,7992,737-800,18,7,26,8,7,23,,,,,8,5
2019-04-10 03:55,DLC,1486,737-800,8,6,26,4,6,28,,,,,18,20
2019-04-10 03:54,DLC,1541,737-800,8,3,24,2,3,26,,,,,16,18
2019-04-10 03:54,PEK,5709,737-800,10,6,26,7,6,22,,,,,16,12
2019-04-10 03:54,DLC,1928,737-800,7,4,20,4,5,17,,,,,13,10
2019-04-10 03:53,DLC,5662,737-800,7,3,20,2,3,20,,,,,13,13
2019-04-10 03:53,DLC,1102,737-800,12,3,24,7,7,27,,,,,12,15
2019-04-10 03:52,DLC,1215,737-800,11,3,27,3,3,20,,,,,16,9
2019-04-10 03:51,DLC,5662,737-800,7,3,20,2,3,20,,,,,13,13
2019-04-10 03:49,PEK,7398,737-800,8,4,24,4,3,22,,,,,16,14
2019-04-10 03:49,XIY,1481,737-800,13,5,26,6,6,22,,,,,13,9
2019-04-10 03:43,PEK,5153,737-800,9,2,20,3,3,18,,,,,11,9
2019-04-10 03:39,HHA,1735,737-800,14,4,24,4,5,22,,,,,10,8
2019-04-10 03:38,XIY,1350,737-800,12,3,25,3,3,21,,,,,13,9
2019-04-10 03:35,HAK,1505,737-800,27,6,28,4,6,22,,,,,1,-5
2019-04-10 03:34,ÃàÑô,5732,737-800,24,4,25,4,4,25,,,,,1,1
2019-04-10 03:33,HHA,5852,737-800,11,7,24,4,4,22,,,,,13,11
2019-04-10 03:30,HHA,5687,737-800,15,4,21,4,4,22,,,,,6,7
2019-04-10 03:28,CAN,1213,737-800,26,7,34,6,6,34,,,,,8,8
2019-04-10 03:26,XIY,5439,737-800,13,4,18,4,4,20,,,,,5,7
2019-04-10 03:25,XIY,5416,737-800,13,8,20,8,8,30,,,,,7,17
2019-04-10 03:24,CGO,6015,737-800,10,4,20,3,3,18,,,,,10,8
2019-04-10 03:17,URC,1568,737-800,15,2,20,2,2,20,,,,,5,5
2019-04-10 03:15,XIY,5116,737-800,11,420,0,4,4,20,,,,,-11,9
2019-04-10 03:14,CAN,6065,737-800,25,4,36,4,5,32,1,,,1,11,7
2019-04-10 03:14,HHA,1996,737-800,12,5,23,5,5,22,,,,,11,10
2019-04-10 03:07,URC,5713,737-800,15,7,20,6,6,20,,,,,5,5
2019-04-10 03:05,KMG,7989,737-800,16,5,24,6,6,24,,,,,8,8
2019-04-10 03:02,HGH,5428,737-800,12,4,22,4,3,23,,,,,10,11
2019-04-10 03:00,FOC,5182,737-800,21,3,28,4,3,26,,,,,7,5
2019-04-10 02:51,HGH,1727,737-800,13,5,24,5,5,20,,,,,11,7
2019-04-10 02:49,HGH,1570,737-800,12,5,19,5,5,19,,,,,7,7
2019-04-10 02:47,HRB,1905,737-800,3,4,18,4,4,17,,,,,15,14
2019-04-10 02:47,URC,7400,737-800,15,2,22,2,2,20,,,,,7,5
2019-04-10 02:45,FOC,7113,737-800,22,5,28,5,5,27,,,,,6,5
2019-04-10 02:37,TYN,1346,737-800,10,6,26,4,4,20,,,,,16,10
2019-04-10 02:36,TYN,1797,737-800,10,4,22,4,4,20,,,,,12,10
2019-04-10 02:35,SZX,5139,737-800,26,4,29,6,4,30,,,,,3,4
2019-04-10 02:33,HAK,1726,737-800,27,6,29,4,4,30,,,,,2,3
2019-04-10 02:29,SYX,7618,737-800,27,5,32,6,5,30,,,,,5,3
2019-04-10 02:23,XIY,1903,737-800,13,1,23,2,2,22,,,,,10,9
2019-04-10 02:15,CAN,5661,737-800,26,4,30,4,4,34,,,,,4,8
2019-04-10 02:15,XIY,1161,737-800,12,4,22,3,3,18,,,,,10,6
2019-04-10 02:15,KMG,7167,737-800,19,2,24,8,6,24,,,,,5,5
2019-04-10 02:12,HHA,1493,737-800,18,4,23,6,6,20,,,,,5,2
2019-04-10 02:12,HGH,1733,737-800,15,2,22,2,2,19,,,,,7,4
2019-04-10 02:11,HGH,5375,737-800,15,4,24,2,2,22,,,,,9,7
2019-04-10 02:04,HAK,1505,737-800,27,10,28,4,6,23,,,,,1,-4
2019-04-10 02:04,HAK,1927,737-800,25,4,28,4,7,29,,,,,3,4
2019-04-10 01:57,HHA,1787,737-800,15,4,26,4,4,28,,,,,11,13
2019-04-10 01:51,FOC,1492,737-800,24,3,29,3,3,28,,,,,5,4
2019-04-10 01:50,SZX,1547,737-800,26,6,32,6,5,30,,,,,6,4
2019-04-10 01:48,XIY,5712,737-800,11,2,21,6,2,20,,,,,10,9
2019-04-10 01:48,SZX,5429,737-800,26,4,30,4,3,30,,,,,4,4
2019-04-10 01:46,URC,1735,737-800,15,2,22,4,4,22,,,,,7,7
2019-04-10 01:41,PEK,1347,737-800,5,4,22,3,4,19,,,,,17,14
2019-04-10 01:39,XIY,5462,737-800,12,2,18,3,4,15,,,,,6,3
2019-04-10 01:35,SYX,1489,737-800,26,5,30,5,4,30,,,,,4,4
2019-04-10 01:34,YIH,1348,737-800,15,4,28,4,4,22,,,,,13,7
2019-04-10 01:34,PEK,1997,737-800,9,4,21,3,3,20,,,,,12,11
2019-04-10 01:34,HAK,5359,737-800,26,5,32,4,4,28,,,,,6,2
2019-04-10 01:30,XIY ,5479,737-800,15,5,22,6,7,33,,1,,1,7,18
2019-04-10 01:29,.PEK,5539,737-800,10,5,20,5,5,24,,,,,10,14
2019-04-10 01:24,XIY,5180,737-800,13,5,24,5,5,22,,,,,11,9
2019-04-10 01:23,HAK,5408,737-800,26,6,28,4,4,28,,,,,2,2
2019-04-10 01:23,HAK,1795,737-800,27,4,30,6,6,28,,,,,3,1
2019-04-10 01:20,FOC,5503,737-800,22,3,28,3,3,25,,,,,6,3
2019-04-10 01:14,HHA,5580,737-800,14,6,22,6,6,28,,,,,8,14
2019-04-10 01:07,HAK,1795,737-800,27,4,30,6,6,28,,,,,3,1
2019-04-10 01:07,CAN,5520,737-800,26,6,35,6,7,32,,,,,9,6
2019-04-10 01:06,HAK,5478,737-800,27,4,35,5,5,32,,,,,8,5
2019-04-10 01:00,PEK,1131,737-800,10,5,26,4,4,21,,,,,16,11
2019-04-10 00:48,XIY,1163,737-800,13,2,24,3,3,25,,,,,11,12
2019-04-10 00:44,YIH,1351,737-800,15,4,26,4,4,20,,,,,11,5
2019-04-10 00:43,URC,205V,737-800,15,8,26,6,6,25,,,,,11,10
2019-04-10 00:40,HAK,5136,737-800,25,5,33,5,5,36,,1,,1,8,11
2019-04-10 00:40,XIY,5116,737-800,14,4,20,4,4,20,,,,,6,6
2019-04-10 00:40,PEK,5538,737-800,8,3,25,3,3,25,,,,,17,17
2019-04-10 00:40,MIG,6809,737-800,25,5,25,5,5,25,,,,,0,0
2019-04-10 00:38,CGO,6016,737-800,7,2,28,4,4,22,,,,,21,15
2019-04-10 00:31,KHG,1322,737-800,20,3,22,3,3,22,,,,,2,2
2019-04-10 00:28,XIY,1728,737-800,13,6,18,6,6,8,,,,,5,-5
2019-04-10 00:28,HHA,1549,737-800,21,5,24,5,5,23,,,,,3,2
2019-04-10 00:28,HAK,1786,737-800,27,2,32,4,4,30,,,,,5,3
2019-04-10 00:25,XIY,5620,737-800,15,3,26,2,4,20,,,,,11,5
2019-04-10 00:24,SYX,1487,737-800,25,3,32,3,3,28,,,,,7,3
2019-04-10 00:22,URC,1793,737-800,15,4,20,4,5,20,,,,,5,5
2019-04-10 00:18,HAK,1503,737-800,25,2,30,4,3,29,,,,,5,4
2019-04-10 00:18,HGH,1799,737-800,14,4,26,4,4,26,,,,,12,12
2019-04-10 00:17,HRB,1480,737-800,2,4,18,4,4,15,,,,,16,13
2019-04-10 00:09,HRB,1559,737-800,4,2,19,2,2,20,,,,,15,16
2019-04-10 00:08,CKG,5855,737-800,23,6,26,4,4,24,,,,,3,1
2019-04-10 00:05,HAK,5090,737-800,27,2,30,5,5,32,,,,,3,5
2019-04-10 00:04,DLC,5346,737-800,8,6,23,6,5,24,,,,,15,16
2019-04-10 00:04,URC,1325,737-800,15,4,21,3,3,24,,,,,6,9
2019-04-10 00:03,XMN,6066,737-800,24,4,26,4,5,22,,,,,2,-2
2019-04-10 00:02,XMN,5373,737-800,24,6,28,6,7,30,,,,,4,6
2019-04-10 00:02,FOC,7395,737-800,22,6,28,6,6,28,,,,,6,6
2019-04-09 23:53,HAK,6063,737-800,27,7,30,6,5,29,,,,,3,2
2019-04-09 23:52,SYX,1373,737-800,26,4,30,4,4,27,,,,,4,1
2019-04-09 23:50,CKG,7172,737-800,22,5,24,7,6,22,,,,,2,0
2019-04-09 23:44,HAK,5407,737-800,27,6,34,5,3,32,,,,,7,5
2019-04-09 23:43,TYN,5467,737-800,12,2,18,4,2,18,,,,,6,6
2019-04-09 23:42,CGO,5465,737-800,9,3,22,4,3,20,,,,,13,11
2019-04-09 23:40,CGO,5135,737-800,10,8,26,3,2,22,,,,,16,12
2019-04-09 23:39,TYN,5579,737-800,7,8,26,6,6,20,,,,,19,13
2019-04-09 23:26,CGO,205U,737-800,7,3,23,5,5,20,,,,,16,13
2019-04-09 23:20,XNN,1101,737-800,10,3,28,3,2,16,,,,,18,6
2019-04-09 23:18,CAN,1538,737-800,28,3,33,4,3,30,,,,,5,2
2019-04-09 23:15,SYX,1501,737-800,28,4,33,4,4,30,,,,,5,2
2019-04-09 23:06,SYX,5480,737-800,28,6,32,5,2,28,,,,,4,0
2019-04-09 23:00,HAK,5686,737-800,27,5,34,5,5,34,,,,,7,7
2019-04-09 22:52,CAN,1498,737-800,27,6,34,6,6,30,,,,,7,3
2019-04-09 22:51,XIY,7616,737-800,15,5,23,4,4,23,,,,,8,8
2019-04-09 22:34,HAK,206G,737-800,28,3,30,4,5,31,,,,,2,3
2019-04-09 22:32,CAN,5405,737-800,28,5,36,6,4,34,,,,,8,6
2019-04-09 22:29,HAK,5581,737-800,30,8,28,5,4,32,,,,,-2,2
2019-04-09 22:18,URC,1323,737-800,15,3,23,3,3,25,,,,,8,10
2019-04-09 22:15,NKG,1796,737-800,9,7,13,7,7,23,,,,,4,14
2019-04-09 22:07,DLC,5521,737-800,11,4,16,2,2,12,,,,,5,1
2019-04-09 22:01,HAK,7171,737-800,27,4,31,6,7,32,,,,,4,5
2019-04-09 21:58,ZGC,5138,737-800,10,9,26,8,9,23,,,,,16,13
2019-04-09 21:54,ÃàÑô,6959,737-800,25,6,25,7,7,25,,,,,0,0
2019-04-09 21:50,XNN,7173,737-800,10,5,0,5,4,18,,,,,-10,8
2019-04-09 21:18,XUZ,7988,737-800,13,6,23,4,4,23,,,,,10,10
2019-04-09 20:26,FOC,1562,737-800,25,4,22,5,5,25,,,,,-3,0
2019-04-09 20:15,HGH,5375,737-800,20,2,24,2,2,24,,,,,4,4
2019-04-09 20:08,HAK,7399,737-800,30,4,34,6,3,28,,,,,4,-2
2019-04-09 19:15,URC,205T,737-800,19,2,22,4,4,24,,,,,3,5
2019-04-09 18:11,PEK ,1488 ,737-800,10,5,26,6,4,22,,,,,16,12
2019-04-09 15:07,URC,6995,737-800,16,4,22,6,6,20,,,,,6,4
2019-04-09 14:54,HHA,1375,737-800,25,4,27,4,4,26,,,,,2,1
2019-04-09 11:44,CTU,7990,737-800,31,3,28,3,3,26,,,,,-3,-5
2019-04-09 11:21,PEK,5141,737-800,6,5,25,4,6,24,,,,,19,18
2019-04-09 09:25,XIY,5180,737-800,16,5,26,5,6,24,,,,,10,8
2019-04-09 08:36,HAK,1729,737-800,25,2,26,8,6,26,,,,,1,1
2019-04-09 08:36,HAK,1729,737-800,25,2,26,8,6,26,,,,,1,1
2019-04-09 08:34,HAK,5581,737-800,27,7,28,6,5,33,,,,,1,6
2019-04-09 08:31,PEK,1726,737-800,8,4,22,4,4,20,,,,,14,12
2019-04-09 08:29,PEK,5465,737-800,12,2,20,2,2,20,,,,,8,8
2019-04-09 08:19,PEK,5638,737-800,10,4,20,4,4,24,,,,,10,14
2019-04-09 08:15,CGO,1586,737-800,12,3,24,4,4,23,,,,,12,11
2019-04-09 08:14,CAN,5520,737-800,26,3,30,6,5,31,,,,,4,5
2019-04-09 07:54,HAK,7400,737-800,25,4,32,6,6,30,,,,,7,5
2019-04-09 07:37,PEK,5482,737-800,5,0,16,2,2,16,,,,,11,11
2019-04-09 07:25,SYX,1501,737-800,27,4,35,4,4,30,,,,,8,3
2019-04-09 06:54,XIY,5416,737-800,15,9,24,8,8,24,,,,,9,9
2019-04-09 06:47,XIY,1162,737-800,15,4,20,4,5,22,,,,,5,7
2019-04-09 06:17,HAK,5483,737-800,27,6,37,5,5,36,,,,,10,9
2019-04-09 06:16,XMN,7398,737-800,23,3,23,5,4,24,,,,,0,1
2019-04-09 06:15,XMN,1549,737-800,24,2,28,6,4,26,,,,,4,2
2019-04-09 06:14,XMN,7378,737-800,24,8,30,6,9,32,,,,,6,8
2019-04-09 06:13,XMN,1131,737-800,15,2,20,3,4,18,,,,,5,3
2019-04-09 05:53,KMG,6015,737-800,16,4,22,3,3,22,,,,,6,6
2019-04-09 05:52,HGH,7175,737-800,27,4,30,5,4,28,,,,,3,1
2019-04-09 05:34,XIY,2647,737-800,15,3,19,4,3,20,,,,,4,5
2019-04-09 05:33,HGH,1497,737-800,26,4,28,4,3,28,,,,,2,2
2019-04-09 05:28,HGH,1497,737-800,25,4,28,4,3,28,,,,,3,3
2019-04-09 05:27,PEK,1728,737-800,10,4,20,2,3,18,,,,,10,8
2019-04-09 05:27,URC,5358,737-800,13,9,17,6,6,18,,,,,4,5
2019-04-09 05:26,XIY,1903,737-800,15,3,8,3,2,8,,,,,-7,-7
2019-04-09 04:58,HAK,5428,737-800,27,5,34,5,5,35,,,,,7,8
2019-04-09 04:57,HAK,6065,737-800,28,5,30,4,4,34,,,,,2,6
2019-04-09 04:47,KMG,7167,737-800,17,5,25,6,6,23,,,,,8,6
2019-04-09 04:44,KMG,1208,737-800,15,3,23,4,4,20,,,,,8,5
2019-04-09 04:43,FOC,5182,737-800,25,3,25,4,4,26,,,,,0,1
2019-04-09 04:43,YIH,7395,737-800,19,6,28,6,6,28,,,,,9,9
2019-04-09 04:39,CGO,6016,737-800,14,4,28,4,4,24,,,,,14,10
2019-04-09 04:38,URC,1793,737-800,7,4,22,4,4,18,,,,,15,11
2019-04-09 04:37,CGO,7989,737-800,8,4,27,6,5,22,,,,,19,14
2019-04-09 04:36,KMG,6800,737-800,18,4,22,4,4,20,,,,,4,2
2019-04-09 04:33,CGO,1588,737-800,13,3,22,4,4,19,,,,,9,6
2019-04-09 04:08,XIY,5439,737-800,15,4,19,3,3,22,,,,,4,7
2019-04-09 04:07,YIH,1348,737-800,19,4,29,4,4,28,,,,,10,9
2019-04-09 04:07,PEK,5539,737-800,10,4,19,7,8,22,,,,,9,12
2019-04-09 04:04,HHA,1996,737-800,25,4,22,4,4,23,,,,,-3,-2
2019-04-09 03:59,TYN,5467,737-800,15,2,17,8,6,16,,,,,2,1
2019-04-09 03:55,FOC,5141,737-800,20,3,22,4,3,20,,,,,2,0
2019-04-09 03:55,DLC,5662,737-800,12,3,20,3,7,20,,,,,8,8
2019-04-09 03:53,XIY,5115,737-800,15,3,18,4,4,22,,,,,3,7
2019-04-09 03:53,FOC,1906,737-800,22,6,25,6,6,27,,,,,3,5
2019-04-09 03:52,DLC,1928,737-800,20,3,19,4,4,18,,,,,-1,-2
2019-04-09 03:50,HGH,1548,737-800,21,4,28,4,3,26,,,,,7,5
2019-04-09 03:49,HHA,5580,737-800,25,6,28,6,6,26,,,,,3,1
2019-04-09 03:45,HAK,8183,737-800,25,7,30,6,4,27,,,,,5,2
2019-04-09 03:39,KMG,7992,737-800,15,7,23,7,7,23,,,,,8,8
2019-04-09 03:35,SYX,1373,737-800,27,4,32,4,4,30,,,,,5,3
2019-04-09 03:34,XIY,1483,737-800,15,3,20,4,3,21,,,,,5,6
2019-04-09 03:31,SYX,5135,737-800,26,7,34,4,3,32,,,,,8,6
2019-04-09 03:18,URC,6268,737-800,9,3,24,4,4,22,,,,,15,13
2019-04-09 03:15,HAK,5686,737-800,25,6,32,5,5,30,,,,,7,5
2019-04-09 03:13,XIY,5116,737-800,20,2,20,2,2,20,,,,,0,0
2019-04-09 03:12,ZGC,1490,737-800,5,3,20,4,3,22,,,,,15,17
2019-04-09 03:11,ZGC,1489,737-800,10,3,21,4,3,22,,,,,11,12
2019-04-09 03:10,URC,1725,737-800,10,4,22,3,2,23,,,,,12,13
2019-04-09 03:10,HHA,5687,737-800,25,3,27,3,2,22,,,,,2,-3
2019-04-09 03:08,FOC,5503,737-800,23,2,26,4,3,26,,,,,3,3
2019-04-09 03:08,KMG,5409,737-800,20,3,22,5,4,23,,,,,2,3
2019-04-09 03:03,HHA,5852,737-800,28,4,28,4,4,25,,,,,0,-3
2019-04-09 02:58,HAK,5636,737-800,26,7,29,6,7,28,,,,,3,2
2019-04-09 02:58,Î÷°²,5712,737-800,19,2,22,2,2,22,,,,,3,3
2019-04-09 02:53,XIY,7616,737-800,20,4,24,4,4,24,,,,,4,4
2019-04-09 02:50,XIY,1163,737-800,15,3,26,2,2,26,,,,,11,11
2019-04-09 02:44,TYN,1346,737-800,5,6,22,4,4,20,,,,,17,15
2019-04-09 02:41,URC,1793,737-800,9,4,22,4,4,18,,,,,13,9
2019-04-09 02:39,SYX ,5713,737-800,26,6,10,6,6,0,,,,,-16,-26
2019-04-09 02:36,XIY,7113,737-800,15,2,22,2,4,22,,,,,7,7
2019-04-09 02:36,URC,6995,737-800,9,2,22,4,3,19,,,,,13,10
2019-04-09 02:36,PEK,6062,737-800,13,2,20,2,2,20,,,,,7,7
2019-04-09 02:33,HAK,5522,737-800,27,6,34,8,9,34,,,,,7,7
2019-04-09 02:29,HAK,7172,737-800,27,2,28,4,5,31,,,,,1,4
2019-04-09 02:28,PEK,5346,737-800,14,5,24,4,4,26,,,,,10,12
2019-04-09 02:28,HAK,5359,737-800,21,4,35,5,7,35,,,,,14,14
2019-04-09 02:27,XIY,1902,737-800,20,4,24,4,4,24,,,,,4,4
2019-04-09 02:27,URC,205V,737-800,10,5,22,5,5,20,,,,,12,10
2019-04-09 02:26,SZX,5478,737-800,26,4,33,5,4,30,,,,,7,4
2019-04-09 02:26,CAN,5661,737-800,26,4,29,4,4,31,,,,,3,5
2019-04-09 02:25,HHA,1503,737-800,27,2,29,4,3,29,,,,,2,2
2019-04-09 02:25,FOC,1559,737-800,22,4,29,3,4,24,,,,,7,2
2019-04-09 02:24,CAN,1795,737-800,27,3,30,4,4,31,,,,,3,4
2019-04-09 02:24,HAK,1545,737-800,27,4,33,6,6,33,,,,,6,6
2019-04-09 02:24,HHA,5153,737-800,25,2,22,3,3,23,,,,,-3,-2
2019-04-09 02:23,DLC,1496,737-800,10,4,24,4,4,25,,,,,14,15
2019-04-09 02:21,XIY,1482,737-800,15,5,28,4,4,28,,,,,13,13
2019-04-09 02:20,URC,205U,737-800,9,4,23,3,4,18,,,,,14,9
2019-04-09 02:19,SZX,5139,737-800,25,5,34,6,4,30,,,,,9,5
2019-04-09 02:17,MIG,5732,737-800,15,2,25,2,2,24,,,,,10,9
2019-04-09 02:17,URC,2159,737-800,15,4,23,3,3,22,,,,,8,7
2019-04-09 02:17,PEK,1347,737-800,12,8,30,8,8,25,,,,,18,13
2019-04-09 02:16,DLC,5521,737-800,12,4,22,4,5,20,,,,,10,8
2019-04-09 02:15,URC,5502,737-800,5,4,20,6,4,22,,,,,15,17
2019-04-09 02:13,PEK,5538,737-800,13,3,24,1,1,24,,,,,11,11
2019-04-09 02:11,DLC,1215,737-800,19,3,26,4,5,21,,,,,7,2
2019-04-09 02:11,URC,1995,737-800,9,3,22,4,4,23,,,,,13,14
2019-04-09 02:09,KMG,7991,737-800,17,6,23,6,6,23,,,,,6,6
2019-04-09 02:05,SYX,BX206H,737-800,27,4,34,3,3,32,,,,,7,5
2019-04-09 02:04,CAN,5418,737-800,27,5,0,5,5,31,,,,,-27,4
2019-04-09 01:53,CAN,1498,737-800,26,6,28,6,6,32,,,,,2,6
2019-04-09 01:53,HHA,1493,737-800,26,5,26,6,6,25,,,,,0,-1
2019-04-09 01:46,URC,1569,737-800,8,3,24,2,2,20,,,,,16,12
2019-04-09 01:46,SYX,2158,737-800,30,8,29,4,4,28,,,,,-1,-2
2019-04-09 01:45,PEK,1488,737-800,13,8,28,6,8,30,,,,,15,17
2019-04-09 01:41,HAK,7993,737-800,27,6,32,7,6,30,,,,,5,3
2019-04-09 01:38,CKG,5735,737-800,20,3,20,3,4,22,,,,,0,2
2019-04-09 01:36,KMG,1587,737-800,15,3,20,3,3,20,,,,,5,5
2019-04-09 01:35,XIY,286F,737-800,16,5,26,5,4,25,,,,,10,9
2019-04-09 01:34,XIY,6063,737-800,15,6,27,5,6,25,,,,,12,10
2019-04-09 01:32,URC,5853,737-800,6,6,22,6,6,20,,,,,16,14
2019-04-09 01:32,SYX,5480,737-800,28,5,32,4,4,30,,,,,4,2
2019-04-09 01:31,HRB,7105,737-800,4,4,20,4,4,17,,,,,16,13
2019-04-09 01:30,HRB,1435,737-800,5,4,26,4,4,24,,,,,21,19
2019-04-09 01:29,HHA,6066,737-800,25,2,29,3,3,28,,,,,4,3
2019-04-09 01:28,HAK,1505,737-800,26,4,36,4,4,29,,,,,10,3
2019-04-09 01:28,HRB,1480,737-800,7,5,17,4,4,16,,,,,10,9
2019-04-09 01:24,HRB,1433,737-800,15,4,24,4,4,22,,,,,9,7
2019-04-09 01:22,URC,1568,737-800,12,6,22,5,5,18,,,,,10,6
2019-04-09 01:21,HAK,5797,737-800,27,5,27,6,5,28,,,,,0,1
2019-04-09 01:19,URC,1929,737-800,11,4,20,3,3,20,,,,,9,9
2019-04-09 01:19,PEK,1495,737-800,14,4,22,2,2,24,,,,,8,10
2019-04-09 01:18,HHA,1787,737-800,25,4,28,4,4,30,,,,,3,5
2019-04-09 01:11,XIY,5338,737-800,15,4,20,4,4,24,,,,,5,9
2019-04-09 01:11,HGH,5625,737-800,25,5,27,4,4,24,,,,,2,-1
2019-04-09 01:08,SYX,6060,737-800,28,6,34,6,5,31,,,,,6,3
2019-04-09 01:06,URC,5637,737-800,10,6,25,2,2,18,,,,,15,8
2019-04-09 01:03,HGH,5138,737-800,21,4,26,4,4,28,,,,,5,7
2019-04-09 01:03,XIY,1481,737-800,15,3,21,2,3,22,,,,,6,7
2019-04-09 01:03,URC,1735,737-800,10,3,22,5,4,17,,,,,12,7
2019-04-09 01:02,HGH,1733,737-800,22,2,24,2,3,22,,,,,2,0
2019-04-09 00:59,XIY,5733,737-800,16,5,25,5,6,26,,,,,9,10
2019-04-09 00:58,HAK,5408,737-800,27,5,33,4,4,30,,,,,6,3
2019-04-09 00:57,CAN,5136,737-800,26,3,30,3,4,34,,,,,4,8
2019-04-09 00:55,SZX,6103,737-800,26,6,30,6,6,30,,,,,4,4
2019-04-09 00:54,SZX,6103,737-800,26,6,30,6,6,30,,,,,4,4
2019-04-09 00:53,SZX,6103,737-800,26,6,30,6,6,30,,,,,4,4
2019-04-09 00:52,HAK,1209,737-800,27,4,32,3,4,29,,,,,5,2
2019-04-09 00:50,URC,1130,737-800,15,2,24,3,3,22,,,,,9,7
2019-04-09 00:48,TYN,1491,737-800,6,4,24,4,5,22,,,,,18,16
2019-04-09 00:47,CAN,5406,737-800,27,6,28,6,5,29,,,,,1,2
2019-04-09 00:46,HAK,1542,737-800,27,5,30,4,3,30,,,,,3,3
2019-04-09 00:41,CKG,7619,737-800,20,5,30,6,4,28,,,,,10,8
2019-04-09 00:38,HAK,5089,737-800,29,4,29,1,1,36,,,,,0,7
2019-04-09 00:36,SYX,7618,737-800,27,6,31,6,4,30,,,,,4,3
2019-04-09 00:34,HAK,5090,737-800,21,1,30,2,3,30,,,,,9,9
2019-04-09 00:28,PEK,7377,737-800,15,7,20,6,7,25,,,,,5,10
2019-04-09 00:28,CGO,5855,737-800,12,6,22,4,4,18,,,,,10,6
2019-04-09 00:28,CGO,1586,737-800,12,3,24,4,4,23,,,,,12,11
2019-04-09 00:25,HAK,1547,737-800,26,3,28,4,3,26,,,,,2,0
2019-04-09 00:23,KHG,1325,737-800,19,4,23,4,3,22,,,,,4,3
2019-04-09 00:20,URC,5611,737-800,12,5,21,5,5,26,,,,,9,14
2019-04-09 00:17,FOC,1350,737-800,24,3,30,3,2,26,,,,,6,2
2019-04-09 00:15,HAK,5463,737-800,27,3,27,3,3,28,,,,,0,1
2019-04-09 00:13,SYX,1487,737-800,28,2,32,3,3,32,,,,,4,4
2019-04-09 00:13,URC,1372,737-800,9,6,22,4,5,19,,,,,13,10
2019-04-09 00:12,CKG,1502,737-800,20,4,27,4,4,30,,,,,7,10
2019-04-09 00:06,DLC,1492,737-800,12,3,21,4,4,20,,,,,9,8
2019-04-09 00:06,SZX,1141,737-800,28,6,36,6,6,32,,,,,8,4
2019-04-08 23:56,URC,1570,737-800,10,5,21,5,6,20,,,,,11,10
2019-04-08 23:56,SZX,5417,737-800,27,4,28,6,6,35,,,,,1,8
2019-04-08 23:56,SZX,7886,737-800,25,6,36,4,6,34,,,,,11,9
2019-04-08 23:46,HGH,5375,737-800,22,2,24,2,2,24,,,,,2,2
2019-04-08 23:39,FOC,1351,737-800,22,4,30,3,3,28,,,,,8,6
2019-04-08 23:38,DLC,1541,737-800,15,5,28,6,5,24,,,,,13,9
2019-04-08 23:33,PEK,1103,737-800,14,2,28,3,3,22,,,,,14,8
2019-04-08 23:30,PEK,5373,737-800,14,6,16,6,6,25,,,,,2,11
2019-04-08 23:29,CAN,5405,737-800,27,5,35,6,4,34,,,,,8,7
2019-04-08 23:29,DLC,1102,737-800,13,4,24,4,4,22,,,,,11,9
2019-04-08 23:23,CAN,1213,737-800,27,6,36,6,6,34,,,,,9,7
2019-04-08 23:21,URC,2157,737-800,12,4,20,8,8,24,,,,,8,12
2019-04-08 23:13,MIG,1798,737-800,26,4,25,5,5,24,,,,,-1,-2
2019-04-08 23:11,FOC,1562,737-800,23,6,32,5,5,32,,,,,9,9
2019-04-08 23:09,CGO,205T,737-800,15,3,23,2,2,24,,,,,8,9
2019-04-08 23:09,HAK,206G,737-800,24,2,34,4,4,30,,,,,10,6
2019-04-08 22:57,URC,1323,737-800,11,2,21,3,3,24,,,,,10,13
2019-04-08 22:57,CGO,1997,737-800,12,2,22,3,2,18,,,,,10,6
2019-04-08 22:52,CAN,6061,737-800,26,5,31,6,5,30,,,,,5,4
2019-04-08 22:51,HAK,1785,737-800,28,0,32,9,9,30,,,,,4,2
2019-04-08 22:43,SZX,5623,737-800,27,6,30,6,6,30,,,,,3,3
2019-04-08 22:28,HAK,7399,737-800,26,4,32,4,4,29,,,,,6,3
2019-04-08 22:22,,1797,737-800,5,4,22,4,4,18,,,,,17,13
2019-04-08 22:16,HGH,1799,737-800,25,5,28,5,5,29,,,,,3,4
2019-04-08 22:13,XNN,1386,737-800,5,3,20,3,3,16,,,,,15,11
2019-04-08 22:05,SZX,1927,737-800,27,4,30,6,4,30,,,,,3,3
2019-04-08 22:00,CAN,5337,737-800,28,8,30,6,5,32,,,,,2,4
2019-04-08 21:34,HGH,71775,737-800,27,4,30,5,4,28,,,,,3,1
2019-04-08 21:28,XNN,1101,737-800,5,2,28,3,2,18,,,,,23,13
2019-04-08 21:28,XNN,1101,737-800,5,2,28,3,2,18,,,,,23,13
2019-04-08 21:21,CAN,1796,737-800,26,6,32,3,4,30,,,,,6,4
2019-04-08 21:08,MIG,6809,737-800,26,6,26,2,2,24,,,,,0,-2
2019-04-08 20:06,TYN,5579,737-800,15,6,22,4,4,21,,,,,7,6
2019-04-08 19:55,DLC,7639,737-800,12,6,26,5,6,22,,,,,14,10
2019-04-08 19:55,PEK ,5540,737-800,15,5,28,4,4,24,,,,,13,9
2019-04-08 19:48,HAK,5709,737-800,30,6,32,7,6,30,,,,,2,0
2019-04-08 18:43,XUZ,7988,737-800,18,6,26,5,6,25,,,,,8,7
2019-04-08 18:25,HGH,1786,737-800,28,4,30,4,3,26,,,,,2,-2
2019-04-08 15:25,URC,7198,737-800,18,4,22,5,4,21,,,,,4,3
2019-04-08 13:06,KHG,1325,737-800,20,4,20,4,4,20,,,,,0,0
2019-04-08 11:52,URC,1322,737-800,10,3,21,2,3,20,,,,,11,10
2019-04-08 11:16,CTU,7990,737-800,28,2,28,3,3,26,,,,,0,-2
2019-04-08 10:29,PEK,5638,737-800,15,4,22,4,4,21,,,,,7,6
2019-04-08 08:46,HAK,1785,737-800,25,1,29,9,8,31,,,,,4,6
2019-04-08 07:44,XIY,5662,737-800,20,2,22,3,8,22,,,,,2,2
2019-04-08 07:35,HAK,5375,737-800,25,9,37,8,9,36,1,1,,11,12,11
2019-04-08 07:24,À¥Ã÷,7991,737-800,15,6,24,5,6,22,,,,,9,7
2019-04-08 06:31,PEK,5540,737-800,11,3,24,3,3,23,,,,,13,12
2019-04-08 06:20,KMG,1208,737-800,18,3,21,4,4,20,,,,,3,2
2019-04-08 06:18,TYN,5467,737-800,16,2,21,4,2,18,,,,,5,2
2019-04-08 05:57,XMN,7398,737-800,24,3,30,3,3,30,,,,,6,6
2019-04-08 05:56,XMN,1727,737-800,23,4,30,6,6,20,,,,,7,-3
2019-04-08 05:56,XMN,1347,737-800,22,3,29,3,3,28,,,,,7,6
2019-04-08 05:42,HGH,1786,737-800,20,3,25,3,3,24,,,,,5,4
2019-04-08 05:13,FOC,1799,737-800,22,4,25,4,4,28,,,,,3,6
2019-04-08 04:43,TYN,5579,737-800,16,6,26,6,6,23,,,,,10,7
2019-04-08 04:41,CGO,1588,737-800,20,4,24,4,4,24,,,,,4,4
2019-04-08 04:31,XIY,5439,737-800,15,5,21,5,6,20,,,,,6,5
2019-04-08 04:23,SZX,7886,737-800,25,3,34,3,3,34,,,,,9,9
2019-04-08 04:17,PEK,5373,737-800,15,5,22,4,4,20,,,,,7,5
2019-04-08 04:17,HAK,1502,737-800,25,4,30,5,6,32,,,,,5,7
2019-04-08 04:12,CGO,6016,737-800,19,4,30,4,4,24,,,,,11,5
2019-04-08 03:58,FOC,5503,737-800,21,4,26,4,4,26,,,,,5,5
2019-04-08 03:58,PEK,5539,737-800,16,4,20,5,5,21,,,,,4,5
2019-04-08 03:55,SZX,1505,737-800,25,4,33,4,4,30,,,,,8,5
2019-04-08 03:31,XIY,1162,737-800,20,4,29,3,3,24,,,,,9,4
2019-04-08 03:30,HAK,5408,737-800,27,8,32,6,6,32,,,,,5,5
2019-04-08 03:24,KMG,7989,737-800,16,8,24,4,6,20,,,,,8,4
2019-04-08 03:23,SYX,2158,737-800,26,7,29,4,4,27,,,,,3,1
2019-04-08 03:22,HAK,6808,737-800,25,4,29,4,4,30,,,,,4,5
2019-04-08 03:16,URC,205U,737-800,12,4,26,5,5,24,,,,,14,12
2019-04-08 03:15,SYX,1997,737-800,28,2,32,2,2,28,,,,,4,0
2019-04-08 03:13,PEK,1498,737-800,17,5,24,4,4,19,,,,,7,2
2019-04-08 03:13,URC,5611,737-800,10,6,17,8,8,20,,,,,7,10
2019-04-08 03:11,URC,1929,737-800,10,2,20,4,4,20,,,,,10,10
2019-04-08 03:09,TYN,5623,737-800,15,6,23,6,6,22,,,,,8,7
2019-04-08 03:03,URC,1568,737-800,8,6,20,6,6,18,,,,,12,10
2019-04-08 03:02,HAK,5853,737-800,25,6,30,6,6,30,,,,,5,5
2019-04-08 03:00,SZX,1733,737-800,23,3,29,3,3,25,,,,,6,2
2019-04-08 02:58,HAK,5798,737-800,25,2,26,2,2,27,,,,,1,2
2019-04-08 02:57,CAN,1729,737-800,25,5,27,5,4,29,,,,,2,4
2019-04-08 02:56,XIY,5430,737-800,17,5,21,5,4,26,,,,,4,9
2019-04-08 02:54,HHA,7171,737-800,25,4,25,4,4,26,,,,,0,1
2019-04-08 02:52,XIY,1902,737-800,20,4,24,3,4,22,,,,,4,2
2019-04-08 02:50,KMG,7993,737-800,15,6,24,7,6,21,,,,,9,6
2019-04-08 02:48,XIY,5180,737-800,20,2,28,2,4,30,,,,,8,10
2019-04-08 02:46,SYX,7618,737-800,26,4,32,4,4,30,,,,,6,4
2019-04-08 02:37,HGH,7378,737-800,20,5,21,5,5,24,,,,,1,4
2019-04-08 02:36,XIY,1903,737-800,20,2,26,3,3,26,,,,,6,6
2019-04-08 02:34,HAK,1493,737-800,25,5,33,5,4,29,,,,,8,4
2019-04-08 02:34,FOC,1562,737-800,23,6,28,6,6,29,,,,,5,6
2019-04-08 02:29,HHA,1787,737-800,23,2,26,3,3,24,,,,,3,1
2019-04-08 02:29,URC,6268,737-800,10,5,23,5,5,25,,,,,13,15
2019-04-08 02:27,HHA,1503,737-800,23,6,28,4,4,24,,,,,5,1
2019-04-08 02:27,URC,2157,737-800,11,4,21,4,2,21,,,,,10,10
2019-04-08 02:24,CAN,5661,737-800,27,4,30,4,4,32,,,,,3,5
2019-04-08 02:20,URC,1725,737-800,15,4,24,4,4,25,,,,,9,10
2019-04-08 02:19,FOC,5182,737-800,21,3,25,3,3,25,,,,,4,4
2019-04-08 02:15,SYX,206H,737-800,25,3,32,3,4,30,,,,,7,5
2019-04-08 02:11,URC,7198,737-800,10,4,24,5,4,22,,,,,14,12
2019-04-08 02:09,KMG,1209,737-800,17,4,24,4,4,22,,,,,7,5
2019-04-08 02:09,CAN,5405,737-800,26,8,34,7,6,30,,,,,8,4
2019-04-08 02:07,KMG,1565,737-800,17,1,24,4,4,22,,,,,7,5
2019-04-08 02:04,MIG,5409,737-800,25,4,24,4,4,24,,,,,-1,-1
2019-04-08 02:01,HHA,1996,737-800,22,5,28,4,5,26,,,,,6,4
2019-04-08 02:01,URC,5713,737-800,11,6,0,6,6,0,,,,,-11,-11
2019-04-08 01:59,KMG,7988,737-800,20,4,24,5,5,24,,,,,4,4
2019-04-08 01:59,HHA,2647,737-800,22,2,20,3,3,22,,,,,-2,0
2019-04-08 01:59,HGH ,1549,737-800,23,5,28,4,4,22,,,,,5,-1
2019-04-08 01:55,CAN,5405,737-800,26,8,34,7,6,30,,,,,8,4
2019-04-08 01:55,XIY,1161,737-800,21,4,18,2,2,20,,,,,-3,-1
2019-04-08 01:55,KMG,6800,737-800,15,4,20,5,5,20,,,,,5,5
2019-04-08 01:51,URC,2159,737-800,11,6,20,2,2,18,,,,,9,7
2019-04-08 01:50,Î÷°²,5115,737-800,20,2,17,5,6,25,,,,,-3,5
2019-04-08 01:49,XIY,1481,737-800,21,6,24,7,6,26,,,,,3,5
2019-04-08 01:44,URC,1735,737-800,11,22,4,6,4,24,,,,,-7,13
2019-04-08 01:43,HAK,5406,737-800,26,7,30,7,4,30,,,,,4,4
2019-04-08 01:43,PEK,5141,737-800,16,5,17,4,5,20,,,,,1,4
2019-04-08 01:42,XIY,1482,737-800,20,4,28,5,6,26,,,,,8,6
2019-04-08 01:41,DLC,1541,737-800,12,4,26,4,4,22,,,,,14,10
2019-04-08 01:41,CAN,1538,737-800,26,3,30,4,2,30,,,,,4,4
2019-04-08 01:39,KMG,5407,737-800,17,3,24,6,4,22,,,,,7,5
2019-04-08 01:39,HAK,6065,737-800,26,5,35,5,5,34,,,,,9,8
2019-04-08 01:35,URC,1372,737-800,15,5,23,4,4,20,,,,,8,5
2019-04-08 01:34,URC,5358,737-800,10,6,20,6,6,10,,,,,10,0
2019-04-08 01:34,HGH,6062,737-800,20,4,25,3,2,25,,,,,5,5
2019-04-08 01:34,ZGC,5480,737-800,15,3,20,4,2,22,,,,,5,7
2019-04-08 01:33,XIY,1163,737-800,25,2,26,3,2,26,,,,,1,1
2019-04-08 01:32,ZGC,1489,737-800,17,3,20,4,4,19,,,,,3,2
2019-04-08 01:32,CAN,7173,737-800,26,6,31,6,6,30,,,,,5,4
2019-04-08 01:30,HHA,5687,737-800,25,4,14,4,4,23,,,,,-11,-2
2019-04-08 01:29,CGO,7167,737-800,20,6,27,5,5,26,,,,,7,6
2019-04-08 01:28,CAN,5136,737-800,26,5,30,5,5,34,,,,,4,8
2019-04-08 01:27,SYX,1497,737-800,25,4,32,4,4,37,,1,,1,7,12
2019-04-08 01:25,HHA,6066,737-800,25,4,28,4,4,26,,,,,3,1
2019-04-08 01:24,XIY,7113,737-800,22,5,28,6,5,24,,,,,6,2
2019-04-08 01:20,CAN,1795,737-800,25,4,31,4,4,30,,,,,6,5
2019-04-08 01:19,SZX,5478,737-800,26,3,34,5,4,32,,,,,8,6
2019-04-08 01:18,CAN,206F,737-800,26,3,32,3,3,29,,,,,6,3
2019-04-08 01:13,URC,5636,737-800,9,4,22,6,4,24,,,,,13,15
2019-04-08 01:11,URC,5138,737-800,8,8,14,3,3,12,,,,,6,4
2019-04-08 01:09,URC,1995,737-800,10,4,22,5,5,22,,,,,12,12
2019-04-08 01:09,HRB,1433,737-800,2,3,21,3,3,16,,,,,19,14
2019-04-08 01:09,CAN,5661,737-800,27,4,30,28,4,32,,,,,3,5
2019-04-08 00:59,HAK,5686,737-800,26,6,32,6,6,30,,,,,6,4
2019-04-08 00:56,TYN,1346,737-800,15,6,23,5,5,15,,,,,8,0
2019-04-08 00:55,CGO,1588,737-800,20,4,24,4,4,24,,,,,4,4
2019-04-08 00:52,HHA,5153,737-800,23,4,26,4,3,27,,,,,3,4
2019-04-08 00:52,XIY,5116,737-800,16,4,21,4,4,22,,,,,5,6
2019-04-08 00:52,SYX,1373,737-800,27,6,35,2,2,28,,,,,8,1
2019-04-08 00:49,YIH,7395,737-800,15,6,28,8,8,28,,,,,13,13
2019-04-08 00:46,HRB,1435,737-800,4,8,22,8,9,23,,,,,18,19
2019-04-08 00:45,HHA,5687,737-800,25,4,13,4,4,24,,,,,-12,-1
2019-04-08 00:44,104,5465,737-800,13,3,5,2,2,21,,,,,-8,8
2019-04-08 00:43,URC,5637,737-800,10,2,22,2,2,18,,,,,12,8
2019-04-08 00:42,XIY,5462,737-800,25,4,22,6,4,24,,,,,-3,-1
2019-04-08 00:39,MIG,6809,737-800,22,4,25,4,4,25,,,,,3,3
2019-04-08 00:36,XIY,7400,737-800,20,4,22,4,3,22,,,,,2,2
2019-04-08 00:36,HGH,1548,737-800,21,2,26,3,3,25,,,,,5,4
2019-04-08 00:34,XIY,1103,737-800,23,4,30,4,4,24,,,,,7,1
2019-04-08 00:34,PEK,5371,737-800,10,7,16,6,6,20,,,,,6,10
2019-04-08 00:33,CGO,205T,737-800,20,3,28,2,2,27,,,,,8,7
2019-04-08 00:33,HAK,1375,737-800,25,4,32,4,3,28,,,,,7,3
2019-04-08 00:31,¹þ¶û±õ,7105,737-800,4,4,22,4,4,20,,,,,18,16
2019-04-08 00:29,HAK,5082,737-800,25,6,28,4,4,29,,,,,3,4
2019-04-08 00:26,XMN,1490,737-800,24,3,22,4,4,24,,,,,-2,0
2019-04-08 00:24,MIG,1798,737-800,18,6,25,2,2,24,,,,,7,6
2019-04-08 00:20,FOC,1350,737-800,22,8,27,4,4,24,,,,,5,2
2019-04-08 00:15,SYX,6060,737-800,25,4,32,4,4,28,,,,,7,3
2019-04-08 00:14,HAK,6103,737-800,28,4,30,4,5,30,,,,,2,2
2019-04-08 00:14,FOC,1351,737-800,19,4,28,3,4,24,,,,,9,5
2019-04-08 00:05,CKG,7619,737-800,26,6,24,5,5,24,,,,,-2,-2
2019-04-08 00:03,URC,205V,737-800,10,6,24,6,6,20,,,,,14,10
2019-04-08 00:02,CKG,5428,737-800,27,4,24,5,4,30,,,,,-3,3
2019-04-08 00:01,DLC,7377,737-800,13,4,20,6,6,20,,,,,7,7
2019-04-07 23:54,FOC,1559,737-800,22,3,29,3,3,25,,,,,7,3
2019-04-07 23:54,CGO,1501,737-800,18,4,28,4,4,24,,,,,10,6
2019-04-07 23:53,CGO,5709,737-800,20,4,23,3,4,21,,,,,3,1
2019-04-07 23:46,HGH,5522,737-800,18,8,26,6,6,26,,,,,8,8
2019-04-07 23:39,HGH,7175,737-800,22,4,30,2,2,24,,,,,8,2
2019-04-07 23:37,PEK,1491,737-800,15,5,35,5,5,24,1,,,1,20,9
2019-04-07 23:33,DLC,7639,737-800,12,6,26,6,6,24,,,,,14,12
2019-04-07 23:28,DLC,1496,737-800,11,6,26,4,4,24,,,,,15,13
2019-04-07 23:28,PEK,5483,737-800,13,6,24,6,4,22,,,,,11,9
2019-04-07 23:28,SZX,1927,737-800,25,3,35,6,3,30,,,,,10,5
2019-04-07 23:16,SYX,1492,737-800,28,4,32,4,4,28,,,,,4,0
2019-04-07 23:12,MIG,5732,737-800,24,4,25,4,4,24,,,,,1,0
2019-04-07 23:12,SZX,1141,737-800,26,6,35,6,6,32,,,,,9,6
2019-04-07 23:11,URC,5502,737-800,11,4,22,5,4,21,,,,,11,10
2019-04-07 23:10,HAK,7399,737-800,25,3,28,5,4,28,,,,,3,3
2019-04-07 23:06,HRB,1480,737-800,4,4,17,4,4,16,,,,,13,12
2019-04-07 23:05,HAK,1542,737-800,27,4,24,3,4,29,,,,,-3,2
2019-04-07 23:01,CAN,5337,737-800,26,5,34,6,5,34,,,,,8,8
2019-04-07 23:00,HAK,5359,737-800,24,6,31,5,5,32,,,,,7,8
2019-04-07 22:59,CKG,5735,737-800,26,3,20,3,3,22,,,,,-6,-4
2019-04-07 22:58,XIY,7616,737-800,20,4,28,2,2,26,,,,,8,6
2019-04-07 22:57,HAK,1797,737-800,27,4,32,4,4,30,,,,,5,3
2019-04-07 22:53,XIY,1488,737-800,25,4,22,4,4,22,,,,,-3,-3
2019-04-07 22:52,HHA,5852,737-800,25,4,26,4,4,25,,,,,1,0
2019-04-07 22:50,DLC,5521,737-800,12,6,20,4,4,20,,,,,8,8
2019-04-07 22:49,DLC,1928,737-800,15,5,20,5,5,19,,,,,5,4
2019-04-07 22:48,HAK,1728,737-800,27,5,32,4,4,31,,,,,5,4
2019-04-07 22:45,HAK,5418,737-800,26,6,0,3,4,32,,,,,-26,6
2019-04-07 22:44,DLC,1215,737-800,12,4,24,4,4,20,,,,,12,8
2019-04-07 22:43,URC,1569,737-800,15,8,30,6,4,22,,,,,15,7
2019-04-07 22:39,HAK,5449,737-800,28,4,30,4,4,28,,,,,2,0
2019-04-07 22:29,URC,1323,737-800,8,7,6,4,4,12,,,,,-2,4
2019-04-07 22:29,PEK,1793,737-800,20,5,22,6,5,19,,,,,2,-1
2019-04-07 22:26,103,1131,737-800,14,5,25,4,4,25,,,,,11,11
2019-04-07 22:14,CAN,1796,737-800,27,6,33,5,4,29,,,,,6,2
2019-04-07 22:13,CAN,1495,737-800,28,4,32,3,3,31,,,,,4,3
2019-04-07 22:12,DLC,1102,737-800,10,4,24,3,3,21,,,,,14,11
2019-04-07 22:10,XIY,5733,737-800,16,4,22,4,5,23,,,,,6,7
2019-04-07 22:09,XIY,5733,737-800,16,4,22,4,5,23,,,,,6,7
2019-04-07 22:08,CAN,5372,737-800,26,6,30,7,8,32,,,,,4,6
2019-04-07 21:43,HAK,1783,737-800,27,4,28,5,5,34,,,,,1,7
2019-04-07 21:34,XNN,1101,737-800,7,2,27,3,2,18,,,,,20,11
2019-04-07 21:22,TYN,5135,737-800,20,3,22,3,2,22,,,,,2,2
2019-04-07 21:00,FOC,1906,737-800,21,7,30,7,6,28,,,,,9,7
2019-04-07 20:54,HAK,5089,737-800,28,2,28,2,2,32,,,,,0,4
2019-04-07 19:48,HAK,206G,737-800,29,3,34,4,4,31,,,,,5,2
2019-04-07 19:34,DLC,5712,737-800,13,1,20,2,2,18,,,,,7,5
2019-04-07 19:28,HGH,5581,737-800,27,4,22,4,6,25,,,,,-5,-2
2019-04-07 19:10,KMG,6015,737-800,23,6,24,4,4,22,,,,,1,-1
2019-04-07 19:01,SZX,5429,737-800,26,2,30,3,3,31,,,,,4,5
2019-04-07 18:36,HGH,5417,737-800,28,4,24,4,4,26,,,,,-4,-2
2019-04-07 18:25,HAK,206P,737-800,30,3,32,2,2,31,,,,,2,1
2019-04-07 17:16,XUZ,1587,737-800,20,2,25,2,2,21,,,,,5,1
2019-04-07 14:18,URC,6995,737-800,5,4,25,5,5,18,,,,,20,13
2019-04-07 13:54,PEK,5416,737-800,20,8,22,8,9,28,,,,,2,8
2019-04-07 12:47,CTU,7990,737-800,28,3,29,3,3,27,,,,,1,-1
2019-04-07 12:09,URC,5713,737-800,12,7,10,6,7,1,,,,,-2,-11
2019-04-07 08:23,PEK,5482,737-800,12,0,18,3,3,20,,,,,6,8
2019-04-07 08:22,PEK ,5855,737-800,15,7,21,7,6,21,,,,,6,6
2019-04-07 08:05,CAN,1729,737-800,30,4,25,4,4,28,,,,,-5,-2
2019-04-07 07:57,SZX,5478,737-800,25,3,23,4,4,27,,,,,-2,2
2019-04-07 07:56,SZX,5463,737-800,24,5,27,4,4,22,,,,,3,-2
2019-04-07 07:55,SZX,5463,737-800,24,5,27,4,4,22,,,,,3,-2
2019-04-07 07:54,SZX,5135,737-800,25,5,30,3,2,30,,,,,5,5
2019-04-07 07:27,HAK,5625,737-800,26,4,28,6,5,32,,,,,2,6
2019-04-07 07:21,PEK,5798,737-800,12,2,18,2,2,20,,,,,6,8
2019-04-07 07:10,HAK,5465,737-800,24,3,30,4,4,31,,,,,6,7
2019-04-07 07:09,HAK,1505,737-800,24,4,35,4,4,30,,,,,11,6
2019-04-07 07:08,HAK,5686,737-800,24,5,32,5,5,30,,,,,8,6
2019-04-07 07:00,SZX,5135,737-800,25,5,30,3,2,30,,,,,5,5
2019-04-07 06:27,CKG,7619,737-800,18,4,22,4,4,22,,,,,4,4
2019-04-07 06:22,SZX,5406,737-800,25,4,24,6,4,28,,,,,-1,3
2019-04-07 06:16,SZX,1733,737-800,25,6,33,6,7,29,,,,,8,4
2019-04-07 06:13,XIY,6063,737-800,15,4,20,4,4,20,,,,,5,5
2019-04-07 05:29,HAK,5082,737-800,25,4,34,5,4,29,,,,,9,4
2019-04-07 05:26,SYX,7618,737-800,27,5,32,6,5,30,,,,,5,3
2019-04-07 05:24,FOC,1559,737-800,22,4,28,3,3,23,,,,,6,1
2019-04-07 04:46,XIY,5430,737-800,20,5,26,5,5,26,,,,,6,6
2019-04-07 04:35,KMG,7993,737-800,15,5,24,5,5,18,,,,,9,3
2019-04-07 04:34,SZX,1548,737-800,24,4,32,4,4,32,,,,,8,8
2019-04-07 04:33,FOC,5503,737-800,19,3,23,3,3,23,,,,,4,4
2019-04-07 04:25,TYN,5439,737-800,10,4,18,4,4,20,,,,,8,10
2019-04-07 04:23,XIY,5462,737-800,20,2,20,4,4,14,,,,,0,-6
2019-04-07 04:18,URC,6268,737-800,13,4,24,4,4,22,,,,,11,9
2019-04-07 04:17,PEK,5539,737-800,10,5,20,6,6,21,,,,,10,11
2019-04-07 04:12,HAK,7173,737-800,25,5,30,6,5,31,,,,,5,6
2019-04-07 04:12,CGO,1588,737-800,22,2,22,2,4,16,,,,,0,-6
2019-04-07 04:12,HAK,5082,737-800,25,4,34,5,4,29,,,,,9,4
2019-04-07 04:05,FOC,1906,737-800,21,6,30,5,5,27,,,,,9,6
2019-04-07 04:05,URC,6995,737-800,9,3,22,2,2,21,,,,,13,12
2019-04-07 04:04,URC,205V,737-800,12,3,21,2,1,20,,,,,9,8
2019-04-07 04:03,KMG,6015,737-800,18,4,20,3,4,18,,,,,2,0
2019-04-07 04:01,XIY,1162,737-800,22,3,27,4,3,25,,,,,5,3
2019-04-07 04:01,XIY,5180,737-800,21,6,25,6,6,26,,,,,4,5
2019-04-07 03:58,XIY,5467,737-800,20,2,20,4,4,14,,,,,0,-6
2019-04-07 03:52,SYX,1501,737-800,27,4,33,4,4,30,,,,,6,3
2019-04-07 03:42,PEK,5538,737-800,13,3,24,4,4,26,,,,,11,13
2019-04-07 03:42,URC,1995,737-800,23,6,26,6,6,22,,,,,3,-1
2019-04-07 03:41,CGO,1588,737-800,22,2,22,22,4,16,,,,,0,-6
2019-04-07 03:39,DLC,5462,737-800,13,4,18,6,6,20,,,,,5,7
2019-04-07 03:36,XMN,5371,737-800,21,8,30,5,8,28,,,,,9,7
2019-04-07 03:35,HAK,5375,737-800,26,2,30,8,8,32,,,,,4,6
2019-04-07 03:35,HHA,1375,737-800,18,2,23,4,3,23,,,,,5,5
2019-04-07 03:35,XMN,1727,737-800,21,6,31,4,4,26,,,,,10,5
2019-04-07 03:34,XMN,1347,737-800,24,6,30,4,4,20,,,,,6,-4
2019-04-07 03:34,XIY,1483,737-800,13,5,20,6,6,22,,,,,7,9
2019-04-07 03:34,HAK,1728,737-800,26,5,32,7,5,27,,,,,6,1
2019-04-07 03:34,XMN,7398,737-800,22,6,28,6,6,26,,,,,6,4
2019-04-07 03:32,KMG,1587,737-800,15,4,18,4,4,19,,,,,3,4
2019-04-07 03:27,DLC,1131,737-800,13,2,26,4,4,24,,,,,13,11
2019-04-07 03:26,KMG,5449,737-800,14,5,22,4,4,19,,,,,8,5
2019-04-07 03:24,DLC,1102,737-800,9,4,22,2,2,22,,,,,13,13
2019-04-07 03:21,HHA,5153,737-800,22,4,26,4,4,28,,,,,4,6
2019-04-07 03:21,HHA,7171,737-800,20,5,24,4,4,26,,,,,4,6
2019-04-07 03:19,DLC,1541,737-800,10,5,24,5,4,20,,,,,14,10
2019-04-07 03:13,DLC,5521,737-800,14,4,19,4,4,12,,,,,5,-2
2019-04-07 03:12,DLC,7377,737-800,13,7,20,7,6,22,,,,,7,9
2019-04-07 03:12,KMG,7992,737-800,15,7,21,8,7,22,,,,,6,7
2019-04-07 03:11,KMG,1798,737-800,15,6,22,6,6,22,,,,,7,7
2019-04-07 03:10,HAK,5428,737-800,27,4,31,5,5,34,,,,,4,7
2019-04-07 03:09,PEK,1787,737-800,14,2,20,0,0,18,,,,,6,4
2019-04-07 03:08,FOC,1351,737-800,22,4,28,4,4,24,,,,,6,2
2019-04-07 03:08,XIY,5116,737-800,15,5,19,5,5,20,,,,,4,5
2019-04-07 03:06,URC,2159,737-800,12,6,24,2,2,22,,,,,12,10
2019-04-07 03:05,URC,5138,737-800,12,4,22,2,4,25,,,,,10,13
2019-04-07 03:02,URC,1568,737-800,13,6,25,5,5,21,,,,,12,8
2019-04-07 03:01,PEK,5373,737-800,12,5,18,6,5,24,,,,,6,12
2019-04-07 02:58,XIY,5662,737-800,20,4,20,3,4,22,,,,,0,2
2019-04-07 02:54,PEK,5638,737-800,12,6,20,7,5,22,,,,,8,10
2019-04-07 02:51,CGO,7991,737-800,16,5,23,6,5,23,,,,,7,7
2019-04-07 02:49,KMG,7167,737-800,13,5,22,6,5,21,,,,,9,8
2019-04-07 02:45,SYX,1373,737-800,26,4,30,4,4,26,,,,,4,0
2019-04-07 02:44,TYN,5579,737-800,15,6,24,4,4,24,,,,,9,9
2019-04-07 02:44,HAK,1927,737-800,25,4,28,9,4,30,,,,,3,5
2019-04-07 02:43,XIY,1492,737-800,24,4,26,2,2,24,,,,,2,0
2019-04-07 02:43,SZX,1498,737-800,24,6,32,6,5,28,,,,,8,4
2019-04-07 02:43,HAK,5479,737-800,25,6,27,6,8,32,,,,,2,7
2019-04-07 02:42,URC,1372,737-800,12,5,15,2,3,18,,,,,3,6
2019-04-07 02:41,XIY,5712,737-800,24,0,21,4,2,20,,,,,-3,-4
2019-04-07 02:40,CAN,1542,737-800,25,4,32,4,4,28,,,,,7,3
2019-04-07 02:40,XIY,7113,737-800,12,5,23,6,7,22,,,,,11,10
2019-04-07 02:36,KHG,1569,737-800,19,4,24,4,5,23,,,,,5,4
2019-04-07 02:34,HAK,1493,737-800,26,6,30,6,6,29,,,,,4,3
2019-04-07 02:33,XIY,1163,737-800,12,2,24,2,2,24,,,,,12,12
2019-04-07 02:32,XIY,1482,737-800,13,6,30,6,6,24,,,,,17,11
2019-04-07 02:28,HHA,2647,737-800,21,2,21,5,5,22,,,,,0,1
2019-04-07 02:28,XIY,1903,737-800,12,4,21,6,4,22,,,,,9,10
2019-04-07 02:21,HGH,1786,737-800,20,4,26,4,4,0,,,,,6,-20
2019-04-07 02:17,URC,5853,737-800,13,5,25,6,6,23,,,,,12,10
2019-04-07 02:17,URC,7175,737-800,13,4,26,4,4,20,,,,,13,7
2019-04-07 02:16,5853,URC,737-800,13,5,25,6,6,23,,,,,12,10
2019-04-07 02:16,HAK,5408,737-800,25,4,32,4,3,28,,,,,7,3
2019-04-07 02:15,HHA,5852,737-800,21,4,25,4,4,23,,,,,4,2
2019-04-07 02:12,FOC,1488,737-800,19,5,28,3,2,22,,,,,9,3
2019-04-07 02:11,HAK,1213,737-800,25,6,34,5,5,32,,,,,9,7
2019-04-07 02:07,CAN,7616,737-800,26,4,30,4,4,30,,,,,4,4
2019-04-07 02:04,XIY,5733,737-800,21,5,21,5,6,22,,,,,0,1
2019-04-07 02:01,HGH,5346,737-800,22,6,24,5,6,25,,,,,2,3
2019-04-07 02:00,XIY,5115,737-800,15,4,18,6,5,22,,,,,3,7
2019-04-07 01:59,URC,5540,737-800,15,4,26,0,1,22,,,,,11,7
2019-04-07 01:58,PEK,1491,737-800,13,5,27,6,6,25,,,,,14,12
2019-04-07 01:56,SYX,1997,737-800,26,4,32,4,3,27,,,,,6,1
2019-04-07 01:55,CGO,6016,737-800,15,4,28,4,4,25,,,,,13,10
2019-04-07 01:54,CAN,1538,737-800,26,3,31,3,3,30,,,,,5,4
2019-04-07 01:52,CGO,1586,737-800,16,4,24,4,4,22,,,,,8,6
2019-04-07 01:50,HHA,7172,737-800,21,5,30,4,5,28,,,,,9,7
2019-04-07 01:46,SYX,2158,737-800,26,6,28,5,4,26,,,,,2,0
2019-04-07 01:44,URC,2157,737-800,15,4,22,7,3,20,,,,,7,5
2019-04-07 01:44,HRB,1905,737-800,2,3,20,3,4,21,,,,,18,19
2019-04-07 01:42,FOC,5182,737-800,20,2,27,4,4,27,,,,,7,7
2019-04-07 01:41,SYX,6065,737-800,26,5,32,6,5,31,,,,,6,5
2019-04-07 01:38,YIH,7395,737-800,15,6,26,6,6,28,,,,,11,13
2019-04-07 01:38,SYX,206H,737-800,26,2,22,2,2,27,,,,,-4,1
2019-04-07 01:38,HAK,7399,737-800,25,4,33,4,3,29,,,,,8,4
2019-04-07 01:35,HAK,1547,737-800,26,6,31,7,6,31,,,,,5,5
2019-04-07 01:31,CAN,1795,737-800,27,4,31,4,4,30,,,,,4,3
2019-04-07 01:26,URC,1725,737-800,12,2,20,2,2,20,,,,,8,8
2019-04-07 01:24,URC,206P,737-800,13,4,24,3,3,22,,,,,11,9
2019-04-07 01:22,URC,5611,737-800,23,6,26,6,5,25,,,,,3,2
2019-04-07 01:19,CAN,6061,737-800,25,4,30,4,4,30,,,,,5,5
2019-04-07 01:16,XIY,5338,737-800,20,2,24,3,2,24,,,,,4,4
2019-04-07 01:15,PEK,1491,737-800,13,5,27,6,25,25,,,,,14,12
2019-04-07 01:14,SYX,206H,737-800,26,30,2,2,2,27,,,,,-24,1
2019-04-07 01:11,KMG,1208,737-800,15,7,16,2,2,20,,,,,1,5
2019-04-07 01:10,FOC,1435,737-800,21,6,28,6,5,26,,,,,7,5
2019-04-07 01:02,XIY,1103,737-800,23,4,28,2,4,26,,,,,5,3
2019-04-07 01:02,HGH,1489,737-800,17,3,26,4,4,24,,,,,9,7
2019-04-07 01:02,CAN,5405,737-800,26,5,36,6,4,34,,,,,10,8
2019-04-07 00:59,URC,1322,737-800,15,4,24,4,4,18,,,,,9,3
2019-04-07 00:52,FOC,1435,737-800,21,6,28,6,5,26,,,,,7,5
2019-04-07 00:49,XIY,7400,737-800,15,6,20,4,4,22,,,,,5,7
2019-04-07 00:49,TYN,5623,737-800,15,6,22,5,5,20,,,,,7,5
2019-04-07 00:47,XIY,1161,737-800,21,3,23,3,3,21,,,,,2,0
2019-04-07 00:45,YIH,1348,737-800,15,6,28,4,4,26,,,,,13,11
2019-04-07 00:41,DLC,1496,737-800,10,5,24,5,5,24,,,,,14,14
2019-04-07 00:41,HAK,5580,737-800,28,6,33,6,6,36,,,,,5,8
2019-04-07 00:41,CKG,5709,737-800,21,6,28,6,6,25,,,,,7,4
2019-04-07 00:40,KWE,5480,737-800,18,0,18,6,2,20,,,,,0,2
2019-04-07 00:40,DLC,1496,737-800,10,5,24,5,5,24,,,,,14,14
2019-04-07 00:39,HRB,1433,737-800,0,4,20,4,6,22,,,,,20,22
2019-04-07 00:38,MIG,5409,737-800,20,4,24,4,4,24,,,,,4,4
2019-04-07 00:37,ZGC,6060,737-800,13,3,22,4,4,21,,,,,9,8
2019-04-07 00:36,MIG,7988,737-800,20,4,28,4,4,26,,,,,8,6
2019-04-07 00:36,ZGC,6060,737-800,13,3,22,4,0,0,,,,,9,-13
2019-04-07 00:34,HGH,7886,737-800,24,4,30,3,3,28,,,,,6,4
2019-04-07 00:33,SZX,1141,737-800,25,5,31,6,5,30,,,,,6,5
2019-04-07 00:30,HAK,5636,737-800,25,5,30,6,5,30,,,,,5,5
2019-04-07 00:26,MIG,6809,737-800,20,4,25,4,4,25,,,,,5,5
2019-04-07 00:26,SYX,1501,737-800,27,4,33,4,4,30,,,,,6,3
2019-04-07 00:22,DLC,1928,737-800,7,5,18,4,4,16,,,,,11,9
2019-04-07 00:20,SZX,1502,737-800,24,5,32,4,4,31,,,,,8,7
2019-04-07 00:18,PEK,1929,737-800,13,6,22,3,3,20,,,,,9,7
2019-04-07 00:16,CAN,5372,737-800,26,8,30,8,8,30,,,,,4,4
2019-04-07 00:09,XIY,1783,737-800,21,4,20,6,6,22,,,,,-1,1
2019-04-07 00:08,URC,5502,737-800,15,5,23,6,5,23,,,,,8,8
2019-04-06 23:59,CGO,6062,737-800,18,3,21,4,4,21,,,,,3,3
2019-04-06 23:55,HGH,1785,737-800,25,4,28,6,6,28,,,,,3,3
2019-04-06 23:51,CAN,5337,737-800,25,5,34,5,5,34,,,,,9,9
2019-04-06 23:48,KMG,1209,737-800,14,4,23,4,4,20,,,,,9,6
2019-04-06 23:47,CAN,6808,737-800,30,4,34,4,4,32,,,,,4,2
2019-04-06 23:37,FOC,1350,737-800,20,4,28,4,4,26,,,,,8,6
2019-04-06 23:34,CKG,5735,737-800,22,2,22,2,2,18,,,,,0,-4
2019-04-06 23:30,PEK,1215,737-800,14,6,25,5,5,23,,,,,11,9
2019-04-06 23:29,URC,205U,737-800,20,4,24,2,0,20,,,,,4,0
2019-04-06 23:29,URC,5358,737-800,17,5,18,7,7,17,,,,,1,0
2019-04-06 23:25,URC,5637,737-800,15,2,26,2,2,20,,,,,11,5
2019-04-06 23:19,TYN,7639,737-800,14,5,28,5,5,22,,,,,14,8
2019-04-06 23:10,HHA,1503,737-800,24,4,26,4,4,26,,,,,2,2
2019-04-06 23:04,HRB,1480,737-800,2,4,18,4,4,17,,,,,16,15
2019-04-06 23:03,SYX,206F,737-800,26,4,32,4,4,30,,,,,6,4
2019-04-06 23:01,CGO,205T,737-800,17,4,22,4,4,16,,,,,5,-1
2019-04-06 22:57,HAK,5418,737-800,25,4,28,4,4,30,,,,,3,5
2019-04-06 22:53,XIY,5620,737-800,15,4,20,2,4,20,,,,,5,5
2019-04-06 22:48,CAN,1495,737-800,27,4,30,4,4,30,,,,,3,3
2019-04-06 22:45,HAK,5089,737-800,25,2,14,1,1,32,,,,,-11,7
2019-04-06 22:43,HAK,5407,737-800,26,4,34,5,4,33,,,,,8,7
2019-04-06 22:40,FOC,1906,737-800,20,6,30,5,5,26,,,,,10,6
2019-04-06 22:39,CGO,1726,737-800,17,3,22,3,3,22,,,,,5,5
2019-04-06 22:32,HAK,5429,737-800,26,4,21,3,3,19,,,,,-5,-7
2019-04-06 22:32,HAK,1996,737-800,26,5,31,5,6,30,,,,,5,4
2019-04-06 22:31,SYX,1487,737-800,27,3,31,3,3,28,,,,,4,1
2019-04-06 22:29,HGH,5417,737-800,23,4,22,4,4,24,,,,,-1,1
2019-04-06 22:26,CAN,5136,737-800,27,4,30,4,4,32,,,,,3,5
2019-04-06 22:26,HAK,5661,737-800,27,4,30,5,5,34,,,,,3,7
2019-04-06 22:25,DLC,1346,737-800,11,7,26,11,12,28,,,,,15,17
2019-04-06 22:19,HAK,1497,737-800,26,3,33,4,3,32,,,,,7,6
2019-04-06 22:17,XNN,1386,737-800,7,4,18,3,3,16,,,,,11,9
2019-04-06 22:09,XIY,1793,737-800,22,5,25,4,5,25,,,,,3,3
2019-04-06 22:03,URC,1323,737-800,18,3,25,4,5,26,,,,,7,8
2019-04-06 22:02,URC,1325,737-800,16,0,20,2,2,20,,,,,4,4
2019-04-06 21:57,PEK,1490,737-800,14,5,21,6,6,16,,,,,7,2
2019-04-06 21:44,XNN,1101,737-800,7,3,28,3,2,20,,,,,21,13
2019-04-06 21:38,XUZ,6800,737-800,24,5,26,5,4,25,,,,,2,1
2019-04-06 21:29,DLC,7377,737-800,13,7,20,7,6,22,,,,,7,9
2019-04-06 21:24,MIG,5732,737-800,24,2,23,3,3,24,,,,,-1,0
2019-04-06 19:46,HAK,5687,737-800,29,6,22,6,6,32,,,,,-7,3
2019-04-06 19:31,HAK,2652,737-800,28,5,33,5,4,23,,,,,5,-5
2019-04-06 18:47,HGH,7378,737-800,20,6,26,5,5,27,,,,,6,7
2019-04-06 18:33,HGH,5581,737-800,25,4,20,6,4,28,,,,,-5,3
2019-04-06 17:28,PEK,6103,737-800,20,8,28,6,8,27,,,,,8,7
2019-04-06 15:46,TYN,5139,737-800,18,4,20,5,4,24,,,,,2,6
2019-04-06 14:36,URC,7198,737-800,21,3,22,3,2,22,,,,,1,1
2019-04-06 10:58,CTU,7990,737-800,25,6,29,3,3,27,,,,,4,2
2019-04-06 09:47,HAK ,7993,737-800,23,6,22,8,7,26,,,,,-1,3
2019-04-06 09:21,XIY,1903,737-800,20,2,22,2,3,26,,,,,2,6
2019-04-06 08:34,KMG,1209,737-800,12,8,26,4,4,20,,,,,14,8
2019-04-06 08:34,KMG,6800,737-800,12,4,20,4,4,20,,,,,8,8
2019-04-06 08:23,PEK,5855,737-800,14,6,20,6,6,20,,,,,6,6
2019-04-06 08:17,SYX,1726,737-800,27,5,27,4,4,28,,,,,0,1
2019-04-06 08:15,FOC,1559,737-800,21,3,16,3,5,24,,,,,-5,3
2019-04-06 07:49,HRB,1905,737-800,0,4,20,4,4,14,,,,,20,14
2019-04-06 07:48,HRB,7105,737-800,0,4,22,4,4,20,,,,,22,20
2019-04-06 07:44,TYN,5462,737-800,20,2,18,6,4,20,,,,,-2,0
2019-04-06 07:34,FOC,5182,737-800,20,4,22,5,5,24,,,,,2,4
2019-04-06 07:20,KMG,1798,737-800,15,5,20,4,5,20,,,,,5,5
2019-04-06 07:18,KMG,6016,737-800,13,5,26,4,4,23,,,,,13,10
2019-04-06 07:01,HGH,1786,737-800,15,4,26,4,4,0,,,,,11,-15
2019-04-06 07:01,HRB,1433,737-800,1,8,26,6,8,23,,,,,25,22
2019-04-06 06:29,PEK,1505,737-800,12,4,22,4,4,20,,,,,10,8
2019-04-06 05:48,HAK,1497,737-800,24,3,32,4,3,31,,,,,8,7
2019-04-06 05:32,XIY,1163,737-800,18,4,20,3,4,21,,,,,2,3
2019-04-06 05:28,KMG,5449,737-800,12,4,23,4,5,21,,,,,11,9
2019-04-06 04:52,CGO,1588,737-800,21,4,26,4,4,24,,,,,5,3
2019-04-06 04:50,CGO,5735,737-800,16,2,22,2,2,20,,,,,6,4
2019-04-06 04:42,XMN,5416,737-800,21,7,29,8,7,30,,,,,8,9
2019-04-06 04:42,XMN,1503,737-800,22,4,30,3,3,28,,,,,8,6
2019-04-06 04:41,XMN,6060,737-800,21,7,30,8,8,31,,,,,9,10
2019-04-06 04:40,XMN,1491,737-800,22,5,32,5,5,31,1,,,1,10,9
2019-04-06 04:29,KMG,6016,737-800,13,5,26,4,4,23,,,,,13,10
2019-04-06 04:29,HAK,206G,737-800,25,2,33,2,2,29,,,,,8,4
2019-04-06 04:25,KMG,7989,737-800,15,4,25,6,5,20,,,,,10,5
2019-04-06 03:49,SYX,5662,737-800,25,3,32,2,4,28,,,,,7,3
2019-04-06 03:45,SYX,1545,737-800,25,5,32,4,5,31,,,,,7,6
2019-04-06 03:45,SZX,1548,737-800,24,2,30,2,2,28,,,,,6,4
2019-04-06 03:29,XIY,7616,737-800,17,4,21,4,4,22,,,,,4,5
2019-04-06 03:27,HHA,7398,737-800,20,4,25,4,3,22,,,,,5,2
2019-04-06 03:27,SYX,5520,737-800,25,8,34,6,6,30,,,,,9,5
2019-04-06 03:25,SYX,2158,737-800,26,5,26,4,4,26,,,,,0,0
2019-04-06 03:21,KMG,1586,737-800,15,3,22,3,3,21,,,,,7,6
2019-04-06 03:21,XIY,1481,737-800,20,5,26,6,6,22,,,,,6,2
2019-04-06 03:10,PEK,5538,737-800,12,2,26,6,8,34,,1,,1,14,22
2019-04-06 03:09,XIY,1783,737-800,20,4,20,4,3,20,,,,,0,0
2019-04-06 03:04,SZX,5685,737-800,25,2,27,2,3,25,,,,,2,0
2019-04-06 03:01,HHA,5636,737-800,20,4,25,4,4,24,,,,,5,4
2019-04-06 03:01,DLC,5521,737-800,20,5,17,0,0,12,,,,,-3,-8
2019-04-06 03:00,DLC,7400,737-800,15,6,22,8,7,25,,,,,7,10
2019-04-06 02:58,HAK,5429,737-800,25,2,21,3,4,24,,,,,-4,-1
2019-04-06 02:56,SYX,206H,737-800,27,4,32,4,4,31,,,,,5,4
2019-04-06 02:53,DLC,5712,737-800,13,1,16,1,2,16,,,,,3,3
2019-04-06 02:53,SYX,1489,737-800,25,4,30,4,3,28,,,,,5,3
2019-04-06 02:53,DLC,5623,737-800,20,6,24,5,5,20,,,,,4,0
2019-04-06 02:51,FOC,1488,737-800,19,4,28,3,6,22,,,,,9,3
2019-04-06 02:51,URC,6268,737-800,15,4,26,6,6,23,,,,,11,8
2019-04-06 02:51,DLC,1346,737-800,15,6,25,4,5,22,,,,,10,7
2019-04-06 02:50,URC,5853,737-800,18,5,26,5,6,23,,,,,8,5
2019-04-06 02:50,SZX,1733,737-800,24,3,30,2,2,28,,,,,6,4
2019-04-06 02:50,DLC,1541,737-800,20,5,27,4,4,24,,,,,7,4
2019-04-06 02:50,URC,2157,737-800,18,3,24,4,4,28,,,,,6,10
2019-04-06 02:46,HAK,5686,737-800,25,5,28,6,5,30,,,,,3,5
2019-04-06 02:45,HHA,5540,737-800,20,5,29,4,3,26,,,,,9,6
2019-04-06 02:44,DLC,5467,737-800,20,3,19,3,2,18,,,,,-1,-2
2019-04-06 02:44,CKG,5709,737-800,18,8,26,10,9,25,,,,,8,7
2019-04-06 02:43,DLC,1490,737-800,13,5,22,5,5,20,,,,,9,7
2019-04-06 02:41,XIY,7113,737-800,18,4,24,2,4,22,,,,,6,4
2019-04-06 02:41,XIY,5430,737-800,18,6,26,4,4,24,,,,,8,6
2019-04-06 02:39,HGH,7378,737-800,20,6,24,4,5,27,,,,,4,7
2019-04-06 02:36,XIY,1787,737-800,15,0,18,0,0,19,,,,,3,4
2019-04-06 02:35,XIY,1162,737-800,18,2,25,2,2,18,,,,,7,0
2019-04-06 02:32,URC,205V,737-800,10,4,30,4,5,24,,,,,20,14
2019-04-06 02:29,PE,7379,737-800,13,4,26,3,3,27,,,,,13,14
2019-04-06 02:29,SZX,1498,737-800,24,6,30,6,6,28,,,,,6,4
2019-04-06 02:25,CAN,7173,737-800,25,4,23,7,6,22,,,,,-2,-3
2019-04-06 02:20,URC,1568,737-800,17,3,21,3,3,21,,,,,4,4
2019-04-06 02:18,CKG,1373,737-800,18,4,36,4,4,20,1,,,1,18,2
2019-04-06 02:17,PEK,5375,737-800,15,2,15,2,1,20,,,,,0,5
2019-04-06 02:15,URC,5611,737-800,18,6,29,6,6,30,,,,,11,12
2019-04-06 02:14,HGH,5483,737-800,25,4,24,4,4,26,,,,,-1,1
2019-04-06 02:14,XIY,1482,737-800,15,6,26,4,3,24,,,,,11,9
2019-04-06 02:14,HAK,5687,737-800,24,4,24,5,4,31,,,,,0,7
2019-04-06 02:11,KMG,1208,737-800,10,5,25,7,7,26,,,,,15,16
2019-04-06 02:11,HAK,5408,737-800,25,6,32,5,6,30,,,,,7,5
2019-04-06 02:10,URC,5502,737-800,15,5,21,6,5,23,,,,,6,8
2019-04-06 02:09,HGH,5417,737-800,19,4,24,4,4,22,,,,,5,3
2019-04-06 02:08,FOC,1435,737-800,21,6,29,5,5,29,,,,,8,8
2019-04-06 02:07,PEK,6103,737-800,12,8,26,9,9,26,,,,,14,14
2019-04-06 02:06,URC,1995,737-800,15,4,24,5,6,23,,,,,9,8
2019-04-06 02:05,CGO,1588,737-800,21,4,26,4,4,24,,,,,5,3
2019-04-06 02:04,HAK,5733,737-800,24,8,30,6,5,31,,,,,6,7
2019-04-06 02:00,HHA,6066,737-800,17,6,24,4,3,22,,,,,7,5
2019-04-06 01:55,HHA,7171,737-800,18,4,24,4,4,20,,,,,6,2
2019-04-06 01:53,HAK,1799,737-800,25,5,31,6,5,32,,,,,6,7
2019-04-06 01:52,SYX ,6065,737-800,25,3,34,4,3,32,,,,,9,7
2019-04-06 01:52,MIG,6015,737-800,20,4,24,3,3,24,,,,,4,4
2019-04-06 01:51,HAK,1996,737-800,23,3,30,6,6,29,,,,,7,6
2019-04-06 01:47,PEK,5482,737-800,13,8,16,5,7,10,,,,,3,-3
2019-04-06 01:45,URC,6995,737-800,14,4,25,5,5,20,,,,,11,6
2019-04-06 01:44,CAN,5405,737-800,23,4,31,4,4,31,,,,,8,8
2019-04-06 01:44,HAK,5687,737-800,24,4,24,5,4,31,,,,,0,7
2019-04-06 01:42,CAN,6061,737-800,23,3,29,4,4,26,,,,,6,3
2019-04-06 01:41,SZX,5478,737-800,25,3,34,4,3,27,,,,,9,2
2019-04-06 01:41,CAN,1495,737-800,22,4,28,3,3,27,,,,,6,5
2019-04-06 01:37,HAK,1501,737-800,25,4,36,4,4,30,1,,,1,11,5
2019-04-06 01:36,HGH,5581,737-800,20,4,19,5,5,25,,,,,-1,5
2019-04-06 01:36,XIY,1161,737-800,17,3,23,3,4,22,,,,,6,5
2019-04-06 01:35,URC,2159,737-800,10,2,24,2,2,22,,,,,14,12
2019-04-06 01:34,CAN,6808,737-800,25,4,30,4,4,29,,,,,5,4
2019-04-06 01:30,URC,1929,737-800,17,8,24,7,8,25,,,,,7,8
2019-04-06 01:30,XIY,5180,737-800,19,6,22,6,6,20,,,,,3,1
2019-04-06 01:29,XIY,1902,737-800,20,2,22,4,4,20,,,,,2,0
2019-04-06 01:28,URC,205T,737-800,15,4,25,2,2,26,,,,,10,11
2019-04-06 01:28,KMG,7988,737-800,14,4,25,5,5,24,,,,,11,10
2019-04-06 01:27,YIH,1348,737-800,15,4,26,4,4,22,,,,,11,7
2019-04-06 01:26,CAN,1542,737-800,24,4,30,4,3,28,,,,,6,4
2019-04-06 01:26,URC,5637,737-800,15,2,24,2,2,20,,,,,9,5
2019-04-06 01:24,URC,5406,737-800,16,4,18,6,6,24,,,,,2,8
2019-04-06 01:24,HHA,7172,737-800,18,6,22,5,5,22,,,,,4,4
2019-04-06 01:24,URC,5853,737-800,18,5,26,5,6,23,,,,,8,5
2019-04-06 01:24,URC,1322,737-800,17,3,22,3,3,23,,,,,5,6
2019-04-06 01:19,URC,206P,737-800,16,4,26,4,4,23,,,,,10,7
2019-04-06 01:17,PEK,6103,737-800,12,17,34,9,9,26,,,,,22,14
2019-04-06 01:16,PEK,5539,737-800,14,8,24,8,6,22,,,,,10,8
2019-04-06 01:16,HAK,1141,737-800,26,5,33,6,6,30,,,,,7,4
2019-04-06 01:15,PEK,1347,737-800,12,4,23,3,5,25,,,,,11,13
2019-04-06 01:15,TYN,1131,737-800,16,6,24,6,6,22,,,,,8,6
2019-04-06 01:13,FOC,5503,737-800,19,3,25,3,3,25,,,,,6,6
2019-04-06 01:10,HAK,5418,737-800,23,4,26,9,8,25,,,,,3,2
2019-04-06 01:09,MIG,5409,737-800,20,2,22,3,3,24,,,,,2,4
2019-04-06 01:03,URC,1929,737-800,17,8,24,7,8,25,,,,,7,8
2019-04-06 01:02,URC,1929,737-800,17,8,24,7,8,25,,,,,7,8
2019-04-06 01:01,SZX,1927,737-800,24,4,27,6,4,29,,,,,3,5
2019-04-06 01:01,TYN ,7639 ,737-800,20,6,28,6,6,22,,,,,8,2
2019-04-06 00:59,FOC,1906,737-800,15,8,28,7,7,26,,,,,13,11
2019-04-06 00:59,PEK,BX1928,737-800,13,4,20,4,6,20,,,,,7,7
2019-04-06 00:52,YIH,7395,737-800,15,8,26,8,6,28,,,,,11,13
2019-04-06 00:50,CAN,5428,737-800,23,4,27,6,4,30,,,,,4,7
2019-04-06 00:50,FOC,1351,737-800,23,3,29,4,4,26,,,,,6,3
2019-04-06 00:45,KMG,5407,737-800,11,3,24,4,3,21,,,,,13,10
2019-04-06 00:43,URC,1725,737-800,17,4,24,4,3,22,,,,,7,5
2019-04-06 00:43,URC,1325,737-800,18,4,25,3,4,27,,,,,7,9
2019-04-06 00:40,URC,1727,737-800,16,5,23,6,5,20,,,,,7,4
2019-04-06 00:38,HGH,5625,737-800,20,4,28,5,4,24,,,,,8,4
2019-04-06 00:36,SZX,1549,737-800,24,4,30,4,4,29,,,,,6,5
2019-04-06 00:31,CGO,1587,737-800,22,3,26,2,2,24,,,,,4,2
2019-04-06 00:30,HAK,5346,737-800,25,5,32,5,5,30,,,,,7,5
2019-04-06 00:29,TYN,5439,737-800,18,4,26,4,5,27,,,,,8,9
2019-04-06 00:28,HAK,7886,737-800,20,4,36,4,3,33,,,,,16,13
2019-04-06 00:26,XIY,5139,737-800,22,4,18,6,4,28,,,,,-4,6
2019-04-06 00:25,CAN,5136,737-800,24,4,28,3,3,33,,,,,4,9
2019-04-06 00:22,HRB,1433,737-800,6,11,28,11,10,23,,,,,22,17
2019-04-06 00:19,CAN,5465,737-800,25,4,26,3,4,30,,,,,1,5
2019-04-06 00:19,CAN,5465,737-800,25,4,26,3,4,30,,,,,1,5
2019-04-06 00:19,SYX ,1487,737-800,25,2,30,2,2,29,,,,,5,4
2019-04-06 00:17,XIY,5620,737-800,20,4,24,2,2,20,,,,,4,0
2019-04-06 00:10,HAK,1997,737-800,25,4,30,4,3,28,,,,,5,3
2019-04-06 00:10,URC,1372,737-800,10,6,24,4,4,22,,,,,14,12
2019-04-06 00:09,HAK,5337,737-800,25,6,31,6,6,32,,,,,6,7
2019-04-06 00:05,URC,5611,737-800,18,6,29,6,6,30,,,,,11,12
2019-04-06 00:03,FOC,1559,737-800,21,3,16,23,25,24,,,,,-5,3
2019-04-06 00:02,ZGC,5371,737-800,12,9,18,5,6,19,,,,,6,7
2019-04-06 00:00,PEK,1496,737-800,16,7,28,6,8,30,,,,,12,14
2019-04-05 23:56,XIY,1103,737-800,22,4,26,4,4,22,,,,,4,0
2019-04-05 23:55,HAK,5479,737-800,24,6,27,6,6,30,,,,,3,6
2019-04-05 23:51,CGO,5638,737-800,22,4,26,4,4,26,,,,,4,4
2019-04-05 23:45,PEK,1215,737-800,15,4,25,4,5,22,,,,,10,7
2019-04-05 23:43,HAK,5522,737-800,25,6,30,8,8,30,,,,,5,5
2019-04-05 23:33,CKG,1728,737-800,20,4,28,5,5,22,,,,,8,2
2019-04-05 23:33,XIY,1130,737-800,23,2,23,2,2,22,,,,,0,-1
2019-04-05 23:31,MIG,5732,737-800,20,4,24,4,4,24,,,,,4,4
2019-04-05 23:31,SZX,1548,737-800,24,2,30,2,2,2,,,,,6,-22
2019-04-05 23:28,XIY,1213,737-800,20,4,24,4,4,22,,,,,4,2
2019-04-05 23:27,SZX,5358,737-800,24,5,27,6,6,28,,,,,3,4
2019-04-05 23:25,HAK,5082,737-800,25,4,34,4,4,0,,,,,9,-25
2019-04-05 23:21,PEK,1793,737-800,15,6,22,2,3,18,,,,,7,3
2019-04-05 23:20,URC,5713,737-800,10,6,0,6,6,0,,,,,-10,-10
2019-04-05 23:20,HAK,5089,737-800,25,2,24,2,2,30,,,,,-1,5
2019-04-05 23:16,HAK,5090,737-800,23,3,30,4,4,30,,,,,7,7
2019-04-05 23:05,CGO,205U,737-800,21,4,26,4,4,26,,,,,5,5
2019-04-05 23:00,HGH,5138,737-800,25,4,26,4,4,30,,,,,1,5
2019-04-05 22:55,SZX,1502,737-800,25,3,31,4,4,29,,,,,6,4
2019-04-05 22:55,CGO ,7167,737-800,21,5,28,6,5,27,,,,,7,6
2019-04-05 22:55,HAK,1538,737-800,24,3,33,4,2,29,,,,,9,5
2019-04-05 22:43,CAN,1796,737-800,25,6,30,4,4,29,,,,,5,4
2019-04-05 22:37,HHA,1375,737-800,22,4,24,4,3,24,,,,,2,2
2019-04-05 22:37,HAK,5373,737-800,25,5,28,5,6,30,,,,,3,5
2019-04-05 22:36,SZX,5463,737-800,24,6,26,4,4,24,,,,,2,0
2019-04-05 22:26,URC,1323,737-800,18,3,26,4,4,25,,,,,8,7
2019-04-05 22:23,CAN,1795,737-800,26,4,28,4,4,30,,,,,2,4
2019-04-05 22:22,URC,7175,737-800,21,5,29,5,4,22,,,,,8,1
2019-04-05 22:21,HAK,7399,737-800,24,4,32,4,5,30,,,,,8,6
2019-04-05 22:20,CGO,7991,737-800,21,6,26,5,5,25,,,,,5,4
2019-04-05 22:18,CAN,1729,737-800,25,4,23,4,4,24,,,,,-2,-1
2019-04-05 22:16,HAK,6062,737-800,24,4,30,9,8,36,,,,,6,12
2019-04-05 22:13,SYX ,206F,737-800,27,4,32,4,2,30,,,,,5,3
2019-04-05 22:10,XIY,1102,737-800,25,3,25,4,4,24,,,,,0,-1
2019-04-05 22:03,HAK,1547,737-800,25,6,30,6,5,31,,,,,5,6
2019-04-05 22:01,PEK,5141,737-800,14,4,14,1,5,24,,,,,0,10
2019-04-05 21:59,URC,1569,737-800,20,2,25,3,3,24,,,,,5,4
2019-04-05 21:58,XNN,1386,737-800,7,3,20,2,3,18,,,,,13,11
2019-04-05 21:48,CAN,5338,737-800,25,5,25,5,4,28,,,,,0,3
2019-04-05 21:46,XIY,1492,737-800,23,2,22,3,2,22,,,,,-1,-1
2019-04-05 21:40,PEK,7619,737-800,15,5,21,4,4,21,,,,,6,6
2019-04-05 21:19,MIG,BX6809,737-800,20,4,24,4,4,24,,,,,4,4
2019-04-05 21:16,HAK,5135,737-800,25,5,34,5,2,30,,,,,9,5
2019-04-05 21:13,XNN,1101,737-800,7,2,27,2,3,20,,,,,20,13
2019-04-05 20:56,PEK,5375,737-800,15,0,10,2,1,20,,,,,-5,5
2019-04-05 20:27,HGH,5372,737-800,21,8,27,9,8,26,,,,,6,5
2019-04-05 20:08,HAK,1570,737-800,25,5,28,6,6,27,,,,,3,2
2019-04-05 19:55,DLC,7377,737-800,14,5,22,6,6,24,,,,,8,10
2019-04-05 19:30,HAK,2652,737-800,25,6,34,6,5,22,,,,,9,-3
2019-04-05 19:04,HRB,1562,737-800,7,5,22,4,4,21,,,,,15,14
2019-04-05 16:59,XUZ,7992,737-800,26,6,27,7,6,26,,,,,1,0
2019-04-05 15:14,HAK,1493,737-800,25,6,32,6,6,30,,,,,7,5
2019-04-05 15:12,CTU,7990,737-800,25,2,27,4,4,27,,,,,2,2
2019-04-05 11:44,SZX,1549,737-800,25,6,30,6,5,30,,,,,5,5
2019-04-05 08:05,PEK,5855,737-800,17,5,20,6,5,22,,,,,3,5
2019-04-05 07:13,KMG,1586,737-800,15,4,22,4,4,22,,,,,7,7
2019-04-05 07:12,KMG,6800,737-800,20,4,20,4,5,20,,,,,0,0
2019-04-05 07:09,KMG,6016,737-800,15,4,25,4,4,22,,,,,10,7
2019-04-05 06:45,CKG,1373,737-800,15,2,14,3,3,18,,,,,-1,3
2019-04-05 06:43,CKG,1728,737-800,15,2,20,5,4,20,,,,,5,5
2019-04-05 05:33,URC,5625,737-800,15,10,22,8,8,24,1,,,1,7,9
2019-04-05 05:29,FOC,1433,737-800,17,2,14,2,2,0,,,,,-3,-17
2019-04-05 05:12,KMG ,5407,737-800,16,4,24,3,5,22,,,,,8,6
2019-04-05 04:59,SYX,5467,737-800,25,1,29,4,1,26,,,,,4,1
2019-04-05 04:59,URC,5502,737-800,15,4,22,6,4,22,,,,,7,7
2019-04-05 04:58,HAK,5463,737-800,27,5,27,5,6,25,,,,,0,-2
2019-04-05 04:57,DLC,5521,737-800,10,4,20,2,2,22,,,,,10,12
2019-04-05 04:56,CGO,7167,737-800,15,6,26,6,6,24,,,,,11,9
2019-04-05 04:49,URC,1929,737-800,16,3,21,4,3,22,,,,,5,6
2019-04-05 04:42,KMG,1588,737-800,15,4,20,3,4,20,,,,,5,5
2019-04-05 04:39,FOC,5182,737-800,20,3,28,4,4,26,,,,,8,6
2019-04-05 04:29,HAK,1101,737-800,25,2,35,2,3,34,,,,,10,9
2019-04-05 04:26,XIY,5116,737-800,22,3,20,3,4,20,,,,,-2,-2
2019-04-05 04:18,KMG,7992,737-800,20,8,25,6,8,23,,,,,5,3
2019-04-05 04:17,URC,7175,737-800,15,4,25,5,5,23,,,,,10,8
2019-04-05 04:15,PEK,5141,737-800,15,6,20,4,4,24,,,,,5,9
2019-04-05 04:11,HHA,5289,737-800,15,3,22,2,3,22,,,,,7,7
2019-04-05 04:07,PEK,5540,737-800,15,4,26,2,3,24,,,,,11,9
2019-04-05 04:06,HAK,1538,737-800,24,3,30,9,8,22,,,,,6,-2
2019-04-05 04:05,CAN,1501,737-800,20,3,29,4,4,26,,,,,9,6
2019-04-05 04:05,CGO,7991,737-800,17,5,24,6,6,24,,,,,7,7
2019-04-05 04:01,SZX,1497,737-800,22,2,26,2,3,25,,,,,4,3
2019-04-05 03:58,HGH,5581,737-800,14,7,16,3,3,20,,,,,2,6
2019-04-05 03:48,SYX,2158,737-800,26,5,29,3,3,27,,,,,3,1
2019-04-05 03:44,HHA,5636,737-800,20,4,25,4,4,24,,,,,5,4
2019-04-05 03:43,HGH,5372,737-800,15,8,24,8,7,22,,,,,9,7
2019-04-05 03:34,FOC,1350,737-800,17,4,20,8,9,9,,,,,3,-8
2019-04-05 03:32,PEK,5539,737-800,18,5,20,6,4,22,,,,,2,4
2019-04-05 03:30,CAN,5136,737-800,22,4,26,6,5,30,,,,,4,8
2019-04-05 03:28,CAN,5373,737-800,19,5,24,6,6,23,,,,,5,4
2019-04-05 03:26,HAK,5709,737-800,25,7,29,6,5,28,,,,,4,3
2019-04-05 03:23,HHA,1488,737-800,13,5,28,5,6,26,,,,,15,13
2019-04-05 03:20,HHA,1491,737-800,14,5,24,4,4,23,,,,,10,9
2019-04-05 03:15,CAN,5465,737-800,23,3,24,4,3,28,,,,,1,5
2019-04-05 03:13,XIY,1163,737-800,16,2,24,2,2,23,,,,,8,7
2019-04-05 03:12,XIY,1163,737-800,16,2,24,2,2,23,,,,,8,7
2019-04-05 03:12,CGO,1798,737-800,18,6,28,6,6,24,,,,,10,6
2019-04-05 03:06,XIY,5620,737-800,18,2,28,2,4,22,,,,,10,4
2019-04-05 03:04,HAK,5375,737-800,25,8,32,7,6,31,,,,,7,6
2019-04-05 03:01,SYX,5662,737-800,26,3,31,3,5,31,,,,,5,5
2019-04-05 02:59,DLC,5712,737-800,15,5,28,6,5,29,,,,,13,14
2019-04-05 02:58,HAK,5138,737-800,25,4,28,5,4,36,,1,,1,3,11
2019-04-05 02:53,URC,1568,737-800,18,6,23,6,6,21,,,,,5,3
2019-04-05 02:51,SZX,1498,737-800,23,6,30,5,5,28,,,,,7,5
2019-04-05 02:49,XIY,5430,737-800,18,6,28,7,7,29,,,,,10,11
2019-04-05 02:49,HAK,206G,737-800,25,2,36,4,3,32,1,,,1,11,7
2019-04-05 02:41,XIY,5115,737-800,20,5,29,6,5,28,,,,,9,8
2019-04-05 02:40,KMG,7993,737-800,15,6,25,6,6,20,,,,,10,5
2019-04-05 02:40,HGH,5483,737-800,15,4,28,5,5,24,,,,,13,9
2019-04-05 02:39,PEK,5538,737-800,15,6,26,4,4,24,,,,,11,9
2019-04-05 02:35,URC,5637,737-800,15,4,24,2,2,21,,,,,9,6
2019-04-05 02:33,SZX,5417,737-800,24,4,24,4,4,28,,,,,0,4
2019-04-05 02:33,KMG,1209,737-800,15,4,25,4,4,20,,,,,10,5
2019-04-05 02:32,XIY,1346,737-800,18,6,26,6,6,24,,,,,8,6
2019-04-05 02:32,HAK,7399,737-800,26,5,31,5,4,29,,,,,5,3
2019-04-05 02:31,XIY,5115,737-800,20,6,29,6,5,28,,,,,9,8
2019-04-05 02:31,CAN,6066,737-800,20,4,27,3,3,25,,,,,7,5
2019-04-05 02:30,XMN,7618,737-800,16,5,26,5,4,25,,,,,10,9
2019-04-05 02:30,XIY,6103,737-800,18,6,22,6,6,23,,,,,4,5
2019-04-05 02:30,CAN,5428,737-800,20,4,24,6,4,28,,,,,4,8
2019-04-05 02:29,XMN,1928,737-800,15,3,17,2,3,17,,,,,2,2
2019-04-05 02:29,XIY,1483,737-800,20,4,22,4,4,24,,,,,2,4
2019-04-05 02:27,HHA,7172,737-800,15,4,24,4,4,24,,,,,9,9
2019-04-05 02:25,FOC,5733,737-800,19,7,26,8,7,20,,,,,7,1
2019-04-05 02:21,URC,6268,737-800,19,2,18,3,4,18,,,,,-1,-1
2019-04-05 02:21,PEK ,1995,737-800,19,5,24,6,6,25,,,,,5,6
2019-04-05 02:18,URC,1372,737-800,15,4,26,8,8,26,,,,,11,11
2019-04-05 02:17,PEK,5482,737-800,15,0,20,4,4,24,,,,,5,9
2019-04-05 02:16,XIY,1903,737-800,10,2,23,2,3,24,,,,,13,14
2019-04-05 02:15,XIY,1482,737-800,18,8,30,6,6,23,,,,,12,5
2019-04-05 02:12,HAK,5479,737-800,25,2,36,5,4,33,1,,,1,11,8
2019-04-05 02:12,XIY,1902,737-800,12,4,24,4,5,23,,,,,12,11
2019-04-05 02:12,HAK,1786,737-800,25,2,27,4,4,26,,,,,2,1
2019-04-05 02:09,URC,5853,737-800,18,6,14,6,6,18,,,,,-4,0
2019-04-05 02:09,DLC,5623,737-800,14,8,26,7,7,24,,,,,12,10
2019-04-05 02:04,URC,2159,737-800,18,7,18,2,3,20,,,,,0,2
2019-04-05 02:03,SZX,5687,737-800,23,5,22,4,4,29,,,,,-1,6
2019-04-05 02:02,URC,6995,737-800,15,4,24,6,5,20,,,,,9,5
2019-04-05 02:02,HGH,1503,737-800,14,3,24,3,3,22,,,,,10,8
2019-04-05 02:01,URC,206P,737-800,10,2,24,4,3,22,,,,,14,12
2019-04-05 02:01,XIY,1783,737-800,18,4,22,4,4,24,,,,,4,6
2019-04-05 01:54,FOC,7395,737-800,16,4,26,6,4,24,,,,,10,8
2019-04-05 01:54,URC,2157,737-800,10,4,20,6,6,22,,,,,10,12
2019-04-05 01:52,CAN,1501,737-800,20,3,29,4,4,26,,,,,9,6
2019-04-05 01:52,HHA,7171,737-800,20,8,22,5,5,22,,,,,2,2
2019-04-05 01:48,URC,1322,737-800,20,4,26,2,2,22,,,,,6,2
2019-04-05 01:46,ZGC,1726,737-800,4,7,21,4,6,24,,,,,17,20
2019-04-05 01:43,HGH,5579,737-800,15,5,28,6,6,24,,,,,13,9
2019-04-05 01:42,ZGC,5371,737-800,3,7,21,6,7,22,,,,,18,19
2019-04-05 01:41,PEK,1347,737-800,20,4,23,4,4,22,,,,,3,2
2019-04-05 01:41,HAK,1733,737-800,26,3,30,3,3,25,,,,,4,-1
2019-04-05 01:40,PEK,6060,737-800,20,5,22,6,5,24,,,,,2,4
2019-04-05 01:40,YIH,1906,737-800,18,6,27,8,7,25,,,,,9,7
2019-04-05 01:37,ZGC,1726,737-800,4,7,2,4,6,24,,,,,-2,20
2019-04-05 01:34,URC,1793,737-800,18,5,24,5,5,22,,,,,6,4
2019-04-05 01:33,URC,5713,737-800,19,6,20,6,6,20,,,,,1,1
2019-04-05 01:31,SYX,1735,737-800,27,3,28,5,4,27,,,,,1,0
2019-04-05 01:28,SZX,1502,737-800,25,3,25,3,4,25,,,,,0,0
2019-04-05 01:27,SYX,206H,737-800,25,4,22,2,2,22,,,,,-3,-3
2019-04-05 01:27,CGO,5480,737-800,17,3,23,3,3,22,,,,,6,5
2019-04-05 01:24,HAK,5082,737-800,25,4,33,4,4,0,,,,,8,-25
2019-04-05 01:18,CGO,1587,737-800,18,2,22,2,3,22,,,,,4,4
2019-04-05 01:17,FOC,5503,737-800,22,4,24,4,2,25,,,,,2,3
2019-04-05 01:16,HHA,5418,737-800,16,2,22,5,5,24,,,,,6,8
2019-04-05 01:15,KMG,7989,737-800,15,6,22,6,6,20,,,,,7,5
2019-04-05 01:15,HAK,1101,737-800,26,4,30,3,2,31,,,,,4,5
2019-04-05 01:08,KMG,1208,737-800,16,4,23,4,3,20,,,,,7,4
2019-04-05 01:05,HAK,5405,737-800,25,8,34,5,4,32,,,,,9,7
2019-04-05 01:04,CAN,1795,737-800,21,4,28,4,4,28,,,,,7,7
2019-04-05 01:03,XIY,5180,737-800,18,5,22,5,5,23,,,,,4,5
2019-04-05 01:02,URC,1996,737-800,18,6,23,5,5,22,,,,,5,4
2019-04-05 01:02,XIY,1161,737-800,17,3,19,4,3,20,,,,,2,3
2019-04-05 01:00,XIY,1902,737-800,11,4,24,4,5,23,,,,,13,12
2019-04-05 00:57,URC,5611,737-800,15,6,24,6,6,24,,,,,9,9
2019-04-05 00:54,YIH,1348,737-800,22,4,26,4,3,24,,,,,4,2
2019-04-05 00:53,H?R?B,1562,737-800,2,4,20,4,4,18,,,,,18,16
2019-04-05 00:50,CAN,1796,737-800,23,6,30,4,4,26,,,,,7,3
2019-04-05 00:48,´óÁ¬,1541,737-800,14,6,28,6,4,24,,,,,14,10
2019-04-05 00:43,XIY,1103,737-800,20,4,20,4,4,20,,,,,0,0
2019-04-05 00:43,ÃàÑô,5449,737-800,22,5,26,6,5,24,,,,,4,2
2019-04-05 00:42,HAK,1799,737-800,25,4,34,5,5,32,,,,,9,7
2019-04-05 00:42,HGH,7378,737-800,17,4,20,6,6,22,,,,,3,5
2019-04-05 00:39,HGH,2647,737-800,19,6,23,5,6,24,,,,,4,5
2019-04-05 00:38,KHG,1323,737-800,20,3,24,4,4,24,,,,,4,4
2019-04-05 00:38,HRB,7105,737-800,2,4,22,4,4,20,,,,,20,18
2019-04-05 00:36,HAK,5522,737-800,25,4,24,7,6,29,,,,,-1,4
2019-04-05 00:35,TYN,1547,737-800,14,6,20,6,6,20,,,,,6,6
2019-04-05 00:33,DLC,7377,737-800,14,6,21,6,5,25,,,,,7,11
2019-04-05 00:33,HHA,7398,737-800,15,4,26,3,3,22,,,,,11,7
2019-04-05 00:33,XIY,5478,737-800,20,5,20,6,5,21,,,,,0,1
2019-04-05 00:32,TYN,5462,737-800,14,4,20,6,5,24,,,,,6,10
2019-04-05 00:32,ÃàÑô,6809,737-800,20,5,24,6,6,23,,,,,4,3
2019-04-05 00:23,SZX,5358,737-800,25,5,26,5,6,25,,,,,1,0
2019-04-05 00:21,HRB,1435,737-800,4,4,16,7,7,27,,,,,12,23
2019-04-05 00:21,CAN,1495,737-800,21,5,28,4,4,27,,,,,7,6
2019-04-05 00:19,SYX,1487,737-800,26,3,30,4,3,29,,,,,4,3
2019-04-05 00:19,PEK,1496,737-800,22,6,25,6,6,26,,,,,3,4
2019-04-05 00:17,SZX,1102,737-800,23,3,22,3,4,22,,,,,-1,-1
2019-04-05 00:16,HAK,1542,737-800,26,5,34,4,4,30,,,,,8,4
2019-04-05 00:14,TYN,5661,737-800,15,3,20,4,5,22,,,,,5,7
2019-04-05 00:12,HAK,5337,737-800,25,4,32,4,4,33,,,,,7,8
2019-04-05 00:00,HAK,5089,737-800,26,2,24,2,1,30,,,,,-2,4
2019-04-04 23:59,CAN,7173,737-800,22,4,27,6,5,27,,,,,5,5
2019-04-04 23:59,CGO,205U,737-800,20,4,26,4,3,23,,,,,6,3
2019-04-04 23:57,HAK,5429,737-800,25,3,29,2,3,29,,,,,4,4
2019-04-04 23:55,SZX,5408,737-800,25,4,30,4,4,24,,,,,5,-1
2019-04-04 23:54,XUZ,7988,737-800,20,2,22,1,1,20,,,,,2,0
2019-04-04 23:46,HHA,2652,737-800,20,4,22,5,5,22,,,,,2,2
2019-04-04 23:44,XIY,7616,737-800,18,4,23,4,4,23,,,,,5,5
2019-04-04 23:43,XMN,1375,737-800,20,4,27,4,3,26,,,,,7,6
2019-04-04 23:42,URC,205T,737-800,20,4,24,2,3,24,,,,,4,4
2019-04-04 23:40,XIY,6063,737-800,20,7,31,7,8,29,,,,,11,9
2019-04-04 23:40,CGO,5638,737-800,20,4,21,3,4,21,,,,,1,1
2019-04-04 23:40,¹þ¶û±õ,1480,737-800,4,5,16,4,4,15,,,,,12,11
2019-04-04 23:38,´óÁ¬,7619,737-800,15,5,24,6,4,22,,,,,9,7
2019-04-04 23:34,URC,1570,737-800,19,6,12,5,5,20,,,,,-7,1
2019-04-04 23:31,XMN,5798,737-800,15,3,20,2,3,17,,,,,5,2
2019-04-04 23:30,DLC,7377,737-800,12,6,21,6,5,25,,,,,9,13
2019-04-04 23:30,FOC,1351,737-800,18,4,26,3,3,22,,,,,8,4
2019-04-04 23:26,URC,5406,737-800,15,2,22,7,4,22,,,,,7,7
2019-04-04 23:25,URC,5406,737-800,15,2,22,7,4,22,,,,,7,7
2019-04-04 23:25,SYX,1545,737-800,27,5,32,5,5,32,,,,,5,5
2019-04-04 23:20,CAN,6061,737-800,21,5,27,4,4,26,,,,,6,5
2019-04-04 23:14,ÃàÑô,5409,737-800,20,4,24,4,4,25,,,,,4,5
2019-04-04 23:11,XIY,5439,737-800,21,4,20,4,4,22,,,,,-1,1
2019-04-04 23:07,URC,1569,737-800,19,4,22,2,2,22,,,,,3,3
2019-04-04 23:02,CAN,7886,737-800,23,3,30,4,3,30,,,,,7,7
2019-04-04 22:58,PEK,1141,737-800,20,6,26,6,6,26,,,,,6,6
2019-04-04 22:57,TYN,7639,737-800,15,6,26,6,6,23,1,,,1,11,8
2019-04-04 22:56,XIY,5139,737-800,20,4,25,6,4,30,,,,,5,10
2019-04-04 22:55,SYX,206F,737-800,26,3,33,3,3,29,,,,,7,3
2019-04-04 22:54,CKG,1997,737-800,16,4,25,4,4,22,,,,,9,6
2019-04-04 22:53,URC,1325,737-800,10,5,28,4,4,20,,,,,18,10
2019-04-04 22:41,HAK,5466,737-800,24,6,28,8,3,29,,,,,4,5
2019-04-04 22:39,CAN,5338,737-800,20,4,22,3,2,26,,,,,2,6
2019-04-04 22:30,HAK,1729,737-800,25,4,26,4,3,26,,,,,1,1
2019-04-04 22:14,PEK,7379,737-800,22,4,26,3,3,29,,,,,4,7
2019-04-04 22:12,SYX,1489,737-800,25,6,32,4,4,30,,,,,7,5
2019-04-04 22:03,XNN,1386,737-800,7,3,20,3,3,18,,,,,13,11
2019-04-04 21:54,HAK,1101,737-800,25,2,36,2,3,34,,,,,11,9
2019-04-04 21:51,XIY,1130,737-800,21,2,29,2,2,23,,,,,8,2
2019-04-04 21:48,HAK,6808,737-800,26,4,34,5,4,31,,,,,8,5
2019-04-04 21:46,PEK,1215,737-800,15,3,23,3,4,24,,,,,8,9
2019-04-04 21:45,´óÁ¬,1213,737-800,16,6,28,6,6,24,,,,,12,8
2019-04-04 21:37,SHE,1493,737-800,20,6,24,6,6,20,,,,,4,0
2019-04-04 21:34,PEK,1505,737-800,25,4,22,3,2,20,,,,,-3,-5
2019-04-04 21:29,XNN,6062,737-800,7,3,20,3,2,20,,,,,13,13
2019-04-04 21:25,ÃàÑô,5732,737-800,20,3,23,3,3,24,,,,,3,4
2019-04-04 20:58,KMG,6800,737-800,21,4,20,5,4,21,,,,,-1,0
2019-04-04 20:55,PEK,BX1131,737-800,26,4,27,5,4,27,,,,,1,1
2019-04-04 20:45,SHE,1927,737-800,10,4,20,8,4,24,,,,,10,14
2019-04-04 20:34,HAK,5090,737-800,25,2,31,1,2,30,,,,,6,5
2019-04-04 20:11,HAK,5346,737-800,25,5,32,5,3,30,,,,,7,5
2019-04-04 20:04,HGH,5416,737-800,15,7,22,8,7,26,,,,,7,11
2019-04-04 19:31,¸£ÖÝ,1559,737-800,18,3,28,2,2,24,,,,,10,6
2019-04-04 17:53,HGH,1733,737-800,20,3,20,2,2,16,,,,,0,-4
2019-04-04 15:17,TYN,6065,737-800,20,5,24,4,5,25,,,,,4,5
2019-04-04 15:03,URC,206P,737-800,15,3,18,2,2,19,,,,,3,4
2019-04-04 15:02,URC,2159,737-800,15,8,18,0,1,19,,,,,3,4
2019-04-04 14:31,XIY,1787,737-800,25,0,22,0,1,21,,,,,-3,-4
2019-04-04 14:06,URC,7198,737-800,20,5,21,6,5,22,,,,,1,2
2019-04-04 14:01,CTU,7990,737-800,20,5,28,3,3,25,,,,,8,5
2019-04-04 09:16,HAK,5153,737-800,25,5,32,5,5,30,,,,,7,5
2019-04-04 09:00,HAK,5466,737-800,25,1,27,9,1,28,,,,,2,3
2019-04-04 08:58,HAK,5138,737-800,25,4,32,5,4,35,,,,,7,10
2019-04-04 07:54,PEK ,7173,737-800,15,4,20,5,5,20,,,,,5,5
2019-04-04 07:25,HAK,5480,737-800,25,6,32,8,4,28,,,,,7,3
2019-04-04 07:24,CAN,5439,737-800,19,4,26,4,4,26,,,,,7,7
2019-04-04 07:01,SZX,1502,737-800,24,6,24,5,6,27,,,,,0,3
2019-04-04 06:51,PEK,5540,737-800,13,6,22,5,5,23,,,,,9,10
2019-04-04 06:49,SZX,5358,737-800,25,8,22,4,5,24,,,,,-3,-1
2019-04-04 06:49,CAN,1795,737-800,25,3,30,4,4,30,,,,,5,5
2019-04-04 06:48,SZX,5687,737-800,23,4,20,5,4,26,,,,,-3,3
2019-04-04 06:44,SZX,5520,737-800,24,4,32,6,5,28,,,,,8,4
2019-04-04 06:40,URC,5637,737-800,14,1,20,2,1,22,,,,,6,8
2019-04-04 06:39,SZX,1538,737-800,24,3,30,4,3,23,,,,,6,-1
2019-04-04 06:33,URC,5713,737-800,18,7,22,6,6,20,,,,,4,2
2019-04-04 06:28,CGO,7167,737-800,16,5,26,5,5,23,,,,,10,7
2019-04-04 06:19,URC,6268,737-800,15,5,26,5,5,27,,,,,11,12
2019-04-04 06:06,PEK,5855,737-800,15,6,22,5,5,24,,,,,7,9
2019-04-04 05:21,SZX,1102,737-800,25,3,28,3,3,29,,,,,3,4
2019-04-04 05:20,SZX,5687,737-800,23,4,20,5,4,26,,,,,-3,3
2019-04-04 05:20,SZX,1927,737-800,23,4,22,4,6,24,,,,,-1,1
2019-04-04 05:16,XIY,1541,737-800,18,5,26,6,5,24,,,,,8,6
2019-04-04 05:15,HGH,1733,737-800,14,2,21,3,3,22,,,,,7,8
2019-04-04 05:11,HAK,7399,737-800,25,4,32,5,4,28,,,,,7,3
2019-04-04 05:11,XIY,1902,737-800,10,7,20,6,7,22,,,,,10,12
2019-04-04 05:09,XIY,5478,737-800,18,5,24,5,5,26,,,,,6,8
2019-04-04 05:09,XIY,1903,737-800,13,7,22,7,8,24,,,,,9,11
2019-04-04 05:08,XIY,5180,737-800,11,6,22,6,6,22,,,,,11,11
2019-04-04 05:07,URC,205T,737-800,15,2,24,2,2,24,,,,,9,9
2019-04-04 05:05,HGH,1733,737-800,14,2,21,3,3,22,,,,,7,8
2019-04-04 05:04,XIY,5139,737-800,18,3,21,5,4,20,,,,,3,2
2019-04-04 04:59,HAK,5408,737-800,25,7,28,5,4,30,,,,,3,5
2019-04-04 04:55,CAN,7886,737-800,21,4,32,4,3,30,,,,,11,9
2019-04-04 04:41,XIY,1483,737-800,12,4,22,6,6,21,,,,,10,9
2019-04-04 04:36,XIY,5521,737-800,15,4,20,2,2,18,,,,,5,3
2019-04-04 04:29,FOC,1433,737-800,14,3,25,4,4,24,,,,,11,10
2019-04-04 04:26,KMG,1587,737-800,12,3,19,3,3,18,,,,,7,6
2019-04-04 04:23,KMG,7993,737-800,14,6,24,6,6,20,,,,,10,6
2019-04-04 04:20,TYN,5373,737-800,13,6,20,6,6,20,,,,,7,7
2019-04-04 04:18,PEK,5482,737-800,13,0,16,5,5,15,,,,,3,2
2019-04-04 04:17,HAK,5337,737-800,25,5,33,6,5,24,,,,,8,-1
2019-04-04 04:15,HAK,5522,737-800,24,6,32,9,9,33,,,,,8,9
2019-04-04 04:11,HHA,5636,737-800,15,4,26,4,4,25,,,,,11,10
2019-04-04 04:07,SZX,5358,737-800,25,8,22,4,5,24,,,,,-3,-1
2019-04-04 04:07,SYX,1487,737-800,25,7,26,6,7,28,,,,,1,3
2019-04-04 04:06,PEK,5539,737-800,13,2,18,2,4,27,,,,,5,14
2019-04-04 04:01,XIY,1130,737-800,12,2,27,4,3,21,,,,,15,9
2019-04-04 03:57,FOC,5733,737-800,16,7,28,7,8,27,,,,,12,11
2019-04-04 03:56,FOC,1562,737-800,15,5,26,5,5,26,,,,,11,11
2019-04-04 03:56,CAN,1501,737-800,20,4,30,4,4,20,,,,,10,0
2019-04-04 03:53,KMG,6015,737-800,12,6,20,4,4,20,,,,,8,8
2019-04-04 03:47,HHA,I7172,737-800,18,4,27,5,4,26,,,,,9,8
2019-04-04 03:39,HAK,5429,737-800,24,4,31,4,3,30,,,,,7,6
2019-04-04 03:38,CAN,1799,737-800,20,6,30,6,6,28,,,,,10,8
2019-04-04 03:37,XIY,6103,737-800,15,4,20,4,4,18,,,,,5,3
2019-04-04 03:35,XIY,5116,737-800,13,3,20,3,3,18,,,,,7,5
2019-04-04 03:34,CGO,1798,737-800,15,6,22,4,4,22,,,,,7,7
2019-04-04 03:34,URC,7175,737-800,16,5,24,5,6,22,,,,,8,6
2019-04-04 03:33,PEK,1787,737-800,13,2,20,0,0,18,,,,,7,5
2019-04-04 03:32,HAK,6808,737-800,25,4,34,5,5,30,,,,,9,5
2019-04-04 03:29,KMG,7989,737-800,13,6,24,6,5,21,,,,,11,8
2019-04-04 03:22,HHA,5852,737-800,15,4,22,4,4,20,,,,,7,5
2019-04-04 03:22,URC,1568,737-800,16,4,24,6,6,20,,,,,8,4
2019-04-04 03:11,HAK,1727,737-800,25,5,32,6,5,28,,,,,7,3
2019-04-04 03:09,DLC,1103,737-800,15,6,28,4,4,22,,,,,13,7
2019-04-04 03:06,XIY,5430,737-800,15,6,26,6,6,26,,,,,11,11
2019-04-04 03:06,PEK,2652,737-800,13,0,16,6,6,12,,,,,3,-1
2019-04-04 03:05,XIY,1161,737-800,12,2,20,3,4,18,,,,,8,6
2019-04-04 03:05,XIY,1162,737-800,15,2,26,3,3,22,,,,,11,7
2019-04-04 03:05,XIY,5115,737-800,12,4,22,3,6,19,,,,,10,7
2019-04-04 03:05,KMG,6016,737-800,14,0,30,3,4,24,,,,,16,10
2019-04-04 02:59,SZX,1102,737-800,25,3,28,3,3,29,,,,,3,4
2019-04-04 02:59,CAN,1501,737-800,20,4,30,4,4,20,,,,,10,0
2019-04-04 02:58,XIY,1161,737-800,12,2,20,3,4,18,,,,,8,6
2019-04-04 02:56,XIY,7113,737-800,15,6,24,5,5,21,,,,,9,6
2019-04-04 02:55,PEK,5538,737-800,15,3,24,3,3,26,,,,,9,11
2019-04-04 02:53,PEK,1495,737-800,16,3,22,3,2,20,,,,,6,4
2019-04-04 02:53,XIY,1482,737-800,15,5,26,5,5,22,,,,,11,7
2019-04-04 02:53,SYX,1735,737-800,27,4,33,4,4,28,,,,,6,1
2019-04-04 02:51,KMG,5407,737-800,8,4,24,4,4,21,,,,,16,13
2019-04-04 02:47,SYX,1545,737-800,27,5,32,5,5,31,,,,,5,4
2019-04-04 02:47,SZX,5520,737-800,24,4,32,6,5,28,,,,,8,4
2019-04-04 02:46,XIY,6063,737-800,14,5,24,5,5,22,,,,,10,8
2019-04-04 02:45,URC,1929,737-800,15,4,22,2,2,22,,,,,7,7
2019-04-04 02:43,HRB,7105,737-800,2,4,21,4,4,22,,,,,19,20
2019-04-04 02:40,KMG,7991,737-800,15,7,22,7,7,21,,,,,7,6
2019-04-04 02:40,URC,1996,737-800,15,6,22,5,5,22,,,,,7,7
2019-04-04 02:39,CAN,5338,737-800,25,3,26,3,3,26,,,,,1,1
2019-04-04 02:33,XMN,5798,737-800,20,3,20,2,3,22,,,,,0,2
2019-04-04 02:29,XIY,6060,737-800,15,6,22,6,6,24,,,,,7,9
2019-04-04 02:28,XIY,5465,737-800,20,4,22,4,4,22,,,,,2,2
2019-04-04 02:28,XIY,5465,737-800,20,4,22,4,4,22,,,,,2,2
2019-04-04 02:28,HAK,5467,737-800,26,0,29,0,0,24,,,,,3,-2
2019-04-04 02:28,KMG,1586,737-800,11,4,22,4,4,22,,,,,11,11
2019-04-04 02:26,ÃàÑô,6800,737-800,16,4,24,4,3,23,,,,,8,7
2019-04-04 02:23,HHA,7398,737-800,15,4,24,4,4,22,,,,,9,7
2019-04-04 02:21,DLC,7400,737-800,15,5,22,5,4,22,,,,,7,7
2019-04-04 02:21,URC,5406,737-800,17,4,18,6,4,22,,,,,1,5
2019-04-04 02:20,FOC,5503,737-800,14,3,23,3,3,24,,,,,9,10
2019-04-04 02:20,URC,1322,737-800,16,3,23,4,4,22,,,,,7,6
2019-04-04 02:19,SYX,2158,737-800,27,7,30,5,4,30,,,,,3,3
2019-04-04 02:19,URC,1322,737-800,17,3,26,4,4,22,,,,,9,5
2019-04-04 02:17,URC,2157,737-800,15,4,22,8,6,28,,,,,7,13
2019-04-04 02:15,URC,5406,737-800,17,4,18,6,4,22,,,,,1,5
2019-04-04 02:10,DLC,7619,737-800,14,4,20,3,3,22,,,,,6,8
2019-04-04 02:09,XMN,1492,737-800,21,3,29,3,3,28,,,,,8,7
2019-04-04 02:08,HHA,1491,737-800,16,6,28,5,5,27,,,,,12,11
2019-04-04 02:06,URC,5625,737-800,20,4,20,0,2,22,,,,,0,2
2019-04-04 02:06,XMN,5735,737-800,20,5,27,5,6,28,,,,,7,8
2019-04-04 02:05,XIY,1163,737-800,15,8,30,8,6,34,,1,,1,15,19
2019-04-04 02:03,ZGC,1785,737-800,5,5,19,7,8,21,,,,,14,16
2019-04-04 02:02,PEK,5709,737-800,12,8,25,8,6,24,,,,,13,12
2019-04-04 02:02,TYN,5661,737-800,13,5,24,5,5,22,,,,,11,9
2019-04-04 02:01,ZGC,1928,737-800,5,8,24,5,6,22,,,,,19,17
2019-04-04 02:01,HGH,5372,737-800,15,6,24,6,6,22,,,,,9,7
2019-04-04 01:59,FOC,5185,737-800,18,2,24,2,3,22,,,,,6,4
2019-04-04 01:59,HAK,1215,737-800,25,2,26,4,4,32,,,,,1,7
2019-04-04 01:55,FOC,7395,737-800,17,6,24,7,6,25,,,,,7,8
2019-04-04 01:52,HGH,5502,737-800,14,6,24,4,4,26,,,,,10,12
2019-04-04 01:46,HAK,5090,737-800,25,2,28,7,8,28,,,,,3,3
2019-04-04 01:43,YIH,1348,737-800,15,4,24,6,6,28,,,,,9,13
2019-04-04 01:43,YIH,1906,737-800,15,6,26,4,6,24,,,,,11,9
2019-04-04 01:42,URC,7618,737-800,16,5,23,4,5,20,,,,,7,4
2019-04-04 01:39,URC,7198,737-800,16,6,24,4,4,22,,,,,8,6
2019-04-04 01:37,CGO,1728,737-800,16,6,20,6,6,20,,,,,4,4
2019-04-04 01:36,KMG,1209,737-800,16,3,24,4,4,20,,,,,8,4
2019-04-04 01:35,SYX,1503,737-800,26,2,30,2,2,30,,,,,4,4
2019-04-04 01:35,CAN,1141,737-800,25,4,22,5,5,28,,,,,-3,3
2019-04-04 01:35,URC,205U,737-800,16,4,24,3,4,21,,,,,8,5
2019-04-04 01:34,HHA,5405,737-800,15,4,27,5,4,24,,,,,12,9
2019-04-04 01:33,URC,205V,737-800,16,4,24,3,4,21,,,,,8,5
2019-04-04 01:33,XMN,1725,737-800,20,4,30,4,4,28,,,,,10,8
2019-04-04 01:31,HAK,1726,737-800,25,4,33,0,0,0,,,,,8,-25
2019-04-04 01:31,SYX,206H,737-800,26,4,20,0,0,26,,,,,-6,0
2019-04-04 01:27,SYX,1489,737-800,27,4,31,4,4,30,,,,,4,3
2019-04-04 01:26,PEK,1375,737-800,10,6,20,2,2,20,,,,,10,10
2019-04-04 01:22,DLC,5712,737-800,14,2,15,1,0,15,,,,,1,1
2019-04-04 01:21,SYX,5662,737-800,27,3,26,4,5,27,,,,,-1,0
2019-04-04 01:17,FOC,1351,737-800,14,4,28,4,4,21,,,,,14,7
2019-04-04 01:15,HGH,1101,737-800,14,4,32,4,2,22,1,,,1,18,8
2019-04-04 01:10,HAK,1498,737-800,26,6,33,6,6,30,,,,,7,4
2019-04-04 01:09,HAK,206G,737-800,24,4,34,4,4,32,,,,,10,8
2019-04-04 01:08,HHA,5418,737-800,15,3,0,4,3,18,,,,,-15,3
2019-04-04 01:04,PEK,1496,737-800,15,6,26,5,5,26,,,,,11,11
2019-04-04 01:01,DLC,1488,737-800,14,6,26,6,6,22,,,,,12,8
2019-04-04 01:00,DLC,5623,737-800,10,5,22,6,6,20,,,,,12,10
2019-04-04 01:00,HAK,5579,737-800,25,4,32,6,6,32,,,,,7,7
2019-04-04 00:59,DLC,1213,737-800,14,6,26,6,6,23,,,,,12,9
2019-04-04 00:58,CAN,6061,737-800,25,4,28,4,4,30,,,,,3,5
2019-04-04 00:58,TYN,1547,737-800,13,6,21,6,5,20,,,,,8,7
2019-04-04 00:56,DLC,5620,737-800,15,3,26,3,3,20,,,,,11,5
2019-04-04 00:56,URC,1793,737-800,15,4,22,4,6,20,,,,,7,5
2019-04-04 00:55,CAN,7379,737-800,23,4,32,4,4,32,,,,,9,9
2019-04-04 00:50,ÖØÇì,5135,737-800,15,2,24,4,2,22,,,,,9,7
2019-04-04 00:44,HRB,1435,737-800,0,6,20,7,6,21,,,,,20,21
2019-04-04 00:37,URC,5853,737-800,16,6,20,6,7,22,,,,,4,6
2019-04-04 00:33,CKG,1373,737-800,14,4,23,4,4,20,,,,,9,6
2019-04-04 00:33,SZX,5417,737-800,26,6,24,4,4,26,,,,,-2,0
2019-04-04 00:32,URC,1323,737-800,13,3,25,3,3,26,,,,,12,13
2019-04-04 00:31,CAN,5428,737-800,25,4,30,5,4,30,,,,,5,5
2019-04-04 00:27,URC,5611,737-800,13,5,23,4,4,20,,,,,10,7
2019-04-04 00:27,HGH,5479,737-800,15,5,22,5,5,22,,,,,7,7
2019-04-04 00:27,XIY,5115,737-800,12,3,15,5,5,24,,,,,3,12
2019-04-04 00:26,URC,205T,737-800,17,2,24,2,2,24,,,,,7,7
2019-04-04 00:25,HAK,1493,737-800,26,6,30,6,6,28,,,,,4,2
2019-04-04 00:22,ÃàÑô,5409,737-800,17,4,25,5,4,27,,,,,8,10
2019-04-04 00:10,KHG,1325,737-800,18,4,24,4,4,20,,,,,6,2
2019-04-04 00:08,HAK,1796,737-800,24,6,32,6,4,30,,,,,8,6
2019-04-04 00:05,TYN,5462,737-800,20,2,24,5,5,26,,,,,4,6
2019-04-03 23:55,HRB,1480,737-800,5,6,18,4,4,16,,,,,13,11
2019-04-03 23:54,HGH,5371,737-800,15,6,20,5,6,24,,,,,5,9
2019-04-03 23:52,SYX,206F,737-800,25,2,32,3,3,30,,,,,7,5
2019-04-03 23:51,CAN,1548,737-800,25,3,28,4,3,32,,,,,3,7
2019-04-03 23:50,URC,1347,737-800,17,4,18,2,4,20,,,,,1,3
2019-04-03 23:49,CGO,1570,737-800,16,4,22,5,5,20,,,,,6,4
2019-04-03 23:46,XUZ,1497,737-800,16,3,24,3,3,23,,,,,8,7
2019-04-03 23:45,ÃàÑô,5449,737-800,21,4,24,6,6,22,,,,,3,1
2019-04-03 23:41,FOC,1350,737-800,19,2,22,3,4,24,,,,,3,5
2019-04-03 23:40,XIY,7616,737-800,20,4,20,4,4,24,,,,,0,4
2019-04-03 23:38,PEK,1995,737-800,15,6,24,6,6,22,,,,,9,7
2019-04-03 23:38,CGO,1997,737-800,18,3,27,3,3,22,,,,,9,4
2019-04-03 23:37,HHA,5686,737-800,15,5,25,4,4,24,,,,,10,9
2019-04-03 23:35,XNN,1386,737-800,7,3,20,3,3,16,,,,,13,9
2019-04-03 23:30,HAK,1490,737-800,25,5,34,6,6,31,,,,,9,6
2019-04-03 23:25,CANN,1495,737-800,25,3,30,4,4,32,,,,,5,7
2019-04-03 23:15,URC,1569,737-800,17,2,27,2,2,24,,,,,10,7
2019-04-03 23:10,KMG,7992,737-800,13,7,24,7,6,22,,,,,11,9
2019-04-03 23:10,HHA,1131,737-800,14,4,24,4,4,25,,,,,10,11
2019-04-03 23:07,HAK,5089,737-800,26,2,24,1,1,32,,,,,-2,6
2019-04-03 23:02,CAN,6066,737-800,23,4,30,3,2,26,,,,,7,3
2019-04-03 22:58,CKG,5638,737-800,14,5,23,6,6,22,,,,,9,8
2019-04-03 22:57,CAN,5136,737-800,25,4,30,5,5,35,,1,,1,5,10
2019-04-03 22:53,PEK,7377,737-800,18,6,22,6,6,26,,,,,4,8
2019-04-03 22:51,HAK,2647,737-800,25,5,26,7,7,26,,,,,1,1
2019-04-03 22:37,CGO,1208,737-800,16,3,22,4,4,16,,,,,6,0
2019-04-03 22:27,HAK,6065,737-800,25,6,32,5,4,32,,,,,7,7
2019-04-03 22:23,HAK,1786,737-800,26,4,32,3,3,3,,,,,6,-23
2019-04-03 22:02,DLC,1549,737-800,14,6,22,6,6,22,,,,,8,8
2019-04-03 21:53,NKG,1783,737-800,16,7,0,6,5,26,,,,,-16,10
2019-04-03 21:36,XNN,1542,737-800,6,4,21,2,2,18,,,,,15,12
2019-04-03 20:50,CGO,1588,737-800,16,5,26,5,5,16,,,,,10,0
2019-04-03 20:47,HRB,1559,737-800,10,4,21,2,2,24,,,,,11,14
2019-04-03 20:32,KMG,6809,737-800,15,5,23,6,6,18,,,,,8,3
2019-04-03 19:27,´óÁ¬,5623,737-800,10,5,22,6,6,20,,,,,12,10
2019-04-03 19:26,HGH,5416,737-800,17,6,24,6,6,30,,,,,7,13
2019-04-03 19:26,HGH,5416,737-800,17,6,24,6,6,30,,,,,7,13
2019-04-03 19:17,´óÁ¬,5623,737-800,10,5,22,6,6,20,,,,,12,10
2019-04-03 19:06,HAK,205V,737-800,26,4,36,4,4,33,,,,,10,7
2019-04-03 18:21,HGH,5581,737-800,17,4,21,5,5,27,,,,,4,10
2019-04-03 17:16,XUZ,7988,737-800,20,5,26,5,4,26,,,,,6,6
2019-04-03 17:14,XUZ,7988,737-800,20,5,26,5,4,25,,,,,6,5
2019-04-03 17:02,PEK,1372,737-800,20,4,25,4,4,20,,,,,5,0
2019-04-03 15:34,XIY,5180,737-800,30,5,26,7,6,25,,,,,-4,-5
2019-04-03 13:26,MIG,5732,737-800,25,4,24,4,4,22,,,,,-1,-3
2019-04-03 10:51,HRB,1435,737-800,2,4,18,4,4,20,,,,,16,18
2019-04-03 09:58,HAK,2647,737-800,25,3,25,5,6,21,,,,,0,-4
2019-04-03 09:53,XIY,1483,737-800,13,4,20,4,5,22,,,,,7,9
2019-04-03 09:09,CTU,7990,737-800,17,4,26,3,3,25,,,,,9,8
2019-04-03 08:56,SYX,1735,737-800,27,6,32,6,6,23,,,,,5,-4
2019-04-03 08:17,HAK,5082,737-800,25,4,32,4,4,30,,,,,7,5
2019-04-03 07:51,HHA,1131,737-800,16,4,28,4,4,20,,,,,12,4
2019-04-03 07:50,HHA,5418,737-800,20,0,21,3,4,22,,,,,1,2
2019-04-03 07:49,HHA,6808,737-800,20,3,25,4,3,24,,,,,5,4
2019-04-03 07:48,KMG,7992,737-800,15,7,23,8,7,20,,,,,8,5
2019-04-03 07:47,HHA,5418,737-800,20,0,21,22,4,22,,,,,1,2
2019-04-03 07:22,HGH,5581,737-800,20,4,20,4,3,22,,,,,0,2
2019-04-03 07:21,HGH,7399,737-800,20,4,24,4,4,18,,,,,4,-2
2019-04-03 07:17,DLC,1541,737-800,10,5,26,5,4,22,,,,,16,12
2019-04-03 07:08,HHA,5405,737-800,20,4,29,4,3,24,,,,,9,4
2019-04-03 06:51,HHA,5686,737-800,14,5,24,4,4,24,,,,,10,10
2019-04-03 06:14,FOC,7395,737-800,17,7,26,6,6,26,,,,,9,9
2019-04-03 05:53,FOC,1386,737-800,16,2,24,2,2,22,,,,,8,6
2019-04-03 05:49,FOC,1386,737-800,16,8,2,2,2,6,,,,,-14,-10
2019-04-03 05:37,HAK,5540,737-800,25,4,35,4,4,21,1,,,1,10,-4
2019-04-03 05:36,HAK,5502,737-800,25,4,29,6,5,29,,,,,4,4
2019-04-03 05:34,PEK,5467,737-800,13,3,20,0,0,10,,,,,7,-3
2019-04-03 05:33,HHA,7398,737-800,15,4,24,4,5,16,,,,,9,1
2019-04-03 05:27,XMN,1725,737-800,18,8,29,4,3,23,,,,,11,5
2019-04-03 05:26,XMN,7378,737-800,20,6,24,6,6,26,,,,,4,6
2019-04-03 05:25,XMN,5709,737-800,20,6,20,6,8,22,,,,,0,2
2019-04-03 05:24,XMN,1785,737-800,19,8,28,7,9,30,,,,,9,11
2019-04-03 05:20,PEK,6063,737-800,8,2,22,4,4,20,,,,,14,12
2019-04-03 05:20,XIY,5430,737-800,13,2,20,2,2,20,,,,,7,7
2019-04-03 05:16,XIY,1903,737-800,15,4,24,2,2,22,,,,,9,7
2019-04-03 05:04,HAK,5408,737-800,25,5,30,4,4,28,,,,,5,3
2019-04-03 05:00,SYX ,2158,737-800,26,6,28,3,4,26,,,,,2,0
2019-04-03 04:56,HAK,5625,737-800,25,4,28,5,5,31,,,,,3,6
2019-04-03 04:51,FOC,5182,737-800,18,2,26,8,8,22,,,,,8,4
2019-04-03 04:47,HGH,1733,737-800,12,3,20,3,3,20,,,,,8,8
2019-04-03 04:47,URC,5713,737-800,17,5,22,6,5,23,,,,,5,6
2019-04-03 04:45,SYX,5479,737-800,26,2,26,6,6,30,,,,,0,4
2019-04-03 04:38,DLC,1541,737-800,10,5,26,5,4,22,,,,,16,12
2019-04-03 04:38,XIY,1902,737-800,15,4,28,4,6,20,,,,,13,5
2019-04-03 04:38,SZX,5337,737-800,23,4,30,5,5,30,,,,,7,7
2019-04-03 04:34,HRB,1559,737-800,2,3,18,3,4,17,,,,,16,15
2019-04-03 04:24,PEK,5482,737-800,12,2,10,4,4,20,,,,,-2,8
2019-04-03 04:11,PEK,1495,737-800,11,4,20,4,4,20,,,,,9,9
2019-04-03 04:11,URC,1101,737-800,15,4,28,2,2,22,,,,,13,7
2019-04-03 04:10,KMG,1587,737-800,12,2,19,2,2,18,,,,,7,6
2019-04-03 04:08,URC,6268,737-800,14,5,20,5,5,20,,,,,6,6
2019-04-03 04:07,KMG,5409,737-800,14,3,21,4,4,24,,,,,7,10
2019-04-03 04:00,HGH,5372,737-800,12,8,26,9,8,22,,,,,14,10
2019-04-03 03:54,HAK,206G,737-800,24,4,32,4,4,30,,,,,8,6
2019-04-03 03:51,SZX,1571,737-800,21,5,30,5,4,27,,,,,9,6
2019-04-03 03:51,SZX,1571,737-800,21,5,30,5,4,27,,,,,9,6
2019-04-03 03:51,SZX,1571,737-800,21,5,30,5,4,27,,,,,9,6
2019-04-03 03:51,SZX,1571,737-800,21,5,30,5,4,27,,,,,9,6
2019-04-03 03:51,SZX,1571,737-800,21,5,30,5,4,27,,,,,9,6
2019-04-03 03:47,SZX,5358,737-800,23,5,23,5,5,19,,,,,0,-4
2019-04-03 03:45,HAK,5136,737-800,26,5,34,5,5,36,,,,,8,10
2019-04-03 03:38,HAK,1849,737-800,26,4,28,4,4,30,,,,,2,4
2019-04-03 03:32,KMG,6809,737-800,15,4,20,5,6,20,,,,,5,5
2019-04-03 03:32,KMG,6016,737-800,15,6,24,5,6,22,,,,,9,7
2019-04-03 03:32,KMG,5407,737-800,15,4,22,5,6,21,,,,,7,6
2019-04-03 03:31,HAK,5463,737-800,25,5,27,30,30,26,,,,,2,1
2019-04-03 03:28,URC,5853,737-800,15,7,28,6,8,29,,,,,13,14
2019-04-03 03:24,KMG,1209,737-800,18,3,24,4,3,20,,,,,6,2
2019-04-03 03:24,HRB,1905,737-800,10,4,22,3,3,18,,,,,12,8
2019-04-03 03:22,KMG,7991,737-800,10,6,22,5,5,20,,,,,12,10
2019-04-03 03:19,URC,2159,737-800,15,4,22,2,3,20,,,,,7,5
2019-04-03 03:19,CAN,1130,737-800,22,2,31,2,2,28,,,,,9,6
2019-04-03 03:18,URC,2159,737-800,15,4,22,2,3,20,,,,,7,5
2019-04-03 03:16,URC,5637,737-800,15,2,21,2,2,18,,,,,6,3
2019-04-03 03:13,XIY,1162,737-800,11,4,26,2,2,20,,,,,15,9
2019-04-03 03:13,HHA,1505,737-800,20,4,26,4,4,22,,,,,6,2
2019-04-03 03:09,SZX,1726,737-800,23,4,30,4,4,26,,,,,7,3
2019-04-03 03:04,HGH,5798,737-800,12,2,20,2,2,20,,,,,8,8
2019-04-03 03:01,DLC,5346,737-800,15,6,18,5,5,25,,,,,3,10
2019-04-03 03:01,URC,5406,737-800,15,4,19,5,4,21,,,,,4,6
2019-04-03 02:59,URC,2157,737-800,15,3,21,4,5,20,,,,,6,5
2019-04-03 02:57,XIY,7616,737-800,13,4,21,0,2,28,,,,,8,15
2019-04-03 02:57,HAK,6060,737-800,25,5,30,5,4,30,,,,,5,5
2019-04-03 02:57,DLC,7619,737-800,10,5,22,4,4,20,,,,,12,10
2019-04-03 02:57,CAN,7379,737-800,25,4,30,4,4,32,,,,,5,7
2019-04-03 02:56,XIY,5115,737-800,11,3,18,4,4,20,,,,,7,9
2019-04-03 02:56,DLC,1545,737-800,17,4,22,4,4,20,,,,,5,3
2019-04-03 02:55,HAK,1795,737-800,25,4,31,5,5,32,,,,,6,7
2019-04-03 02:48,SZX,5337,737-800,203,4,30,5,5,30,,,,,-173,-173
2019-04-03 02:46,HAK,6062,737-800,25,4,31,4,4,32,,,,,6,7
2019-04-03 02:46,SZX,1992,737-800,24,3,30,6,4,30,,,,,6,6
2019-04-03 02:43,FOC,1906,737-800,16,6,18,6,6,24,,,,,2,8
2019-04-03 02:42,URC,1793,737-800,14,6,23,5,5,22,,,,,9,8
2019-04-03 02:38,SYX,BX1503,737-800,26,3,31,3,3,30,,,,,5,4
2019-04-03 02:38, KMG,1586,737-800,15,4,25,4,5,16,,,,,10,1
2019-04-03 02:37,PEK,5539,737-800,9,8,26,8,8,30,,,,,17,21
2019-04-03 02:32,¸£ÖÝ,1386,737-800,16,2,8,2,2,6,,,,,-8,-10
2019-04-03 02:30,CGO,1798,737-800,16,6,22,5,5,21,,,,,6,5
2019-04-03 02:29,HAK,1787,737-800,25,1,30,1,1,26,,,,,5,1
2019-04-03 02:28,SYX,206F,737-800,26,4,36,4,4,30,1,,,1,10,4
2019-04-03 02:28,URC,206P,737-800,15,3,24,4,4,21,,,,,9,6
2019-04-03 02:27,HGH,1733,737-800,14,3,21,3,3,20,,,,,7,6
2019-04-03 02:27,HAK,1786,737-800,24,4,33,4,4,28,,,,,9,4
2019-04-03 02:26,DLC,7400,737-800,5,6,20,4,6,22,,,,,15,17
2019-04-03 02:25,HAK,5138,737-800,25,4,30,4,4,32,,,,,5,7
2019-04-03 02:25,HAK,5439,737-800,25,6,31,4,4,30,,,,,6,5
2019-04-03 02:16,HAK,5687,737-800,25,3,23,4,4,30,,,,,-2,5
2019-04-03 02:15,XIY,1161,737-800,14,4,20,3,3,28,,,,,6,14
2019-04-03 02:15,HHA,5636,737-800,15,5,22,6,4,24,,,,,7,9
2019-04-03 02:14,211,5116,737-800,13,4,22,6,4,30,,,,,9,17
2019-04-03 02:13,HAK,1729,737-800,26,4,28,4,4,26,,,,,2,0
2019-04-03 02:13,HAK,5522,737-800,25,6,32,8,8,30,,,,,7,5
2019-04-03 02:13,XIY,7113,737-800,13,4,26,4,5,22,,,,,13,9
2019-04-03 02:10,URC,1569,737-800,10,2,26,2,2,22,,,,,16,12
2019-04-03 02:09,HGH,5372,737-800,17,8,26,9,8,22,,,,,9,5
2019-04-03 02:08,SYX,206H,737-800,26,4,32,2,4,30,,,,,6,4
2019-04-03 02:04,DLC,7619,737-800,10,5,22,4,4,20,,,,,12,10
2019-04-03 02:04,XIY,1346,737-800,20,6,28,4,3,20,,,,,8,0
2019-04-03 02:04,CGO,6015,737-800,15,4,24,4,4,22,,,,,9,7
2019-04-03 02:03,CAN,1501,737-800,24,4,31,5,5,27,,,,,7,3
2019-04-03 02:00,XIY,1163,737-800,14,6,23,4,2,22,,,,,9,8
2019-04-03 01:58,FOC,1433,737-800,16,3,25,3,2,22,,,,,9,6
2019-04-03 01:57,URC,205V,737-800,14,3,24,2,3,25,,,,,10,11
2019-04-03 01:56,URC,6995,737-800,14,3,23,4,3,21,,,,,9,7
2019-04-03 01:55,CAN,1548,737-800,23,5,28,5,5,30,,,,,5,7
2019-04-03 01:55,URC,1322,737-800,14,3,22,4,4,22,,,,,8,8
2019-04-03 01:52,SZX,5483,737-800,20,6,32,7,7,29,1,,,1,12,9
2019-04-03 01:51,HRB,1562,737-800,2,5,22,4,5,23,,,,,20,21
2019-04-03 01:49,HHA,5852,737-800,15,6,12,22,22,12,,,,,-3,-3
2019-04-03 01:47,CAN,5428,737-800,26,4,28,5,4,30,,,,,2,4
2019-04-03 01:46,DLC,1488,737-800,6,6,25,5,5,21,,,,,19,15
2019-04-03 01:46,URC,6995,737-800,15,3,23,4,3,21,,,,,8,6
2019-04-03 01:45,HAK,7639,737-800,25,7,36,24,28,32,,,,,11,7
2019-04-03 01:44,HAK,1493,737-800,23,6,30,6,6,29,,,,,7,6
2019-04-03 01:44,PEK,1728,737-800,10,4,18,8,8,28,,,,,8,18
2019-04-03 01:42,CGO,1208,737-800,15,3,24,3,3,22,,,,,9,7
2019-04-03 01:38,ZGC,1928,737-800,8,5,20,6,6,10,,,,,12,2
2019-04-03 01:36,SZX,1726,737-800,23,4,30,4,4,26,,,,,7,3
2019-04-03 01:35,KMG,7988,737-800,16,5,23,6,4,23,,,,,7,7
2019-04-03 01:31,URC,1929,737-800,15,4,21,4,4,20,,,,,6,5
2019-04-03 01:31,YIH,1348,737-800,18,4,28,4,4,24,,,,,10,6
2019-04-03 01:30,SZX,1502,737-800,23,4,30,4,3,26,,,,,7,3
2019-04-03 01:27,FOC,1480,737-800,20,6,22,5,4,21,,,,,2,1
2019-04-03 01:23,CKG,1373,737-800,20,3,29,3,3,19,,,,,9,-1
2019-04-03 01:21,HGH,1492,737-800,18,2,24,2,2,22,,,,,6,4
2019-04-03 01:20,HAK,1538,737-800,25,4,32,28,28,30,,,,,7,5
2019-04-03 01:13,XIY,1491,737-800,15,4,25,5,6,25,,,,,10,10
2019-04-03 01:08,MIG,5449,737-800,20,4,22,4,4,22,,,,,2,2
2019-04-03 01:08,HGH,7171,737-800,16,4,24,5,4,24,,,,,8,8
2019-04-03 01:07,XIY,7172,737-800,15,5,26,5,4,24,,,,,11,9
2019-04-03 01:06,CGO,7993,737-800,17,6,26,8,6,23,,,,,9,6
2019-04-03 01:02,FOC,7395,737-800,17,26,26,25,26,26,,,,,9,9
2019-04-03 00:59,URC,1498,737-800,14,4,24,5,4,20,,,,,10,6
2019-04-03 00:56,SYX,1487,737-800,26,3,31,3,2,27,,,,,5,1
2019-04-03 00:56,HHA,1131,737-800,16,4,28,4,4,20,,,,,12,4
2019-04-03 00:53,HRB,7105,737-800,2,4,28,6,7,26,,,,,26,24
2019-04-03 00:53,SZX,1927,737-800,23,4,25,8,4,28,,,,,2,5
2019-04-03 00:53,URC,1347,737-800,15,4,20,4,4,21,,,,,5,6
2019-04-03 00:53,TYN,1547,737-800,16,6,20,6,6,22,,,,,4,6
2019-04-03 00:50,HGH,5416,737-800,15,5,23,5,5,24,,,,,8,9
2019-04-03 00:47,XIY,5623,737-800,15,6,26,5,6,22,,,,,11,7
2019-04-03 00:43,KHG,1325,737-800,20,6,18,4,4,19,,,,,-2,-1
2019-04-03 00:40,XIY,5521,737-800,10,4,20,2,2,20,,,,,10,10
2019-04-03 00:39,CAN,5153,737-800,23,6,30,4,4,30,,,,,7,7
2019-04-03 00:38,CGO,1102,737-800,15,2,25,2,3,21,,,,,10,6
2019-04-03 00:37,CAN,1141,737-800,23,5,30,6,6,29,,,,,7,6
2019-04-03 00:36,YIH,1351,737-800,18,4,26,4,4,21,,,,,8,3
2019-04-03 00:35,TYN,6065,737-800,14,5,22,5,5,24,,,,,8,10
2019-04-03 00:32,FOC,5503,737-800,20,3,24,6,5,24,,,,,4,4
2019-04-03 00:27,HAK,5090,737-800,25,2,27,1,2,26,,,,,2,1
2019-04-03 00:25,URC,1995,737-800,14,6,14,5,5,21,,,,,0,7
2019-04-03 00:25,URC,5611,737-800,10,6,24,4,4,24,,,,,14,14
2019-04-03 00:22,SYX,5712,737-800,27,2,28,2,2,26,,,,,1,-1
2019-04-03 00:22,HGH,5798,737-800,18,2,20,2,2,20,,,,,2,2
2019-04-03 00:22,SZX,1215,737-800,22,3,28,4,4,31,,,,,6,9
2019-04-03 00:21,XIY,7886,737-800,15,4,26,24,3,20,,,,,11,5
2019-04-03 00:19,SYX,1735,737-800,27,6,32,6,6,26,,,,,5,-1
2019-04-03 00:14,URC,205V,737-800,15,3,24,2,3,25,,,,,9,10
2019-04-03 00:13,TYN,1103,737-800,10,4,20,4,3,18,,,,,10,8
2019-04-03 00:08,XIY,2652,737-800,15,2,15,3,3,20,,,,,0,5
2019-04-03 00:07,HAK,5466,737-800,25,1,20,4,2,19,,,,,-5,-6
2019-04-03 00:01,XIY,5139,737-800,16,4,24,5,4,0,,,,,8,-16
2019-04-02 23:59,CGO,1102,737-800,20,2,25,2,3,21,,,,,5,1
2019-04-02 23:58,CKG,6061,737-800,15,4,25,4,5,25,,,,,10,10
2019-04-02 23:57,CAN,1490,737-800,23,5,30,5,5,28,,,,,7,5
2019-04-02 23:54,PEK,5733,737-800,11,6,22,6,7,20,,,,,11,9
2019-04-02 23:50,XIY,5478,737-800,16,3,32,3,2,34,,,,,16,18
2019-04-02 23:50,SZX,1497,737-800,22,5,27,6,6,30,,,,,5,8
2019-04-02 23:48,PEK,5538,737-800,10,3,26,3,2,26,,,,,16,16
2019-04-02 23:44,CGO,1570,737-800,16,8,20,4,4,20,,,,,4,4
2019-04-02 23:40,HAK,5417,737-800,25,5,30,6,6,32,,,,,5,7
2019-04-02 23:39,URC,205T,737-800,15,3,24,3,2,22,,,,,9,7
2019-04-02 23:34,TYN,1796,737-800,15,6,24,6,6,22,,,,,9,7
2019-04-02 23:31,MIG,6800,737-800,18,4,24,5,4,22,,,,,6,4
2019-04-02 23:31,PEK,1496,737-800,12,6,28,6,7,30,,,,,16,18
2019-04-02 23:28,CGO,5135,737-800,17,3,24,3,2,23,,,,,7,6
2019-04-02 23:25,URC,1323,737-800,17,2,24,3,3,24,,,,,7,7
2019-04-02 23:25,URC,1996,737-800,14,5,22,4,4,22,,,,,8,8
2019-04-02 23:11,CAN,5480,737-800,23,2,28,4,2,25,,,,,5,2
2019-04-02 23:07,TYN,5462,737-800,11,3,24,3,4,25,,,,,13,14
2019-04-02 23:02,HAK,1799,737-800,23,4,33,5,5,30,,,,,10,7
2019-04-02 23:01,SYX,1997,737-800,26,4,30,4,4,26,,,,,4,0
2019-04-02 23:00,DLC,5373,737-800,11,5,16,6,6,24,,,,,5,13
2019-04-02 22:59,CAN,1375,737-800,25,4,28,4,4,26,,,,,3,1
2019-04-02 22:56,PEK,7173,737-800,15,4,20,6,5,21,,,,,5,6
2019-04-02 22:55,CKG,5638,737-800,15,4,24,5,5,22,,,,,9,7
2019-04-02 22:50,HAK,7167,737-800,26,4,32,8,8,36,,,,,6,10
2019-04-02 22:36,PEK,5338,737-800,10,6,24,6,8,28,,,,,14,18
2019-04-02 22:36,CAN,6066,737-800,24,3,29,2,2,26,,,,,5,2
2019-04-02 22:32,SYX,BX5375,737-800,26,2,30,6,4,28,,,,,4,2
2019-04-02 22:25,SZX,5429,737-800,23,3,24,4,4,26,,,,,1,3
2019-04-02 22:15,FOC,1350,737-800,20,4,25,4,4,23,,,,,5,3
2019-04-02 22:14,XIY,5465,737-800,15,2,22,3,3,24,,,,,7,9
2019-04-02 22:08,PEK,5855,737-800,13,6,17,7,6,20,,,,,4,7
2019-04-02 22:07,CAN,5141,737-800,23,5,28,6,6,27,,,,,5,4
2019-04-02 22:06,ZGC,5662,737-800,10,4,18,2,5,19,,,,,8,9
2019-04-02 21:58,XNN,1542,737-800,11,4,20,2,2,16,,,,,9,5
2019-04-02 21:51,DLC,5620,737-800,10,4,24,3,5,18,,,,,14,8
2019-04-02 21:42,XUZ,7989,737-800,18,6,29,6,5,27,,,,,11,9
2019-04-02 21:42,HAK,5089,737-800,26,0,22,0,0,32,,,,,-4,6
2019-04-02 21:40,URC,1568,737-800,15,7,20,6,7,21,,,,,5,6
2019-04-02 21:39,XNN,1783,737-800,13,4,10,4,4,20,,,,,-3,7
2019-04-02 21:33,HGH,5520,737-800,18,4,28,4,4,24,,,,,10,6
2019-04-02 21:27,MIG,5732,737-800,20,2,22,4,2,22,,,,,2,2
2019-04-02 21:17,CAN,1727,737-800,25,5,28,5,5,25,,,,,3,0
2019-04-02 20:29,PEK,5735,737-800,20,0,16,1,1,18,,,,,-4,-2
2019-04-02 19:13,HAK,5579,737-800,26,5,32,5,5,32,,,,,6,6
2019-04-02 17:01,PEK,7175,737-800,25,4,31,5,6,20,,,,,6,-5
2019-04-02 09:03,CTU,7990,737-800,15,3,26,2,2,24,,,,,11,9
2019-04-02 08:50,PEK,5522,737-800,9,4,20,5,4,16,,,,,11,7
2019-04-02 08:23,PEK,7377,737-800,11,6,20,8,7,28,,,,,9,17
2019-04-02 06:59,XIY,5116,737-800,22,4,20,4,5,20,,,,,-2,-2
2019-04-02 06:49,KMG,6015,737-800,13,3,20,2,2,20,,,,,7,7
2019-04-02 06:39,HHA,5418,737-800,17,4,25,4,4,23,,,,,8,6
2019-04-02 06:09,PEK,1785,737-800,8,0,22,7,8,24,,,,,14,16
2019-04-02 05:53,SYX,206F,737-800,25,3,32,6,7,31,,,,,7,6
2019-04-02 05:23,PEK,5539,737-800,8,5,24,4,5,23,,,,,16,15
2019-04-02 05:03,CAN,1548,737-800,20,3,27,4,4,29,,,,,7,9
2019-04-02 05:00,FOC,1906,737-800,14,3,21,2,3,20,,,,,7,6
2019-04-02 04:53,XIY,1482,737-800,17,5,20,4,5,19,,,,,3,2
2019-04-02 04:34,CAN,5439,737-800,22,4,24,4,3,24,,,,,2,2
2019-04-02 04:32,CGO,5371,737-800,17,6,18,5,6,22,,,,,1,5
2019-04-02 04:32,SYX,5687,737-800,28,5,18,6,8,22,,,,,-10,-6
2019-04-02 04:29,URC,6268,737-800,10,4,20,4,4,20,,,,,10,10
2019-04-02 04:12,HGH,5852,737-800,19,4,21,5,4,23,,,,,2,4
2019-04-02 04:11,KMG,7991,737-800,15,6,24,4,6,22,,,,,9,7
2019-04-02 04:10,URC,1569,737-800,15,3,26,2,3,23,,,,,11,8
2019-04-02 04:09,URC,7198,737-800,13,4,22,6,4,20,,,,,9,7
2019-04-02 04:00,HHA,1505,737-800,20,4,26,4,4,22,,,,,6,2
2019-04-02 03:53,PEK,5538,737-800,7,3,21,3,3,30,,,,,14,23
2019-04-02 03:52,PEK,5482,737-800,8,0,14,4,4,20,,,,,6,12
2019-04-02 03:51,XIY,7886,737-800,20,6,24,6,5,24,,,,,4,4
2019-04-02 03:48,KMG,6809,737-800,15,7,25,7,7,22,,,,,10,7
2019-04-02 03:47,XIY,5430,737-800,16,6,26,5,5,26,,,,,10,10
2019-04-02 03:46,XIY,1162,737-800,15,4,22,4,4,23,,,,,7,8
2019-04-02 03:45,URC,1570,737-800,10,4,20,6,6,20,,,,,10,10
2019-04-02 03:42,HGH,7399,737-800,14,4,24,5,4,20,,,,,10,6
2019-04-02 03:38,±±¾©,6060,737-800,7,4,22,8,8,24,,,,,15,17
2019-04-02 03:36,FOC,1559,737-800,18,2,24,3,2,25,,,,,6,7
2019-04-02 03:34,HGH,5520,737-800,15,4,28,4,6,24,,,,,13,9
2019-04-02 03:26,KMG,1208,737-800,16,3,24,3,3,20,,,,,8,4
2019-04-02 03:23,HAK,5137,737-800,20,2,20,2,2,27,,,,,0,7
2019-04-02 03:16,URC,1726,737-800,15,4,23,3,3,20,,,,,8,5
2019-04-02 03:16,SZX,1795,737-800,20,4,28,4,4,28,,,,,8,8
2019-04-02 03:15,HHA,6808,737-800,16,4,28,4,4,26,,,,,12,10
2019-04-02 03:15,SZX,6062,737-800,21,3,28,3,3,28,,,,,7,7
2019-04-02 03:14,URC,5798,737-800,15,2,20,2,2,20,,,,,5,5
2019-04-02 03:12,PEK,5479,737-800,10,8,22,6,6,20,,,,,12,10
2019-04-02 03:10,FOC,1372,737-800,14,6,27,5,4,21,,,,,13,7
2019-04-02 03:10,SYX,2158,737-800,25,4,25,3,4,26,,,,,0,1
2019-04-02 03:08,HAK,1497,737-800,24,2,30,4,3,32,,,,,6,8
2019-04-02 03:06,XIY,1163,737-800,15,3,27,3,3,24,,,,,12,9
2019-04-02 02:56,SYX,5712,737-800,26,1,28,2,1,28,,,,,2,2
2019-04-02 02:54,ZGC,5662,737-800,7,8,23,5,9,24,,,,,16,17
2019-04-02 02:54,PEK,5853,737-800,13,6,22,7,6,20,,,,,9,7
2019-04-02 02:53,SYX,1141,737-800,27,5,28,6,6,30,,,,,1,3
2019-04-02 02:52,XIY,1903,737-800,17,2,24,2,2,25,,,,,7,8
2019-04-02 02:52,XIY,1481,737-800,17,5,24,5,5,22,,,,,7,5
2019-04-02 02:50,URC,5713,737-800,16,6,22,6,6,17,,,,,6,1
2019-04-02 02:49,HAK,5579,737-800,25,6,34,6,6,32,,,,,9,7
2019-04-02 02:48,CAN,7379,737-800,18,4,26,4,4,30,,,,,8,12
2019-04-02 02:48,FOC,5182,737-800,15,2,14,4,4,20,,,,,-1,5
2019-04-02 02:48,CAN,6066,737-800,18,3,28,2,2,25,,,,,10,7
2019-04-02 02:46,CAN,1727,737-800,20,4,28,5,5,23,,,,,8,3
2019-04-02 02:45,XIY,5620,737-800,20,3,22,4,4,24,,,,,2,4
2019-04-02 02:45,CAN,5480,737-800,21,4,26,5,3,24,,,,,5,3
2019-04-02 02:40,XIY,1488,737-800,20,6,26,6,5,24,,,,,6,4
2019-04-02 02:39,PEK,5346,737-800,20,6,15,5,4,24,,,,,-5,4
2019-04-02 02:35,FOC,5503,737-800,15,3,22,5,4,24,,,,,7,9
2019-04-02 02:34,URC,2157,737-800,10,3,23,8,9,20,,,,,13,10
2019-04-02 02:32,HAK,1799,737-800,25,2,28,4,4,32,,,,,3,7
2019-04-02 02:30,PEK,7398,737-800,10,9,36,8,9,36,,,,,26,26
2019-04-02 02:28,KHG,1325,737-800,18,4,22,4,4,20,,,,,4,2
2019-04-02 02:26,HAK,1131,737-800,25,5,29,6,5,30,,,,,4,5
2019-04-02 02:24,HHA,1729,737-800,19,4,18,4,4,18,,,,,-1,-1
2019-04-02 02:23,KMG,7167,737-800,15,5,24,6,5,22,,,,,9,7
2019-04-02 02:22,TYN,5428,737-800,15,4,20,5,4,30,,,,,5,15
2019-04-02 02:19,FOC,7395,737-800,20,6,23,7,7,24,,,,,3,4
2019-04-02 02:19,XIY,1161,737-800,18,2,22,2,2,20,,,,,4,2
2019-04-02 02:17,HAK,5429,737-800,25,4,26,5,4,30,,,,,1,5
2019-04-02 02:16,HAK,5138,737-800,25,4,30,4,4,32,,,,,5,7
2019-04-02 02:16,HAK,1783,737-800,25,4,34,4,5,33,,,,,9,8
2019-04-02 02:14,XIY,1501,737-800,20,4,24,4,3,22,,,,,4,2
2019-04-02 02:11,HGH,5581,737-800,15,4,20,4,4,22,,,,,5,7
2019-04-02 02:09,HGH,7378,737-800,14,5,23,5,5,22,,,,,9,8
2019-04-02 02:06,CGO,7988,737-800,16,4,24,3,4,23,,,,,8,7
2019-04-02 01:58,Î÷°²,5620,737-800,20,2,21,4,4,24,,,,,1,4
2019-04-02 01:55,XIY,1902,737-800,17,4,20,4,4,18,,,,,3,1
2019-04-02 01:55,HHA,1733,737-800,20,3,22,3,3,20,,,,,2,0
2019-04-02 01:54,YIH,1351,737-800,15,4,26,6,4,24,,,,,11,9
2019-04-02 01:53,XIY,2652,737-800,20,4,20,6,6,18,,,,,0,-2
2019-04-02 01:48,CKG,1373,737-800,17,3,22,3,3,18,,,,,5,1
2019-04-02 01:48,SYX,206H,737-800,26,3,32,2,2,31,,,,,6,5
2019-04-02 01:46,CKG,1489,737-800,16,2,18,3,4,20,,,,,2,4
2019-04-02 01:45,´óÁ¬,7400,737-800,4,5,20,4,4,18,,,,,16,14
2019-04-02 01:41,SXX,5483,737-800,21,5,31,6,5,29,,,,,10,8
2019-04-02 01:40,TYN,1215,737-800,12,3,25,3,4,20,,,,,13,8
2019-04-02 01:39,SZX,1996,737-800,22,4,23,4,4,25,,,,,1,3
2019-04-02 01:39,HHA,5686,737-800,22,8,24,5,5,24,,,,,2,2
2019-04-02 01:38,XIY,7113,737-800,17,5,25,6,6,22,,,,,8,5
2019-04-02 01:34,MIG,6800,737-800,14,4,22,4,4,20,,,,,8,6
2019-04-02 01:27,HAK,1102,737-800,24,3,33,4,4,32,,,,,9,8
2019-04-02 01:27,FOC,1480,737-800,14,4,20,4,4,19,,,,,6,5
2019-04-02 01:26,KMG,7992,737-800,15,7,24,8,8,22,,,,,9,7
2019-04-02 01:26,HAK,5625,737-800,25,6,30,6,7,31,,,,,5,6
2019-04-02 01:24,PEK,5479,737-800,9,8,22,20,6,20,,,,,13,11
2019-04-02 01:24,HGH ,1725,737-800,15,4,25,5,5,27,,,,,10,12
2019-04-02 01:23,YIH,1348,737-800,17,6,20,6,6,4,,,,,3,-13
2019-04-02 01:22,KMG,1209,737-800,14,3,26,4,4,20,,,,,12,6
2019-04-02 01:17,DLC,1386,737-800,8,4,20,2,2,18,,,,,12,10
2019-04-02 01:17,XIY,5478,737-800,18,6,30,8,5,25,,,,,12,7
2019-04-02 01:13,CAN,1375,737-800,20,4,26,4,3,24,,,,,6,4
2019-04-02 01:10,URC,7175,737-800,10,4,14,6,6,20,,,,,4,10
2019-04-02 01:09,URC,5611,737-800,15,4,23,4,6,22,,,,,8,7
2019-04-02 01:07,HRB,1433,737-800,0,3,22,2,2,17,,,,,22,17
2019-04-02 01:07,CAN,5521,737-800,19,4,22,1,1,17,,,,,3,-2
2019-04-02 01:06,CAN,6065,737-800,19,5,28,5,5,27,,,,,9,8
2019-04-02 01:00,KMG,5407,737-800,20,3,16,4,3,20,,,,,-4,0
2019-04-02 00:55,XIY,5180,737-800,18,5,28,6,8,29,,,,,10,11
2019-04-02 00:54,ZGC,1487,737-800,7,3,18,3,3,17,,,,,11,10
2019-04-02 00:53,URC,1568,737-800,18,6,12,8,8,18,,,,,-6,0
2019-04-02 00:52,HAK,5733,737-800,26,6,30,7,8,30,,,,,4,4
2019-04-02 00:48,¹þ¶û±õ,1562,737-800,1,6,20,5,5,18,,,,,19,17
2019-04-02 00:46,TYN,1103,737-800,13,4,26,4,4,20,,,,,13,7
2019-04-02 00:46,HAK,5153,737-800,25,2,30,4,3,28,,,,,5,3
2019-04-02 00:44,URC,1793,737-800,15,5,22,6,5,21,,,,,7,6
2019-04-02 00:43,HGH,7171,737-800,21,4,22,4,4,24,,,,,1,3
2019-04-02 00:42,HAK,5502,737-800,25,5,30,6,4,30,,,,,5,5
2019-04-02 00:42,TYN,5462,737-800,15,4,20,5,4,22,,,,,5,7
2019-04-02 00:42,HAK,1786,737-800,25,6,32,4,4,8,,,,,7,-17
2019-04-02 00:40,URC,5406,737-800,10,4,18,6,4,21,,,,,8,11
2019-04-02 00:39,URC,1322,737-800,15,4,23,4,4,23,,,,,8,8
2019-04-02 00:36,SYX,BX1735,737-800,28,6,28,5,5,26,,,,,0,-2
2019-04-02 00:31,MIG,5732,737-800,14,2,20,2,2,22,,,,,6,8
2019-04-02 00:29,´óÁ¬,7172,737-800,6,4,22,2,4,22,,,,,16,16
2019-04-02 00:25,FOC,1435,737-800,1,6,16,5,5,17,,,,,15,16
2019-04-02 00:25,HAK,5082,737-800,23,3,32,5,5,32,,,,,9,9
2019-04-02 00:19,URC,1995,737-800,17,6,16,5,6,22,,,,,-1,5
2019-04-02 00:18,URC,5637,737-800,16,2,24,2,2,20,,,,,8,4
2019-04-02 00:16,HAK,1495,737-800,25,4,29,5,6,30,,,,,4,5
2019-04-02 00:15,MIG,5449,737-800,20,4,24,5,4,22,,,,,4,2
2019-04-02 00:10,DLC,7619,737-800,7,4,24,4,4,24,,,,,17,17
2019-04-02 00:07,URC,6995,737-800,10,3,24,4,4,17,,,,,14,7
2019-04-02 00:02,HAK,5855,737-800,24,7,28,7,7,27,,,,,4,3
2019-04-02 00:00,HAK,6061,737-800,26,4,30,4,4,28,,,,,4,2
2019-04-01 23:59,XIY,6103,737-800,18,6,22,6,6,22,,,,,4,4
2019-04-01 23:57,URC,6995,737-800,10,3,24,4,4,17,,,,,14,7
2019-04-01 23:55,CGO,1586,737-800,17,5,25,5,4,24,,,,,8,7
2019-04-01 23:54,SYX,1492,737-800,28,4,22,4,3,30,,,,,-6,2
2019-04-01 23:53,CGO,5638,737-800,20,4,22,5,4,22,,,,,2,2
2019-04-01 23:47,SYX,5135,737-800,27,6,28,3,3,26,,,,,1,-1
2019-04-01 23:47,XIY,7173,737-800,20,6,22,6,5,21,,,,,2,1
2019-04-01 23:47,KMG,1588,737-800,13,4,22,3,3,18,,,,,9,5
2019-04-01 23:46,SZX,1927,737-800,21,2,24,4,3,25,,,,,3,4
2019-04-01 23:45,HAK,1502,737-800,24,4,31,6,5,32,,,,,7,8
2019-04-01 23:44,HHA,5465,737-800,19,3,19,4,4,25,,,,,0,6
2019-04-01 23:44,DLC,5373,737-800,7,5,16,6,6,26,,,,,9,19
2019-04-01 23:43,URC,1498,737-800,17,6,20,4,4,20,,,,,3,3
2019-04-01 23:35,CGO,7993,737-800,18,4,22,5,6,21,,,,,4,3
2019-04-01 23:33,HGH,5416,737-800,15,6,20,6,6,20,,,,,5,5
2019-04-01 23:33,CGO,205T,737-800,16,3,22,5,4,23,,,,,6,7
2019-04-01 23:32,PEK,1549,737-800,20,7,30,6,6,23,,,,,10,3
2019-04-01 23:26,HAK,5797,737-800,24,6,24,5,5,28,,,,,0,4
2019-04-01 23:26,URC,206P,737-800,15,4,24,3,4,22,,,,,9,7
2019-04-01 23:18,SZX,5337,737-800,22,5,28,6,5,30,,,,,6,8
2019-04-01 23:13,´óÁ¬,1346,737-800,6,6,24,4,4,12,,,,,18,6
2019-04-01 23:10,HHA,5405,737-800,23,4,28,4,3,23,,,,,5,0
2019-04-01 23:03,DLC,1541,737-800,7,4,24,6,5,22,,,,,17,15
2019-04-01 23:02,URC,1929,737-800,17,4,24,2,2,20,,,,,7,3
2019-04-01 22:58,TYN,1547,737-800,13,7,20,6,6,18,,,,,7,5
2019-04-01 22:57,PEK,1496,737-800,20,4,24,3,2,26,,,,,4,6
2019-04-01 22:56,±±¾©,5372,737-800,12,8,22,8,8,20,,,,,10,8
2019-04-01 22:53,SZX,1796,737-800,21,6,30,4,4,26,,,,,9,5
2019-04-01 22:48,CAN,5141,737-800,19,5,23,5,6,28,,,,,4,9
2019-04-01 22:45,CAN,1490,737-800,20,6,28,5,5,26,,,,,8,6
2019-04-01 22:44,CKG,1503,737-800,15,6,24,4,4,22,,,,,9,7
2019-04-01 22:41,HAK,5540,737-800,24,7,36,7,8,32,1,,,1,12,8
2019-04-01 22:38,XNN,1542,737-800,7,4,20,4,2,16,,,,,13,9
2019-04-01 22:36,HAK,6016,737-800,25,2,32,3,2,30,,,,,7,5
2019-04-01 22:30,XIY,1491,737-800,19,4,26,6,4,24,,,,,7,5
2019-04-01 22:28,SYX,5375,737-800,27,2,31,8,8,32,,,,,4,5
2019-04-01 22:21,Î÷°²,7616,737-800,20,2,21,4,4,24,,,,,1,4
2019-04-01 21:59,XNN,1347,737-800,7,4,20,3,3,18,,,,,13,11
2019-04-01 21:57,HAK,1787,737-800,24,1,28,1,1,26,,,,,4,2
2019-04-01 21:49,CAN,1997,737-800,21,4,28,3,3,24,,,,,7,3
2019-04-01 21:49,CAN,1130,737-800,21,2,30,2,2,26,,,,,9,5
2019-04-01 21:49,HAK,5408,737-800,24,5,32,4,4,28,,,,,8,4
2019-04-01 21:48,URC,205V,737-800,19,4,27,4,4,22,,,,,8,3
2019-04-01 21:46,HAK,206G,737-800,23,1,22,1,2,24,,,,,-1,1
2019-04-01 21:41,HAK,5467,737-800,25,1,26,5,2,19,,,,,1,-6
2019-04-01 21:19,FOC,1350,737-800,14,4,24,4,4,13,,,,,10,-1
2019-04-01 20:08,HAK,5090,737-800,25,2,26,2,3,30,,,,,1,5
2019-04-01 19:26,HRB,1905,737-800,3,4,22,4,3,16,,,,,19,13
2019-04-01 19:25,HGH,5417,737-800,16,5,21,4,4,22,,,,,5,6
2019-04-01 19:14,HAK,5338,737-800,24,4,26,5,4,30,,,,,2,6
2019-04-01 19:08,HAK,205U,737-800,25,4,34,4,4,30,,,,,9,5
2019-04-01 17:52,HAK,5089,737-800,25,1,19,1,1,32,,,,,-6,7
2019-04-01 17:34,XUZ,7989,737-800,20,6,28,5,5,28,,,,,8,8
2019-04-01 16:46,ÈýÑÇ,5520,737-800,29,6,32,5,5,35,,,,,3,6
2019-04-01 15:49,ÈýÑÇ,5520,737-800,31,5,39,5,5,35,1,,,1,8,4
2019-04-01 12:39,CTU,7990,737-800,19,3,27,4,4,24,,,,,8,5
2019-04-01 11:07,URC,1323,737-800,15,3,24,3,4,25,,,,,9,10
2019-04-01 08:19,209,1101,737-800,10,4,32,2,2,30,1,,,1,22,20
2019-04-01 08:05,PEK ,7377,737-800,10,5,23,4,5,25,,,,,13,15
